1 10 18 28 30 32 38 39 42 44 46 52 58 62 71 74 75 79 80 103 105 118 130 131 132 147 148 157 162 168 169 174 178 181 193 194 197 218 222 225 226 246 248 249 252 262 264 275 276 278 282 286 287 288 297 298 300 313 318 320 334 340 349 353 368 378 382 386 387 392 395 417 420 456 464 473 485 494 496 499 506 512 513 519 520 530 532 539 540 558 566 592 632 633 642 661 688 689 720 732 734 739 741 772 783 802 825 828 830 840 873 935 947 967 985 990 1001 1012 1015 1059 1060 1067 1069 1100 1112 1114 1118 1127 1137 1138 1147 
7 14 26 29 34 40 61 81 101 102 107 111 135 154 158 185 195 198 199 207 211 221 236 242 243 244 247 261 295 319 325 328 331 341 363 364 373 374 401 498 568 593 649 666 678 696 700 742 800 842 863 901 919 923 932 948 949 960 966 986 1009 1019 1032 1096 1146 
9 11 16 68 76 86 95 123 124 201 210 212 233 250 251 272 273 280 299 326 327 391 482 484 503 507 522 538 547 562 639 641 648 652 673 778 816 843 931 994 1020 1041 1046 1123 1136 1150 
43 87 88 96 138 155 156 204 205 230 245 294 296 332 347 370 385 470 501 509 580 590 610 624 629 647 722 730 761 776 799 803 819 824 847 871 965 972 983 1045 1124 
50 260 265 316 413 426 432 465 523 524 552 599 615 631 645 676 695 795 814 834 852 860 889 897 898 917 940 952 995 999 1027 1028 1031 1047 1051 1056 1064 1083 1086 1104 1151 
5 69 177 269 292 306 314 366 375 476 521 583 671 674 675 685 725 743 747 820 832 885 920 941 982 1022 1126 1140 1148 
35 113 121 122 145 150 159 182 215 216 381 396 397 404 405 471 487 528 536 537 595 596 614 907 936 939 953 1143 
47 48 108 116 223 235 323 329 514 518 572 598 618 638 669 694 798 839 890 1037 1084 1097 1101 1122 
27 41 59 126 188 343 356 359 457 458 554 597 705 717 718 728 757 812 822 926 1111 
54 93 98 555 556 710 740 821 862 921 943 954 1024 1035 1053 1058 1078 1109 1110 1119 
33 115 120 161 170 171 219 384 418 419 474 542 557 613 713 934 951 
23 227 256 279 301 321 322 497 508 551 570 665 701 879 880 1145 
45 127 422 440 450 489 490 603 636 637 724 749 893 912 1098 1152 
91 99 217 241 567 756 807 835 868 905 922 938 1007 1080 
6 234 446 588 869 895 910 911 1004 1008 1021 1113 1120 
36 106 232 239 270 504 505 810 946 991 1073 1094 1141 
78 129 369 533 576 581 668 727 851 930 973 992 1128 
24 97 179 203 630 687 709 817 831 1023 1044 
2 144 285 515 736 846 945 1013 1085 1139 
4 17 346 371 541 616 760 809 987 1072 
19 72 73 119 165 187 348 390 606 790 
82 146 191 192 563 586 716 780 856 1014 
90 137 184 317 848 853 891 892 977 1048 
209 398 399 619 712 758 774 777 944 964 
213 259 281 351 365 438 585 664 767 900 
64 139 333 336 578 715 755 791 875 
141 163 164 220 238 271 815 826 845 
142 569 573 679 706 762 782 855 927 
173 486 584 662 699 818 906 916 1042 
352 439 600 690 691 1039 1131 1132 1135 
8 66 67 266 400 660 759 1121 
51 263 372 478 516 582 753 1076 
56 425 435 436 635 744 1050 1130 
153 293 427 455 887 888 909 1003 
180 357 406 407 500 729 962 1038 
214 350 380 571 622 904 976 1026 
231 338 339 431 459 460 579 844 
284 358 403 656 684 692 693 1005 
0 274 531 750 859 899 961 
55 311 433 481 654 854 1125 
94 149 190 441 704 883 1071 
416 449 711 876 998 1049 1142 
15 151 240 480 488 808 
20 335 545 628 768 769 
25 189 612 627 925 981 
49 472 770 789 968 978 
110 133 134 312 429 804 
114 546 621 703 726 838 
117 409 430 651 837 1011 
229 415 526 681 763 796 
337 682 707 708 731 1075 
362 434 517 663 877 969 
388 389 437 849 870 884 
22 451 752 902 959 
53 289 309 766 1025 
83 84 186 475 918 
89 360 424 625 989 
125 543 544 746 997 
175 176 454 527 781 
196 344 383 1087 1133 
208 307 479 779 1103 
228 874 882 1057 1091 
237 402 658 659 784 
257 258 805 1040 1095 
304 634 793 937 1081 
308 444 908 1065 1108 
310 683 697 721 1000 
421 461 462 626 836 
646 1061 1070 1090 1149 
37 253 354 483 
57 394 463 813 
65 315 565 1043 
85 140 167 290 
136 283 575 886 
206 591 788 850 
224 655 1006 1077 
302 608 672 955 
330 829 942 1066 
355 428 448 974 
367 604 867 1082 
379 653 787 970 
411 643 811 1055 
442 534 771 988 
468 561 650 1117 
491 702 723 797 
525 827 894 1089 
745 773 933 1074 
775 866 929 957 
785 786 857 996 
3 443 1116 
12 13 928 
31 77 1099 
92 128 1036 
100 268 502 
104 607 640 
109 291 617 
112 589 1016 
172 601 623 
202 466 467 
303 924 958 
305 445 861 
324 794 913 
342 361 605 
376 377 719 
393 670 956 
423 751 915 
469 801 1079 
477 492 733 
495 510 511 
529 737 1144 
548 549 748 
550 620 872 
559 823 975 
577 677 1063 
833 858 984 
841 1092 1093 
903 993 1115 
1033 1034 1054 
