1 8 10 18 30 32 38 39 42 44 46 62 65 71 74 76 79 80 89 101 118 130 131 147 148 157 162 169 174 181 193 194 197 218 225 226 246 249 252 262 264 275 286 287 297 313 318 320 334 348 353 378 382 387 395 417 420 426 456 494 496 499 506 512 513 514 520 530 539 540 566 578 591 603 642 661 688 720 734 739 741 772 783 787 802 825 830 935 967 985 990 1015 1043 1059 1060 1067 1069 1083 1098 1100 1127 1138 1147 
47 48 85 91 108 110 111 113 116 122 145 154 159 195 215 216 223 235 323 329 373 374 381 396 404 405 471 487 528 536 537 572 595 596 618 621 638 669 694 798 811 822 839 932 936 939 947 948 949 953 1009 1019 1037 1084 1097 1101 1122 1150 
11 16 68 95 100 114 117 136 201 210 211 212 233 244 248 250 251 280 282 299 368 379 409 430 485 503 507 538 546 547 550 651 685 703 726 778 785 786 837 838 843 846 872 982 994 1011 1112 1118 1137 
7 26 29 40 81 102 107 185 198 199 207 221 236 242 243 261 295 328 363 364 569 649 666 696 707 842 863 901 986 1032 
43 96 155 156 245 332 347 385 412 501 509 580 590 629 647 722 730 776 799 803 819 965 1022 1045 1049 1124 
6 87 88 204 205 234 263 370 446 587 588 761 856 871 895 910 911 968 1004 1008 1021 1088 1113 1120 
21 41 53 126 188 196 255 343 344 356 359 383 457 458 560 597 628 705 717 718 728 766 926 961 
9 86 123 272 273 326 327 390 391 482 484 522 614 639 648 652 679 706 816 855 927 1046 
5 69 177 269 270 291 292 306 314 375 397 521 671 674 675 743 820 832 920 941 1148 
231 293 338 339 416 427 431 449 459 460 579 653 844 909 924 970 991 998 1142 
254 432 523 524 695 814 852 897 898 952 995 999 1028 1047 1051 1056 1064 1086 1104 
330 352 439 555 556 600 690 691 821 862 921 1024 1039 1066 1119 1131 1132 1135 
23 227 279 321 322 497 508 551 570 665 701 880 943 954 1035 1058 1145 
33 115 120 161 170 171 219 384 419 474 542 557 613 934 940 
92 150 213 281 351 365 438 585 664 767 829 900 1036 1071 
56 57 220 394 463 489 561 635 636 724 813 893 912 
0 64 274 290 519 531 545 750 755 859 875 899 
36 106 232 239 504 505 683 810 946 1073 1094 1141 
51 66 372 400 478 516 582 660 753 759 1076 1121 
77 93 127 336 418 422 601 708 710 1109 1110 
82 146 191 192 284 562 563 586 716 780 1014 
398 455 713 758 777 887 888 944 951 964 1003 
2 144 736 902 945 1017 1018 1023 1085 1139 
15 151 208 307 479 480 488 571 779 808 
4 17 173 371 760 916 987 1025 1072 
27 28 59 554 689 757 812 840 1111 
94 149 190 441 442 534 771 883 988 
99 241 807 868 905 922 938 1007 1080 
141 163 164 238 271 369 815 826 845 
240 265 465 468 515 834 853 1048 1117 
14 180 357 406 407 500 962 1038 
25 189 289 612 627 774 925 981 
34 84 593 655 742 879 1089 1146 
54 217 567 740 756 835 942 1053 
90 137 184 317 848 891 892 977 
97 179 203 266 631 687 709 1044 
105 178 288 349 392 645 732 873 
129 533 581 668 727 851 973 1128 
142 331 358 403 684 692 693 1005 
13 388 389 437 884 1087 1133 
55 311 433 481 654 854 1125 
109 135 158 401 700 923 983 
140 167 324 325 794 913 960 
257 258 259 424 805 1040 1095 
362 434 517 518 663 877 969 
366 583 725 869 885 1126 1140 
380 399 413 470 610 615 917 
454 466 467 573 762 781 782 
486 584 662 699 818 906 1042 
574 646 714 1061 1078 1090 1149 
12 128 160 345 425 928 
50 795 860 889 1013 1031 
124 237 402 658 659 784 
125 337 543 544 746 997 
166 310 697 721 729 1000 
214 350 622 904 976 1026 
229 415 526 681 763 796 
247 568 577 677 678 1063 
19 72 73 165 790 
20 335 667 768 769 
22 230 451 532 752 
45 440 450 598 1152 
52 464 632 633 711 
60 283 535 575 886 
67 228 624 824 882 
133 134 312 429 804 
260 473 565 592 676 
308 444 606 650 1065 
316 393 552 670 956 
342 346 360 361 605 
367 549 604 867 1082 
770 833 858 931 984 
37 253 285 472 
58 278 498 1020 
75 222 386 828 
83 475 817 918 
103 333 377 870 
132 168 300 1114 
138 617 715 1006 
152 153 719 950 
172 452 453 731 
175 176 527 978 
268 502 1027 1151 
298 423 751 915 
302 608 672 955 
421 461 462 626 
469 801 930 1079 
476 744 747 1050 
525 827 894 1001 
599 641 1041 1123 
723 874 1057 1091 
745 773 933 1074 
775 866 929 957 
791 793 876 1081 
3 443 1116 
31 576 1099 
35 182 1143 
49 789 992 
61 966 1096 
98 738 919 
104 607 640 
112 589 1016 
121 849 908 
139 792 971 
186 340 341 
209 619 712 
256 301 1103 
305 445 861 
355 428 448 
408 735 1108 
410 493 797 
411 643 1055 
435 436 1130 
477 492 733 
495 510 511 
529 737 1144 
541 616 809 
558 673 1136 
559 823 975 
602 1070 1102 
609 754 907 
682 831 937 
841 1092 1093 
903 993 1075 
1033 1034 1054 
