7 26 29 34 40 43 47 48 61 64 65 81 82 85 96 101 102 107 108 111 140 142 146 154 155 156 166 167 191 192 195 198 199 207 211 221 223 235 236 237 242 243 244 245 261 267 277 290 295 296 302 319 323 324 325 328 331 332 336 337 347 363 364 402 412 447 466 470 498 501 509 514 518 531 563 569 572 577 578 580 581 586 590 593 598 608 618 629 638 647 649 657 658 659 666 672 677 678 679 680 682 694 696 706 707 708 716 722 730 731 738 742 764 765 776 780 784 791 794 798 799 800 811 819 822 824 839 855 863 875 881 903 913 919 927 932 937 946 948 949 955 960 965 966 972 986 993 1002 1009 1014 1019 1022 1029 1032 1043 1045 1063 1075 1084 1096 1097 1101 1122 1124 1146 
1 10 18 19 28 30 32 38 39 42 44 46 52 58 62 70 71 72 73 74 76 79 80 105 118 130 131 132 147 148 157 162 165 168 169 174 178 181 186 193 194 197 218 222 225 226 239 246 248 249 252 262 264 274 275 276 278 282 286 287 288 297 298 300 301 313 318 320 334 340 348 349 353 368 378 382 385 386 387 390 392 395 410 417 420 456 464 473 485 494 496 499 506 512 513 519 520 530 532 539 540 558 566 592 606 632 633 642 661 669 688 689 720 732 734 739 741 772 783 790 802 825 828 830 840 873 896 935 947 967 973 985 990 1012 1015 1020 1037 1059 1060 1067 1069 1100 1105 1112 1114 1127 1129 1137 1138 1147 
8 17 50 51 66 67 75 90 104 137 184 185 224 227 240 256 260 265 279 317 333 346 371 374 400 411 413 426 453 465 468 477 478 492 497 508 515 523 524 541 551 559 565 582 591 599 607 615 616 631 640 643 644 645 655 660 665 733 753 759 760 795 803 809 814 823 834 848 852 853 860 870 880 889 891 892 897 898 917 952 963 975 977 987 995 999 1013 1027 1028 1031 1047 1048 1051 1052 1055 1056 1064 1077 1083 1086 1104 1117 1121 1145 1151 
5 69 83 84 100 109 110 125 133 134 158 172 177 206 213 268 281 291 292 306 308 311 312 314 351 355 365 366 375 393 408 428 429 438 444 452 475 502 521 543 544 583 585 601 623 654 664 670 671 674 675 725 735 746 747 767 788 804 820 832 850 854 885 900 918 920 941 956 982 997 1108 1115 1126 1140 1148 
6 24 35 55 92 112 113 121 122 128 145 150 152 159 160 182 215 216 234 345 381 388 389 396 397 404 405 437 446 471 487 528 536 537 564 567 587 588 589 594 595 596 614 700 841 846 849 856 869 884 895 907 908 910 911 936 939 950 953 1004 1008 1016 1021 1030 1036 1088 1092 1093 1113 1120 1125 1143 
2 23 36 37 49 97 106 119 144 179 203 214 232 253 266 285 350 354 380 451 472 483 491 493 505 516 548 603 610 686 687 695 702 709 723 736 770 789 797 810 817 831 833 858 901 902 945 968 976 1017 1018 1023 1026 1044 1057 1071 1073 1076 1085 1091 1094 1098 1107 1134 1139 1141 
9 11 14 68 86 95 123 124 135 187 201 210 212 233 247 250 251 272 273 280 299 303 326 327 341 391 401 482 484 488 503 507 522 538 546 547 562 568 639 641 648 652 653 673 676 778 816 843 923 931 958 1041 1046 1123 1136 1150 
175 176 180 200 229 231 270 293 310 338 339 357 379 406 407 414 415 416 421 427 431 432 449 459 460 500 504 526 527 553 579 626 683 697 698 711 721 729 763 787 836 844 909 924 962 970 974 978 991 998 1000 1038 1049 1068 1142 
114 117 183 254 263 284 315 316 322 358 403 409 423 430 550 552 571 609 620 621 651 656 684 693 703 726 737 743 744 754 785 786 792 837 838 857 872 971 996 1005 1011 1033 1034 1050 1054 1144 
54 93 98 202 330 352 439 454 467 495 510 511 555 556 573 600 690 691 710 740 762 781 782 821 829 862 890 921 942 943 954 1024 1035 1039 1053 1058 1066 1072 1078 1109 1110 1119 1131 1132 1135 
4 33 94 115 120 149 161 170 171 190 219 321 329 384 419 441 442 455 474 534 542 557 570 613 704 713 751 755 771 879 883 887 888 915 934 940 951 959 983 988 1003 1065 1082 
0 12 13 22 87 88 138 139 173 196 204 205 230 294 344 370 383 425 486 584 617 624 630 662 692 699 715 750 761 818 847 859 871 899 906 916 928 961 1006 1042 1087 1133 
16 21 25 27 41 53 59 126 188 189 255 289 309 343 356 359 373 448 457 458 461 462 554 560 597 611 612 627 667 705 717 718 757 812 925 926 981 994 1025 1111 
31 45 56 57 77 127 376 377 394 418 422 433 435 436 440 450 463 481 489 490 529 561 635 636 637 681 719 724 749 813 893 912 1099 1130 1152 
89 136 257 258 283 342 360 361 424 575 605 625 650 805 806 886 989 1040 1095 1106 
15 103 116 151 208 259 307 476 479 480 574 685 714 728 779 808 1103 
78 129 369 469 533 576 668 727 801 807 851 922 930 992 1079 1128 
228 367 525 549 604 622 701 748 827 867 874 882 894 1001 1089 1118 
141 163 164 220 238 271 775 815 826 845 866 929 957 1010 1062 
91 99 153 217 241 372 756 835 868 904 905 938 1007 1080 
3 20 63 143 335 443 545 628 766 768 769 1116 
209 398 399 619 712 758 774 777 878 914 944 964 
269 305 362 434 445 517 663 796 842 861 877 969 
60 535 745 752 773 933 984 1074 
602 646 1061 1070 1090 1102 1149 
304 634 793 876 1081 
