8 9 24 25 30 31 44 45 51 60 63 66 67 69 75 83 102 109 114 130 131 152 158 169 201 202 203 206 233 234 245 250 265 266 279 310 314 315 321 329 332 333 335 340 342 355 363 375 393 395 400 408 411 427 429 430 439 440 444 452 454 462 477 478 491 508 516 521 529 533 546 547 548 549 551 564 565 566 573 577 578 582 591 593 615 631 640 642 654 660 669 678 679 683 684 692 701 706 719 732 733 739 759 768 769 772 778 785 786 792 802 827 830 831 832 836 845 861 866 885 901 903 909 912 937 947 957 966 985 996 998 1005 1033 1034 1054 1059 1060 1065 1067 1069 1072 1108 1112 1127 1145 1146 1150 
0 1 10 11 18 19 23 28 32 33 38 39 42 43 46 52 58 59 61 62 68 70 73 74 76 77 78 79 80 95 96 107 108 117 118 148 157 162 168 174 175 176 178 179 181 186 187 193 194 197 210 211 212 218 222 225 226 246 247 248 249 251 252 264 275 276 282 286 287 297 298 313 318 334 353 382 386 387 392 417 420 423 434 448 453 456 485 486 496 499 506 512 513 520 530 532 538 539 540 550 572 592 622 661 663 676 688 698 754 757 775 783 812 825 828 847 894 904 905 917 929 935 958 967 974 976 982 990 994 1029 1036 1096 1101 1137 
27 47 48 65 87 88 110 111 138 140 198 199 204 223 224 230 235 236 237 244 268 324 327 328 336 337 359 369 370 376 377 391 458 469 470 482 507 509 522 523 524 541 542 544 607 610 624 628 638 643 649 657 667 670 682 696 703 715 716 727 737 738 761 762 811 822 839 857 863 871 872 930 932 955 981 983 997 1006 1009 1015 1017 1019 1030 1046 1076 1079 1086 1095 1104 1111 1115 1144 
16 81 82 97 146 147 172 173 191 192 205 219 257 259 267 283 284 330 424 466 493 525 562 563 569 583 584 585 620 629 630 651 662 711 714 718 726 736 752 753 780 837 856 869 906 916 927 941 956 972 975 1014 1025 1028 1042 1049 1064 1100 1126 1140 1148 
21 36 41 64 103 104 116 125 126 142 143 151 208 258 260 261 263 311 319 331 354 357 358 371 372 389 414 437 445 500 502 543 559 560 568 571 574 586 597 608 639 648 666 685 686 720 728 746 766 779 814 849 880 881 884 907 1008 1040 1113 1120 
2 3 119 120 127 128 149 161 165 170 171 232 277 278 309 316 384 385 402 403 418 419 461 492 557 613 641 656 709 860 886 934 940 951 961 999 1013 1018 1020 1041 1047 1092 1123 1135 1139 
4 5 17 91 92 93 94 150 182 183 190 213 214 280 281 323 351 352 365 438 495 511 552 554 618 664 694 704 760 767 829 900 962 963 987 1010 1071 1084 1097 1143 
84 105 106 153 231 270 291 293 294 338 339 394 431 432 443 449 459 460 504 505 579 587 588 675 717 749 820 833 844 991 995 1051 1055 1085 1116 1121 
6 7 20 26 29 40 85 86 115 135 154 195 196 207 209 221 227 242 243 341 368 373 374 401 498 794 852 870 899 948 949 1002 1023 1032 1056 
99 129 134 139 180 228 229 302 303 360 383 406 415 416 421 422 455 489 526 527 601 681 751 763 781 782 796 855 873 877 919 924 969 1068 1128 
89 90 136 137 184 185 240 241 305 306 317 464 465 468 514 515 606 650 702 790 842 843 848 853 868 891 892 1044 1048 1073 1117 1141 
112 113 121 122 144 145 159 160 215 216 381 396 397 404 405 471 487 528 536 537 595 596 614 621 936 939 943 953 
155 407 450 575 576 589 616 617 647 668 722 791 793 809 897 898 1016 1021 1022 1027 1074 1081 1151 1152 
53 255 288 289 580 611 646 695 742 800 823 824 841 908 925 1061 1093 1102 1149 
34 132 256 300 301 534 535 735 770 858 879 931 984 1066 1103 1114 1122 
54 55 217 567 599 740 741 756 835 846 854 971 1007 1053 1080 1088 1125 
100 101 167 177 200 285 320 494 687 689 748 818 840 878 913 960 
274 290 349 350 483 519 531 545 598 750 755 816 859 910 1026 1147 
56 57 133 435 436 481 490 561 635 636 637 724 813 893 1130 
269 292 345 425 476 600 671 674 693 743 744 747 895 920 1050 
262 299 322 366 367 380 412 413 570 697 721 725 867 1082 
49 50 253 254 388 446 447 553 594 680 789 834 914 
325 346 347 361 426 501 605 609 625 801 808 993 1083 
690 691 710 954 1035 1039 1058 1078 1090 1109 1110 1131 1132 
12 378 409 410 497 558 672 673 699 876 945 1136 
22 379 441 604 653 787 902 942 959 970 1142 
123 304 472 745 797 798 933 968 978 988 1043 
163 164 220 238 239 271 463 632 633 815 826 
98 326 510 555 556 862 921 1012 1024 1119 
124 503 619 626 658 659 784 788 890 992 
398 399 627 712 713 758 774 777 944 964 
71 72 348 390 428 475 882 977 1037 
141 295 296 356 612 700 705 928 965 
272 273 602 603 652 1070 1094 1098 
14 15 480 484 488 973 
156 581 590 776 799 819 
166 677 729 1000 1038 1063 
312 707 708 731 989 1075 
343 344 457 773 926 1133 
364 850 851 875 923 950 
473 474 887 888 1003 1004 
803 804 807 922 938 986 
13 810 838 946 1087 
307 308 479 896 1077 
362 451 517 518 915 
188 189 433 1011 
634 655 665 1124 
723 874 1057 1091 
821 1045 1062 1099 
35 730 1089 
442 771 883 
795 889 1031 
805 806 1106 
