7 14 26 29 34 40 43 47 48 61 81 84 85 91 96 101 102 107 108 110 111 113 116 122 135 140 142 145 154 155 156 159 166 167 185 195 198 199 207 211 215 216 221 223 235 236 237 242 243 244 245 247 256 261 267 277 290 294 295 296 301 302 303 305 323 324 325 328 329 331 332 341 346 347 363 364 370 373 374 381 396 397 401 402 404 405 412 445 447 448 471 487 491 501 509 528 536 537 568 569 572 577 580 590 593 595 596 608 611 618 621 624 629 638 647 649 657 658 659 666 669 672 677 678 680 694 696 700 702 716 722 730 738 742 776 784 794 798 799 800 811 819 822 824 839 842 847 861 863 879 881 890 901 913 919 923 932 936 939 947 948 949 953 955 958 965 966 972 983 986 1009 1019 1022 1032 1037 1045 1049 1063 1065 1084 1096 1097 1101 1112 1122 1124 1146 1150 
1 10 18 19 30 32 38 39 42 44 46 58 62 65 70 71 72 73 74 75 76 79 80 105 118 130 131 132 147 148 157 162 165 168 169 174 178 181 194 197 218 222 225 226 246 249 252 262 264 275 278 282 286 287 288 297 298 300 313 318 320 334 340 348 349 353 378 382 385 386 387 392 395 410 417 420 423 456 494 496 498 499 503 506 512 513 514 520 530 539 540 558 591 603 642 645 661 673 688 720 732 734 739 741 751 772 783 790 802 825 828 830 873 876 896 915 935 967 985 990 1043 1059 1060 1067 1069 1098 1100 1105 1114 1127 1129 1136 1138 1147 
9 11 16 68 86 95 114 117 119 123 124 136 183 187 201 210 212 233 248 250 251 272 273 276 280 299 326 327 354 368 390 391 409 430 482 483 484 485 507 522 538 546 547 550 562 566 614 620 639 641 648 651 652 679 685 703 706 726 778 785 786 816 837 838 843 855 857 872 927 982 994 996 1001 1011 1012 1020 1041 1046 1118 1123 1137 
4 17 20 21 25 27 28 41 53 59 126 173 188 189 193 196 255 289 309 319 335 343 344 356 359 362 371 383 398 421 434 457 458 461 462 517 518 554 560 597 612 626 627 628 663 667 705 717 718 757 758 760 768 769 774 777 812 823 836 877 916 925 926 944 961 964 969 974 981 987 1015 1025 1111 1133 
8 51 54 66 67 99 104 217 231 241 266 330 338 339 352 372 400 431 439 459 460 477 478 492 495 510 511 516 555 556 579 582 600 607 640 660 690 691 733 740 753 756 759 766 807 821 833 835 844 858 862 868 905 921 922 931 938 942 984 1007 1024 1039 1053 1066 1072 1076 1080 1119 1121 1131 1135 
2 24 36 37 49 97 106 144 179 203 214 224 228 232 239 253 260 285 350 472 493 504 505 525 565 622 630 644 655 676 683 686 687 709 723 736 770 789 797 810 817 827 831 846 874 882 894 902 904 945 946 968 976 991 1017 1018 1023 1026 1044 1057 1073 1077 1085 1089 1091 1094 1139 1141 
50 90 98 137 184 240 254 265 316 317 380 393 411 432 465 468 515 523 524 541 552 559 599 615 616 631 643 670 695 728 795 803 809 814 834 848 852 853 860 889 891 892 897 898 917 952 956 963 975 977 995 999 1013 1027 1028 1031 1047 1048 1051 1052 1055 1056 1064 1086 1104 1117 1151 
22 52 100 175 176 180 200 202 229 230 293 310 357 379 406 407 414 415 416 427 449 451 454 455 464 466 467 500 526 527 532 553 573 632 633 653 681 697 698 711 721 729 752 762 763 781 782 787 796 887 888 909 924 959 960 962 970 978 998 1000 1003 1038 1142 
6 12 13 87 88 92 121 128 150 160 204 205 213 234 263 281 345 351 365 388 389 437 438 446 585 587 588 594 664 689 761 767 829 840 841 849 869 884 895 900 908 910 911 928 1004 1008 1021 1036 1068 1071 1087 1088 1092 1093 1107 1113 1120 1134 
5 69 83 109 177 186 268 269 270 291 292 306 308 314 366 375 408 444 475 476 502 521 583 606 671 674 675 725 735 743 744 747 792 820 832 885 918 920 941 971 1033 1034 1050 1054 1108 1126 1140 1148 
0 64 82 103 125 133 134 146 158 191 192 274 284 311 312 333 355 377 428 429 519 531 543 544 545 563 586 654 746 750 755 780 804 856 859 870 875 899 1014 
77 93 127 138 139 172 336 337 418 422 452 453 486 578 584 601 617 623 662 682 699 707 708 710 715 731 764 765 818 903 906 1006 1042 1075 1109 1110 1115 
31 78 129 141 163 164 238 271 369 469 533 576 581 668 727 775 801 815 826 845 850 851 866 929 930 957 992 1010 1062 1079 1099 1128 
33 115 120 161 170 171 219 315 358 384 403 419 474 542 557 613 656 684 692 693 713 934 940 951 1005 
45 55 376 433 435 436 440 450 481 489 490 567 598 635 636 637 719 724 749 854 893 912 1125 1130 1152 
60 257 258 259 283 342 360 361 424 535 575 605 745 773 805 806 886 933 1040 1074 1095 1106 
23 227 279 321 322 497 508 551 570 571 665 701 880 943 954 1035 1058 1132 1145 
89 399 413 426 470 610 625 871 989 993 997 1083 
15 151 208 307 479 480 488 779 808 1103 
94 149 190 441 442 534 704 771 883 988 
574 602 646 714 1061 1070 1078 1090 1102 1149 
56 57 220 394 425 463 561 650 813 
206 367 548 549 604 748 788 867 1082 
152 153 473 564 592 950 973 1030 
35 112 182 589 1016 1143 
304 634 791 793 937 1081 
529 609 737 754 907 1144 
3 63 143 443 1116 
209 619 712 878 914 
