10 11 12 18 19 30 32 38 39 58 73 79 105 114 121 123 130 131 163 164 168 169 181 191 217 219 220 222 223 225 238 239 247 248 252 270 271 276 282 288 291 297 305 313 318 321 338 339 353 366 378 382 386 390 392 410 411 420 431 432 440 445 449 459 464 504 505 513 520 532 538 540 556 558 576 579 598 622 631 632 633 642 663 671 672 680 699 702 713 731 732 735 741 755 757 814 820 826 833 836 842 844 853 854 876 945 951 952 963 976 983 991 1009 1022 1037 1052 1059 1069 1108 1119 1127 1138 1147 
4 7 47 48 92 108 112 113 122 125 144 145 149 150 159 160 182 190 213 215 216 224 281 319 323 327 343 381 396 397 403 404 414 423 438 460 471 482 487 495 507 528 536 537 541 542 549 572 583 595 596 614 618 664 669 688 694 704 767 798 822 839 843 883 890 907 923 936 939 947 949 953 967 1005 1019 1029 1036 1074 1084 1097 1101 1116 1126 1140 1143 1150 
6 13 20 26 27 29 40 74 102 115 140 147 154 157 188 193 195 209 233 235 242 243 244 264 275 299 364 368 374 398 399 461 462 467 498 508 509 564 573 580 581 589 593 628 712 727 730 758 774 777 792 799 825 852 859 901 904 905 934 944 964 966 972 978 990 1001 1002 1015 1028 1032 1047 1054 1067 1100 1111 1118 1122 1146 
16 17 25 41 49 61 76 78 85 94 95 96 101 107 119 120 143 167 177 196 218 285 303 320 325 328 344 359 391 393 394 417 437 448 463 485 493 494 521 550 553 554 620 649 662 687 689 696 697 703 748 760 773 781 789 794 818 860 878 924 960 994 1038 1046 1087 1096 1133 1137 
72 104 116 142 171 245 255 274 301 304 307 308 349 357 371 469 470 472 476 479 491 499 500 502 512 515 522 555 560 569 570 571 574 575 615 619 623 630 639 647 658 668 685 686 698 720 723 728 745 752 779 797 801 821 862 867 887 896 917 918 921 962 1024 1043 1045 1072 1103 
81 93 117 166 174 199 214 232 234 262 365 405 415 421 446 454 474 526 533 539 601 644 710 725 738 763 768 769 785 786 802 819 832 857 910 911 937 950 955 957 959 969 986 1004 1008 1065 1071 1082 1107 1113 1120 1134 
2 24 33 36 37 44 50 54 55 172 208 230 231 253 315 316 335 354 360 370 408 451 456 518 548 552 567 582 587 602 603 659 736 740 756 776 787 835 846 902 914 1030 1053 1078 1080 1085 1098 1102 1125 1139 
34 83 84 128 161 189 236 300 402 406 418 442 447 523 524 534 535 557 594 645 654 655 706 729 733 770 795 879 889 897 940 968 984 995 999 1021 1031 1066 1073 1076 1077 1086 1104 1114 1141 
8 15 51 65 86 151 158 227 241 265 311 332 351 355 373 465 468 501 514 529 561 565 586 591 597 650 679 739 751 815 845 855 892 927 935 974 1040 1117 
21 91 98 99 261 293 379 429 458 666 667 690 691 764 765 771 803 804 868 903 943 954 1007 1012 1035 1058 1060 1061 1070 1090 1105 1109 1110 1129 1132 
97 109 111 129 179 180 294 310 331 342 385 422 443 455 492 496 624 670 709 762 782 790 807 817 847 851 858 909 922 998 1000 1017 1018 1023 1115 
69 90 136 137 165 184 185 292 306 314 317 348 375 384 428 436 543 606 674 675 681 747 749 813 848 882 886 891 919 920 977 982 1048 1051 
14 80 82 118 135 148 207 295 296 324 337 340 341 356 483 531 613 682 705 707 708 734 928 942 948 965 993 997 1075 1095 
0 52 212 228 249 257 258 290 298 362 434 545 566 661 677 754 783 796 805 806 812 828 873 874 877 894 1106 1112 
9 22 28 63 66 67 170 175 176 204 266 400 441 453 478 604 640 660 676 701 759 996 1033 1034 1121 1142 
89 146 173 192 267 283 376 377 412 424 466 510 511 525 563 584 711 719 753 780 856 906 916 989 1014 1049 
110 133 134 197 226 363 395 407 430 450 489 519 544 617 678 692 746 816 899 938 961 975 1013 1016 1152 
45 87 278 346 347 352 361 367 413 426 599 600 609 610 616 625 722 800 808 838 871 885 932 1006 
64 75 103 126 138 139 237 336 416 477 578 588 590 715 761 778 791 809 863 946 1025 1027 1088 1151 
5 187 251 273 302 309 326 439 503 637 641 652 653 656 673 987 1039 1041 1094 1123 1131 1135 1136 
141 240 279 322 358 409 473 480 488 530 592 605 638 888 898 971 973 1003 1011 
31 60 77 127 152 383 419 486 611 612 646 700 930 933 1099 1149 
56 153 272 345 372 490 527 627 683 717 718 824 827 925 985 1089 
35 53 155 156 221 380 388 629 657 841 1064 1083 1092 1093 1124 
3 46 330 334 608 643 716 766 810 811 829 1042 1055 1056 
62 183 254 286 559 585 621 684 726 823 834 900 981 1079 
202 203 452 497 634 665 831 866 929 970 1010 1044 1062 1128 
1 88 162 280 547 562 651 737 750 869 1144 
59 256 427 551 607 626 793 872 1068 1081 1145 
68 70 194 201 277 387 506 568 880 881 1020 
23 178 198 211 263 289 516 577 837 1063 
71 100 124 210 250 268 269 369 546 861 
229 433 435 481 788 941 958 988 1130 1148 
43 132 200 246 287 721 784 830 840 
260 312 333 389 457 849 870 884 992 
329 484 517 648 772 915 931 1057 1091 
42 106 186 350 475 695 714 1026 
57 205 259 635 636 724 893 912 
206 444 775 850 908 926 956 
284 425 693 743 744 895 1050 
401 742 875 913 
