2 17 22 23 24 33 36 37 49 54 55 65 87 89 97 98 106 115 144 161 163 164 170 179 209 214 219 220 227 232 238 239 253 256 260 266 271 279 298 315 321 322 350 354 371 380 384 398 399 408 413 414 423 426 429 451 464 470 472 483 505 508 551 553 565 570 571 602 603 609 610 613 615 619 625 630 631 632 633 639 644 668 676 680 683 686 687 695 701 709 712 713 723 736 740 751 752 756 758 760 774 777 789 810 817 826 835 846 871 878 880 901 902 914 915 934 943 944 945 946 951 954 964 976 987 989 992 1023 1026 1033 1034 1035 1043 1053 1054 1058 1061 1070 1072 1078 1080 1082 1083 1085 1090 1094 1098 1102 1125 1139 1141 1145 
1 10 18 19 28 30 32 38 39 42 44 46 58 59 62 70 71 72 73 74 75 76 79 80 105 119 130 131 147 148 157 162 165 168 169 178 181 187 193 194 197 210 218 222 225 226 246 248 249 252 262 264 275 276 278 282 286 288 291 297 299 300 304 313 318 334 340 348 349 353 378 382 386 387 390 392 395 417 420 456 496 498 499 503 506 512 513 514 520 532 539 540 566 622 641 642 645 661 716 720 732 734 739 741 747 783 787 790 792 802 825 828 840 873 896 904 935 967 990 1012 1015 1020 1041 1059 1069 1100 1114 1123 1127 1138 1147 
26 29 40 45 81 82 85 96 101 102 107 111 120 135 140 142 146 154 156 158 167 171 191 192 198 199 206 207 211 235 236 237 242 243 244 245 261 267 269 287 295 296 302 305 324 325 328 331 337 356 363 367 412 428 445 474 491 509 529 563 569 577 580 586 604 608 629 647 649 657 658 659 666 672 677 678 696 700 702 707 722 727 730 737 754 771 776 780 784 794 797 799 800 819 830 842 861 863 867 890 909 919 928 932 948 955 960 963 965 966 972 983 986 996 998 1009 1014 1017 1018 1032 1045 1052 1063 1112 1124 1144 
4 12 13 35 47 48 56 91 92 94 99 108 112 113 122 128 145 149 150 159 160 182 183 190 195 213 215 216 223 224 254 281 284 323 329 341 345 351 365 381 396 403 404 425 438 441 442 460 471 487 528 536 537 542 549 572 585 589 595 596 618 621 656 664 669 684 692 693 694 704 743 744 767 772 798 811 822 829 839 883 900 905 907 936 939 947 949 953 959 1002 1005 1007 1019 1029 1036 1037 1050 1060 1071 1084 1097 1101 1105 1107 1122 1129 1134 1143 1150 
5 50 57 69 90 137 143 177 184 185 230 241 265 268 270 292 303 306 314 316 317 338 339 346 366 393 394 397 431 433 435 436 440 450 459 463 465 468 481 489 490 502 504 521 541 552 561 579 583 598 599 616 635 636 637 650 670 671 674 675 724 725 735 749 788 809 813 820 833 834 844 848 853 854 858 860 885 891 892 912 920 941 956 958 977 982 988 991 1013 1022 1027 1048 1073 1074 1108 1117 1126 1130 1140 1148 1151 1152 
6 14 43 52 132 138 139 174 180 200 204 205 229 234 293 310 357 370 406 407 415 416 427 446 449 454 455 466 467 497 500 526 534 573 588 590 594 617 634 653 665 679 688 697 698 706 711 715 721 729 761 762 763 770 781 782 791 793 796 832 855 856 869 876 887 893 895 910 911 924 927 962 968 970 1000 1004 1006 1008 1021 1031 1038 1049 1068 1077 1081 1113 1120 1142 
3 20 21 25 27 41 53 63 124 126 155 188 189 196 221 255 289 308 309 319 332 335 336 343 344 347 355 359 373 374 383 421 443 444 447 457 458 461 462 501 554 560 578 591 597 606 611 612 626 627 628 667 705 708 717 718 757 764 765 766 768 769 815 836 845 903 908 925 926 961 974 981 993 997 1025 1067 1075 1087 1092 1093 1111 1115 1116 1133 
7 9 11 16 61 68 86 95 100 114 117 118 123 166 201 212 233 250 251 272 273 280 285 320 326 327 368 375 379 391 409 410 430 448 476 482 484 485 493 494 507 515 522 530 538 545 546 547 548 550 562 568 614 620 648 651 652 662 685 689 703 726 738 748 778 785 786 816 837 838 843 857 872 917 931 994 1011 1046 1065 1096 1118 1137 
0 8 34 60 64 83 84 88 103 110 121 125 133 134 247 257 258 259 274 290 311 312 333 364 377 388 389 401 424 437 519 531 535 543 544 557 587 593 654 655 681 742 745 746 750 755 773 795 804 805 806 841 849 859 870 875 879 884 899 913 923 933 984 1040 1088 1095 1106 1146 
51 66 67 104 109 173 175 176 228 263 294 362 372 376 400 434 477 478 492 516 517 518 525 527 558 582 607 624 640 660 663 673 719 733 753 759 812 824 827 847 874 877 882 894 916 938 969 978 985 1001 1057 1076 1089 1091 1121 1136 
202 203 217 330 352 411 432 439 495 510 511 523 524 555 556 559 567 600 643 690 691 803 814 821 823 852 862 889 897 898 921 942 952 975 995 999 1024 1028 1039 1044 1047 1051 1055 1056 1064 1066 1086 1104 1119 1131 1132 1135 
31 78 129 141 152 153 186 240 369 469 473 475 533 564 574 576 581 592 646 682 714 775 801 807 831 850 851 866 868 888 918 922 929 930 937 950 957 973 1003 1010 1016 1030 1062 1079 1099 1128 1149 
15 116 136 151 208 231 277 283 301 307 342 358 360 361 479 480 488 575 605 638 728 779 808 881 886 971 1103 
77 93 127 172 385 402 405 418 419 422 452 453 486 584 601 623 699 710 731 818 906 940 1042 1109 1110 
