1 10 18 19 28 30 32 38 39 42 44 46 52 58 62 70 71 72 73 74 75 79 80 103 105 118 119 130 131 132 147 148 157 162 165 168 169 174 178 181 186 187 193 194 197 218 222 225 226 246 248 249 252 262 264 274 275 276 278 282 286 287 288 297 298 300 313 318 334 340 348 349 353 378 382 386 387 390 392 395 417 420 456 464 473 494 496 499 506 512 513 519 520 530 532 539 540 558 566 592 606 632 633 642 661 669 688 689 720 732 734 739 741 772 783 790 802 825 828 830 840 873 896 935 947 967 985 990 1012 1015 1059 1060 1067 1069 1100 1105 1112 1114 1127 1129 1138 1147 
7 14 26 29 34 40 47 48 60 82 85 101 102 107 108 111 116 135 140 155 166 167 185 195 198 199 207 221 223 235 236 237 241 242 243 269 290 295 302 303 305 319 323 324 325 328 331 341 363 364 373 374 401 402 445 498 514 518 535 572 593 598 608 618 638 649 658 659 666 672 694 696 700 716 738 742 743 784 794 798 811 839 842 861 863 901 913 919 923 924 948 949 955 958 960 1002 1009 1019 1029 1032 1037 1084 1097 1101 1122 1146 
2 6 22 23 24 36 37 49 65 87 88 97 106 138 139 144 179 203 204 205 214 230 232 234 239 253 270 285 294 315 320 321 350 354 370 380 410 446 451 472 483 491 493 504 505 565 571 587 588 594 610 617 624 630 686 687 702 709 715 723 736 752 761 770 789 797 810 817 831 846 847 856 871 895 902 910 911 945 946 968 976 991 1004 1006 1008 1013 1017 1018 1021 1023 1026 1043 1044 1057 1068 1073 1077 1085 1088 1091 1094 1113 1120 1139 1141 
9 11 16 68 76 86 95 100 114 117 123 124 154 183 201 210 211 212 233 244 250 251 268 272 273 280 299 326 327 368 391 409 430 482 484 485 502 503 507 522 538 546 547 550 562 620 621 639 641 648 651 652 673 703 726 778 785 786 792 800 816 837 838 843 857 872 876 931 971 994 996 1001 1011 1020 1033 1034 1041 1046 1054 1118 1123 1136 1137 1150 
50 56 90 137 184 228 240 260 265 316 317 411 413 425 426 432 465 468 515 523 524 525 541 552 559 561 599 615 622 631 643 644 645 676 695 795 809 814 823 827 834 848 852 853 860 874 879 882 889 891 892 894 897 898 917 932 952 963 975 977 995 999 1027 1028 1031 1047 1048 1051 1052 1055 1056 1064 1083 1086 1089 1104 1117 1151 
5 55 69 83 84 109 172 177 206 291 292 306 308 311 314 351 365 366 375 393 408 433 444 475 481 521 574 583 585 591 601 623 654 670 671 674 675 714 725 735 747 788 820 832 850 854 869 885 900 918 920 941 956 982 1022 1065 1108 1125 1126 1140 1148 
4 94 149 153 175 176 180 190 213 229 281 293 357 406 407 414 416 427 438 441 442 449 454 455 500 526 527 534 553 664 704 711 729 763 767 771 781 883 887 888 909 959 962 978 988 998 1003 1038 1049 1071 1107 1134 1142 
12 13 35 92 112 113 121 122 128 145 150 159 160 182 215 216 277 345 381 388 389 396 397 404 405 437 471 487 528 536 537 589 595 596 614 657 680 841 849 870 881 884 908 928 936 939 953 1016 1036 1092 1093 1143 
43 61 81 96 142 146 156 191 192 245 247 261 267 296 332 347 385 412 470 474 501 509 563 568 569 577 580 586 590 629 647 677 678 722 730 776 780 799 803 819 824 937 965 966 972 986 1014 1045 1063 1096 1124 
15 33 115 120 151 161 170 171 208 219 254 284 301 307 329 358 384 403 418 419 423 476 479 480 488 542 557 570 613 656 684 685 692 693 713 744 751 779 808 915 934 940 951 1005 1050 1103 
0 31 45 57 77 127 163 164 220 238 271 376 377 394 422 435 436 440 450 463 489 490 603 635 636 637 650 681 719 724 749 750 813 826 859 893 899 912 961 1098 1099 1130 1152 
25 27 41 53 59 126 188 189 255 289 309 343 356 359 421 457 458 461 462 531 554 560 597 612 626 627 705 717 718 728 757 766 812 822 836 925 926 974 981 1025 1111 
54 93 98 217 330 352 439 495 510 511 555 556 567 600 690 691 710 740 756 821 829 835 862 921 942 943 954 1024 1035 1039 1053 1058 1066 1072 1078 1109 1110 1119 1131 1132 1135 
64 158 333 336 337 355 428 447 448 578 611 682 707 708 731 755 764 765 791 875 903 983 993 1075 1115 
78 129 362 369 415 434 469 517 533 576 581 663 668 727 796 801 851 877 930 969 973 992 1079 1128 
8 51 66 67 104 263 266 372 400 477 478 492 516 582 607 640 660 733 753 759 1076 1121 
91 99 231 338 339 431 459 460 579 807 833 844 858 868 904 905 922 938 984 1007 1080 
89 224 257 258 424 625 655 745 773 805 806 933 989 1040 1074 1095 1106 
227 256 279 304 322 497 508 551 634 665 701 793 880 1081 1145 
3 20 21 63 143 335 443 545 628 667 768 769 1116 
110 125 133 134 312 429 452 453 543 544 746 804 997 
209 398 399 619 712 758 774 777 878 914 944 964 
200 310 379 653 683 697 698 721 787 970 1000 
202 466 467 573 679 706 762 782 855 890 927 
152 529 564 609 737 754 907 950 1030 1144 
173 259 486 584 662 699 818 906 916 1042 
141 775 815 845 866 929 957 1010 1062 
136 283 342 360 361 575 605 886 
367 548 549 604 748 867 1082 
602 646 1061 1070 1090 1102 1149 
17 346 371 616 760 987 
196 344 383 1087 1133 
