1 11 16 17 41 61 76 85 88 94 96 100 107 117 118 120 162 167 177 197 211 214 219 223 262 280 285 320 328 344 365 369 379 391 417 437 448 485 493 494 522 529 547 548 550 553 614 620 651 662 687 689 696 697 703 726 737 738 748 750 760 769 878 994 1046 1065 1096 1137 1144 
7 47 48 91 108 159 190 224 323 381 414 438 471 495 507 537 541 542 572 618 669 688 694 767 798 811 822 839 843 890 949 967 1019 1074 1084 1097 1101 1150 
35 202 203 254 523 524 535 645 682 695 785 786 831 889 897 995 999 1021 1023 1044 1066 1086 1104 
10 18 32 38 79 130 168 169 181 210 297 313 353 440 513 514 520 540 622 732 741 836 
36 163 164 220 238 239 271 326 370 394 408 463 505 582 607 640 810 826 946 1087 1133 
113 122 144 145 150 160 182 215 216 396 404 487 528 536 595 596 621 936 939 1143 
166 174 232 234 354 446 533 644 686 819 832 910 911 937 955 957 1004 1008 1113 1120 
30 105 366 449 501 556 642 679 814 853 947 1038 1059 1119 1127 1138 
54 55 93 405 710 740 954 1035 1053 1058 1078 1109 1110 1125 1131 
99 338 339 431 459 579 803 804 807 833 844 868 922 1007 1060 
12 101 114 378 409 410 538 546 584 672 699 778 876 945 
80 206 207 324 356 441 604 705 707 928 942 965 996 
2 172 429 587 736 756 835 845 846 1080 1085 1139 
4 5 225 273 302 439 503 637 652 987 1094 1135 
26 304 349 364 499 698 797 859 905 918 990 1032 
312 333 377 389 457 543 681 773 849 870 884 992 
50 265 316 393 465 468 552 776 892 912 1117 
72 322 380 539 570 615 639 725 802 917 950 
87 399 413 469 470 609 610 800 801 871 1079 
104 286 357 502 559 574 720 728 779 823 962 
109 135 148 237 295 296 340 341 700 948 1095 
398 416 588 713 758 774 777 944 951 964 1142 
433 442 481 567 788 854 883 941 958 988 1148 
59 527 551 627 683 824 827 925 1089 1145 
90 137 184 185 306 317 436 848 891 1048 
255 256 301 307 308 479 575 647 730 1103 
56 272 345 425 490 743 744 895 1050 
83 84 247 593 654 655 795 879 1146 
189 534 706 770 968 1031 1073 1077 1141 
6 29 86 115 242 243 373 374 
9 51 66 67 400 478 660 753 
31 131 420 576 757 1069 1099 1147 
81 199 474 568 857 959 969 986 
92 183 213 585 829 900 1036 1071 
123 472 680 745 933 952 978 1043 
146 192 284 562 780 856 1014 1049 
171 245 619 656 821 887 896 1045 
292 314 375 674 675 919 920 1051 
27 28 157 193 252 663 1111 
42 106 186 350 475 714 1026 
119 121 187 218 390 392 1037 
260 473 592 676 888 1003 1011 
352 599 600 641 722 1041 1123 
382 444 606 650 775 908 1108 
0 212 222 290 566 677 
8 311 332 591 739 935 
19 244 264 702 894 1112 
21 903 993 997 1075 1115 
33 39 44 456 787 1030 
57 455 489 636 782 790 
77 127 402 419 486 940 
112 403 549 678 692 1005 
133 395 430 544 746 975 
141 152 153 383 612 930 
147 852 1028 1047 1067 1100 
170 175 176 693 759 1121 
180 385 421 422 443 873 
226 450 598 603 1098 1152 
227 279 701 1033 1034 1054 
228 267 434 783 812 828 
269 270 476 671 747 882 
274 519 531 816 899 1013 
327 343 583 869 1126 1140 
329 484 648 772 931 984 
497 634 665 929 970 1128 
508 509 580 589 799 972 
558 564 673 874 1091 1136 
15 151 158 563 586 
68 74 387 506 985 
69 749 886 982 991 
73 217 288 318 321 
97 179 631 709 817 
132 261 300 733 1114 
138 342 624 670 762 
140 578 597 727 1040 
143 794 818 860 960 
229 415 526 763 796 
258 362 661 754 907 
263 289 372 516 1076 
346 347 361 625 808 
355 561 635 815 974 
388 629 657 1083 1124 
411 608 643 1055 1056 
427 649 791 793 1081 
3 330 492 858 
14 406 407 729 
20 154 235 573 
22 266 451 902 
24 25 461 462 
34 60 128 557 
37 253 310 1000 
40 188 196 628 
43 200 246 721 
46 334 716 766 
49 359 554 789 
53 155 221 961 
58 75 249 386 
62 335 684 768 
64 545 715 755 
65 251 351 565 
70 194 201 880 
82 483 613 1042 
89 325 337 426 
95 178 282 837 
110 838 932 1006 
124 268 1027 1151 
129 331 496 581 
139 336 708 809 
142 491 569 723 
149 281 664 704 
156 841 983 1009 
173 376 525 916 
195 368 466 467 
233 275 685 825 
240 480 488 973 
248 299 532 1015 
277 445 881 1020 
283 510 511 906 
291 504 617 1016 
298 423 915 1057 
303 454 781 924 
464 500 632 633 
521 605 898 971 
555 862 921 1024 
626 717 718 872 
646 1061 1090 1149 
690 691 1039 1132 
724 792 820 1022 
45 367 616 
78 850 851 
98 276 1012 
102 512 901 
111 909 998 
125 401 875 
126 458 477 
209 712 934 
278 498 885 
287 784 830 
358 530 638 
371 1025 1072 
397 943 953 
418 601 623 
428 813 977 
452 731 989 
460 482 1116 
517 518 877 
560 658 867 
590 761 863 
602 1070 1102 
666 667 771 
734 963 1052 
742 913 923 
805 806 1106 
842 904 976 
