7 14 26 29 34 40 43 47 48 60 61 64 76 81 82 85 96 100 101 102 107 108 111 116 135 140 146 155 156 166 167 185 191 195 198 199 207 211 221 223 235 236 237 241 242 243 244 245 247 261 267 290 295 296 302 303 305 319 323 324 325 328 331 333 341 363 364 373 374 385 401 402 412 421 445 447 470 498 501 509 514 518 529 563 568 569 572 577 580 586 590 593 598 608 609 618 626 629 638 647 649 658 659 666 672 677 678 694 696 700 716 722 730 737 738 742 754 755 764 765 776 784 791 794 798 799 800 803 811 824 836 839 842 861 863 870 875 901 903 907 913 919 923 924 946 948 949 955 958 960 965 966 972 974 983 986 993 1002 1009 1019 1029 1032 1045 1063 1084 1096 1097 1101 1115 1122 1124 1144 1146 
2 6 22 23 24 36 37 49 65 87 88 97 106 138 139 144 179 203 204 205 214 224 227 228 230 232 234 239 253 256 260 263 279 285 301 304 315 316 321 322 336 337 350 354 367 370 380 410 446 451 472 483 491 493 497 504 505 508 525 548 549 551 552 565 570 571 578 587 588 594 603 604 617 622 624 630 634 644 655 665 676 682 686 687 701 702 707 708 709 715 723 728 731 736 748 752 761 770 789 793 797 810 817 827 831 846 856 867 869 871 874 876 879 880 882 888 894 895 902 904 910 911 916 945 968 976 991 1003 1004 1006 1008 1013 1017 1018 1023 1026 1043 1044 1057 1075 1077 1081 1082 1085 1088 1089 1091 1094 1098 1113 1120 1139 1145 
1 10 18 19 30 32 38 39 42 44 46 52 58 62 70 71 72 73 74 75 79 80 103 105 118 119 130 131 132 147 148 157 162 165 168 169 174 178 181 186 193 194 197 218 222 225 226 246 248 249 252 262 264 274 275 276 278 282 286 287 288 297 298 300 313 318 320 334 340 348 349 353 378 382 386 387 390 392 395 417 420 456 464 473 494 496 499 506 512 513 519 520 530 532 539 540 558 566 592 606 632 633 642 661 669 688 689 720 732 734 739 741 772 783 790 802 825 828 830 840 873 896 935 947 967 985 990 1012 1015 1037 1059 1060 1067 1069 1100 1105 1112 1114 1127 1129 1138 1147 
5 8 55 69 83 84 109 125 158 172 173 177 206 213 259 268 269 270 281 291 292 306 308 311 314 351 355 365 366 375 393 408 428 438 444 448 452 453 475 486 502 521 543 544 574 583 584 585 591 601 623 654 662 664 670 671 674 675 699 714 725 735 743 746 747 767 788 818 820 832 850 854 885 900 906 918 920 941 956 982 997 1022 1042 1108 1125 1126 1140 1148 
9 11 68 86 95 114 117 123 124 183 187 201 210 212 233 250 251 272 273 280 299 326 327 391 409 430 482 484 485 503 507 522 538 545 546 547 550 562 620 621 639 641 648 651 652 673 703 726 778 785 786 792 816 837 838 843 857 872 931 971 996 1011 1020 1033 1034 1041 1046 1054 1123 1136 1137 1150 
17 50 90 137 184 240 265 317 346 371 411 413 426 465 468 515 523 524 541 559 599 610 615 616 631 643 645 650 695 760 795 809 814 823 834 848 853 860 889 891 892 897 898 917 952 963 975 977 987 995 999 1021 1027 1031 1047 1048 1051 1052 1055 1056 1073 1083 1086 1104 1117 1141 1151 
4 94 149 153 175 176 180 190 192 200 229 293 310 357 379 406 407 414 415 416 427 441 442 449 455 500 526 527 534 553 653 683 697 698 704 711 721 729 763 771 780 781 787 883 887 909 959 962 970 978 988 998 1000 1014 1038 1049 1068 1071 1107 1134 1142 
0 31 45 56 57 77 127 220 376 394 422 425 433 435 436 440 450 463 481 489 490 561 602 611 635 636 637 646 681 719 724 749 750 813 859 893 899 912 961 1061 1070 1090 1099 1102 1130 1149 1152 
16 25 27 41 53 59 126 154 188 189 255 289 309 343 356 359 457 458 461 462 531 554 560 597 612 627 705 717 718 757 766 812 822 925 926 981 994 1025 1111 
33 115 120 161 170 171 219 254 284 329 358 384 403 418 419 423 432 474 542 557 613 656 684 692 693 713 744 751 852 915 934 940 951 1005 1028 1050 1064 1065 
54 93 98 330 352 439 495 510 511 555 556 600 690 691 710 740 821 829 862 921 942 943 954 1024 1035 1039 1053 1058 1066 1072 1078 1109 1110 1119 1131 1132 1135 
78 129 141 163 164 238 271 362 369 434 469 517 533 576 581 663 668 727 775 796 801 815 826 845 851 866 877 929 930 957 969 973 992 1010 1062 1079 1128 
35 92 112 113 121 122 128 145 150 159 160 182 215 216 345 381 396 397 404 405 471 487 528 536 537 589 595 596 614 936 939 953 1016 1036 1143 
51 66 67 104 266 294 400 477 478 492 516 582 607 640 660 733 753 759 847 1076 1121 
15 151 208 231 307 338 339 431 459 460 476 479 480 488 579 685 779 808 844 1103 
3 20 21 63 143 196 335 344 383 443 628 667 768 769 1087 1116 1133 
12 13 277 388 389 437 657 680 841 849 881 884 908 928 932 1092 1093 
28 142 202 368 454 466 467 573 679 706 762 782 855 890 927 1001 1118 
91 99 217 372 567 756 807 833 835 858 868 905 922 938 984 1007 1080 
89 257 258 377 424 625 745 773 805 806 933 989 1040 1074 1095 1106 
209 398 399 619 712 758 774 777 878 914 944 964 
136 283 342 360 361 535 575 605 886 
152 332 347 564 819 937 950 1030 
110 133 134 312 429 804 
