7 47 48 54 55 91 92 93 108 112 113 122 125 143 144 145 149 150 159 160 170 175 176 182 183 190 213 215 216 224 280 281 309 319 323 327 343 365 381 396 403 404 405 414 438 441 442 445 471 487 495 507 528 536 537 541 542 549 572 583 585 595 596 618 621 638 664 669 678 688 690 691 692 693 694 704 710 740 759 767 771 798 811 818 822 829 839 843 869 875 883 890 900 913 936 939 949 954 960 967 1005 1019 1035 1036 1039 1053 1058 1071 1074 1078 1084 1097 1101 1107 1109 1110 1121 1125 1126 1131 1132 1134 1140 1143 1150 
8 15 18 28 31 32 38 51 79 109 130 131 135 148 151 158 168 169 181 206 207 225 236 265 291 295 296 305 311 313 332 340 341 355 356 389 392 400 408 420 435 436 440 465 478 513 514 529 540 561 576 577 578 591 597 604 617 635 660 701 705 707 724 725 732 734 739 741 753 757 792 820 833 836 892 907 912 928 935 948 950 963 974 996 1016 1022 1033 1034 1040 1052 1054 1063 1069 1095 1099 1130 1147 
1 9 11 16 41 61 68 70 74 76 82 85 88 94 95 96 100 107 117 118 120 162 167 177 178 194 197 201 210 211 214 219 223 233 262 275 282 285 320 328 344 369 379 387 391 417 437 448 485 493 494 506 530 547 550 553 613 620 637 651 662 666 667 685 687 689 696 697 703 726 737 738 748 750 769 794 825 837 838 842 860 878 880 976 985 994 1046 1065 1096 1137 1144 
42 69 90 106 119 121 136 137 165 171 184 185 186 187 218 245 250 255 256 292 301 306 307 308 314 317 338 339 350 375 390 428 431 459 460 475 479 482 515 522 555 575 579 614 619 647 656 674 675 749 813 821 844 848 862 886 887 891 896 919 920 921 923 977 982 991 1024 1026 1037 1045 1048 1051 1103 1116 
14 34 35 60 77 127 128 156 189 202 203 263 289 402 406 407 419 447 486 516 523 524 534 535 557 594 611 645 646 679 695 706 729 770 785 786 855 889 897 927 931 940 968 983 984 995 999 1009 1017 1018 1021 1023 1031 1044 1061 1066 1068 1076 1077 1086 1090 1104 1149 
23 36 49 161 163 164 166 174 198 220 230 232 234 238 239 260 271 315 316 354 359 370 393 394 446 463 473 483 517 518 533 552 554 571 582 590 592 607 644 676 683 686 761 789 819 826 832 863 877 888 910 911 914 937 955 957 1003 1004 1008 1011 1082 1113 1120 
0 52 58 64 75 212 222 228 249 257 258 259 267 274 283 290 312 333 362 371 377 386 412 424 434 457 510 511 519 531 543 545 560 566 658 661 677 681 711 715 754 755 773 783 805 806 812 816 828 849 867 870 884 899 906 992 1025 1072 1106 
12 56 59 101 105 114 269 270 272 345 372 378 409 410 425 452 476 490 504 505 527 538 546 551 558 564 627 636 671 672 673 699 730 731 743 744 747 778 824 827 874 876 882 895 925 945 989 1050 1057 1089 1091 1136 1145 
2 5 21 33 39 44 50 172 208 231 273 297 302 326 353 360 429 439 456 503 587 652 659 736 756 764 765 776 787 835 840 845 846 903 987 993 997 1013 1030 1075 1080 1085 1094 1115 1122 1135 1139 
10 30 80 81 89 199 324 325 337 346 347 352 358 361 366 401 426 449 474 501 556 568 599 600 625 641 642 722 808 814 853 857 932 942 947 959 965 969 986 1006 1038 1041 1059 1119 1123 1127 1138 
71 111 124 139 154 180 229 268 279 303 310 336 342 385 415 418 421 422 454 526 573 601 623 708 751 762 763 781 782 796 809 817 858 861 873 909 924 1000 1027 1151 
3 20 22 57 63 67 97 129 138 140 179 204 235 261 266 293 294 331 443 451 455 464 489 496 500 581 624 631 632 633 653 670 709 727 847 
19 27 103 104 116 157 193 241 244 248 252 264 286 299 357 468 502 532 559 574 663 702 714 720 728 779 790 823 894 962 1015 1088 1111 1112 1117 
4 6 17 29 40 86 115 188 195 196 209 227 242 243 368 373 374 467 508 509 580 589 628 712 760 799 934 972 1001 1002 1029 1118 
102 146 147 173 192 205 284 376 466 512 525 562 563 584 630 780 852 856 893 901 916 1014 1028 1047 1049 1067 1100 
26 37 123 253 304 349 364 472 499 520 622 680 698 745 797 859 902 904 905 918 933 952 978 990 1032 1043 
45 87 277 278 367 399 413 469 470 498 609 610 616 650 800 801 871 881 885 1020 1073 1079 1141 
62 142 254 329 335 348 384 453 484 491 569 640 648 684 719 723 768 772 834 866 981 1010 1062 
13 53 155 221 388 432 629 657 810 841 961 966 1064 1083 1087 1092 1093 1124 1133 
110 133 134 226 363 395 430 450 544 598 602 603 746 938 975 1070 1098 1102 1152 
126 237 398 416 477 588 713 758 774 777 944 946 951 964 998 1142 
24 25 427 458 461 462 626 649 717 718 791 793 872 930 1081 
66 141 152 153 240 383 480 488 521 605 612 700 898 971 973 
191 397 433 481 567 586 735 788 854 941 943 953 958 988 1148 
83 84 132 247 300 593 654 655 733 742 795 879 1114 1146 
46 330 334 411 492 548 608 643 716 766 1042 1055 1056 
98 99 276 803 804 807 868 922 1007 1012 1060 1105 1129 
65 73 217 251 288 298 318 321 351 423 565 915 
78 382 444 606 775 815 850 851 908 926 956 1108 
72 322 380 539 570 615 639 668 752 802 917 
497 634 665 682 831 929 970 1128 
43 200 246 287 721 784 830 
