12 25 30 37 44 45 56 57 68 69 83 98 99 102 114 123 129 130 131 134 139 152 153 169 180 201 202 203 228 229 233 234 245 250 279 302 303 304 310 314 315 321 322 329 335 340 342 360 363 378 383 406 409 410 411 415 416 421 422 427 429 430 435 439 440 452 454 455 462 467 481 489 490 491 493 497 508 521 526 527 533 546 547 548 549 551 558 564 565 566 573 577 593 599 601 615 624 631 635 636 637 642 654 669 672 673 674 678 679 681 684 692 701 706 710 719 724 732 745 747 748 751 763 772 778 781 782 785 786 787 792 796 802 813 827 830 831 832 836 855 866 873 876 877 885 893 903 909 912 919 920 933 937 957 966 969 978 988 996 998 1005 1033 1034 1039 1052 1054 1059 1060 1068 1069 1072 1112 1127 1136 1145 1146 1150 
0 1 10 11 18 19 23 28 32 33 38 39 42 43 46 52 58 59 61 62 70 73 74 76 77 78 79 80 95 96 107 108 117 118 132 148 157 162 168 174 175 176 178 179 181 186 187 193 194 197 210 211 212 218 222 225 226 246 247 248 249 251 252 264 275 276 282 286 287 297 298 313 318 334 341 353 375 382 386 387 392 417 420 423 434 448 453 456 485 486 496 499 506 512 513 520 532 538 539 540 550 572 620 622 661 663 676 688 698 734 754 757 773 775 783 812 825 828 840 847 869 894 904 905 917 929 935 947 953 958 967 974 976 982 990 994 1029 1036 1037 1096 1101 1137 
27 47 48 65 87 88 110 111 138 140 198 199 204 223 224 230 235 236 237 244 268 295 296 312 324 327 328 336 343 344 356 359 361 370 376 377 390 391 457 458 469 470 482 507 509 522 523 524 541 542 607 609 610 612 625 628 638 643 649 657 667 670 682 696 700 703 705 707 708 715 727 731 737 738 761 762 791 808 822 838 839 857 863 871 872 926 928 930 965 989 1006 1030 1046 1067 1075 1076 1086 1095 1104 1111 1115 1133 1141 1144 
16 24 81 82 97 146 147 172 173 191 192 205 219 257 259 267 283 284 330 424 466 525 530 562 563 569 583 584 585 629 630 646 651 662 711 714 718 726 736 752 753 780 837 856 906 916 927 941 956 972 975 1001 1014 1025 1028 1042 1049 1064 1100 1102 1126 1140 1148 1149 
34 35 53 156 255 256 288 289 300 301 307 308 479 534 535 575 580 581 590 626 634 647 655 658 665 695 730 742 770 776 795 797 798 799 800 819 823 824 841 858 879 889 896 908 925 931 968 984 985 1031 1066 1077 1089 1093 1103 1114 1122 1124 1128 
2 3 119 120 127 128 149 161 165 170 171 232 277 278 309 316 384 385 402 403 418 419 461 492 503 557 613 619 641 644 645 656 699 709 860 886 934 940 951 961 999 1018 1020 1041 1047 1092 1123 1135 1139 
71 72 84 105 106 231 240 241 269 270 291 292 293 338 339 348 394 431 432 449 459 475 476 504 505 579 587 588 671 675 743 749 790 820 833 844 882 924 991 995 1051 1055 1085 
4 5 17 91 92 93 94 150 182 183 190 213 214 280 281 323 351 352 365 438 495 511 552 554 618 664 694 704 760 767 829 900 943 962 963 987 1010 1071 1084 1097 1143 
6 21 41 64 103 104 116 126 142 151 208 258 263 357 358 371 372 472 500 502 559 560 571 574 597 608 639 648 685 720 728 766 779 1008 1040 1043 1113 1120 
36 100 101 125 143 166 167 177 200 261 285 319 320 325 331 354 414 445 494 568 586 666 683 687 689 794 814 818 878 880 881 901 913 960 1000 1038 
89 90 136 137 184 185 305 306 317 428 436 464 465 468 514 515 561 606 650 702 842 843 848 853 868 891 892 977 1044 1048 1073 1117 1130 
7 20 26 29 40 85 86 115 135 154 195 196 207 209 221 227 242 243 368 373 374 401 498 852 899 948 949 1002 1023 1032 1056 1118 
112 113 121 122 144 145 159 160 215 216 381 396 397 404 405 471 487 528 536 537 595 596 614 621 936 939 
155 407 450 576 589 616 617 668 722 735 793 809 897 898 1016 1021 1022 1027 1074 1081 1108 1151 1152 
8 31 60 109 158 206 265 332 333 355 393 408 444 529 578 591 739 845 861 1065 
272 273 326 510 555 556 602 603 652 821 862 902 921 1012 1024 1045 1094 1098 1119 
54 55 217 567 740 741 756 835 846 854 942 971 1007 1053 1080 1088 1125 1131 
9 51 63 66 67 75 266 400 477 478 516 582 640 660 733 759 
49 50 253 254 388 446 447 553 594 680 789 834 914 992 1079 
274 290 349 483 519 531 545 598 750 755 816 859 875 910 
262 299 366 367 380 412 413 570 697 721 725 867 
163 164 220 238 239 271 463 632 633 815 826 
260 311 389 437 543 746 849 870 884 907 
398 399 627 712 713 758 774 777 944 964 
22 379 604 653 959 970 1013 1082 1142 
346 347 426 501 605 801 932 1083 
13 716 810 811 946 1015 1087 
345 425 600 693 744 895 1050 
954 1035 1058 1061 1070 1078 1090 
14 15 480 484 488 973 
124 611 659 784 788 890 
362 451 517 518 723 915 
473 474 887 888 1003 1004 
803 804 807 922 938 986 
337 544 955 993 997 
364 850 851 923 950 
188 189 433 1011 
441 442 771 883 
443 460 717 1116 
983 1009 1017 1019 
133 395 945 
350 1026 1147 
623 686 1138 
677 729 1063 
690 691 1132 
805 806 1106 
874 1057 1091 
