7 14 26 29 40 43 47 48 61 81 82 85 96 100 101 102 107 108 111 116 135 140 146 154 155 156 166 167 187 191 192 195 198 199 207 211 221 223 235 236 237 241 242 243 244 245 261 267 269 290 295 296 302 303 305 319 323 324 325 328 331 332 333 341 347 363 364 373 374 377 401 402 412 421 445 470 498 501 509 514 518 563 569 572 577 580 586 590 593 598 608 618 626 629 638 647 649 658 659 666 672 677 678 694 696 700 716 722 730 737 738 742 776 780 784 794 799 800 803 819 823 824 836 839 842 861 863 870 901 913 919 923 924 932 937 946 948 949 955 958 960 965 966 972 974 986 1009 1014 1019 1032 1045 1063 1084 1096 1097 1101 1122 1124 1144 1146 
1 10 18 19 30 32 38 39 42 44 46 52 58 62 70 71 72 73 74 79 80 105 118 119 130 131 132 147 148 157 162 165 168 169 174 178 181 186 193 194 197 218 222 225 226 246 248 249 252 262 264 274 275 276 278 282 286 287 288 297 298 300 313 318 320 334 340 348 349 353 368 378 382 385 386 387 390 392 395 417 420 456 464 473 485 494 496 499 506 512 513 519 520 530 532 539 540 558 566 592 606 632 633 642 661 669 688 689 720 732 734 739 741 772 783 790 802 825 828 830 840 873 896 935 947 967 973 985 990 1001 1012 1015 1037 1059 1060 1067 1069 1100 1105 1112 1114 1118 1127 1129 1137 1138 1147 
2 34 36 37 49 64 65 75 97 103 106 144 158 179 203 224 228 239 253 270 285 315 367 410 411 434 451 472 491 493 504 505 523 524 525 549 559 587 594 603 604 631 643 645 655 676 687 695 702 709 723 736 748 755 770 789 791 797 798 810 811 814 817 827 831 867 874 875 882 889 894 897 898 902 945 952 963 968 975 983 991 995 999 1017 1018 1021 1023 1043 1044 1047 1051 1052 1055 1056 1057 1068 1077 1085 1086 1088 1089 1091 1094 1098 1104 1139 1141 
5 8 55 69 83 84 109 110 125 133 134 172 177 206 213 268 281 291 292 306 308 311 312 314 351 355 365 366 375 393 408 428 429 438 444 452 453 475 502 521 543 544 583 585 591 601 623 654 664 670 671 674 675 725 735 746 747 767 788 804 820 832 850 854 869 885 900 918 920 941 956 982 997 1022 1108 1125 1126 1140 1148 
9 11 68 76 86 95 114 117 123 124 183 201 210 212 233 247 250 251 272 273 280 299 326 327 391 409 430 482 484 503 507 522 538 545 546 547 550 562 568 620 621 639 641 648 651 652 653 673 703 726 778 785 786 792 816 837 838 843 857 872 931 971 996 1011 1020 1033 1034 1041 1046 1054 1123 1136 1150 
12 13 17 22 23 33 115 120 161 170 171 219 227 256 260 266 279 301 321 322 329 384 413 418 419 426 474 497 508 551 557 565 570 599 613 615 644 665 701 713 751 752 760 795 860 879 880 915 917 928 934 940 951 987 1027 1031 1065 1083 1145 1151 
4 94 149 153 175 176 180 190 229 293 357 379 406 407 414 415 416 427 441 442 449 455 500 526 527 534 553 683 704 711 763 766 771 787 883 887 888 909 959 962 970 978 988 998 1003 1038 1049 1071 1107 1134 1142 
6 24 87 88 138 139 204 205 230 232 234 263 294 336 337 370 446 447 578 588 609 610 617 624 682 707 708 715 731 754 761 764 765 846 847 856 871 895 903 907 910 911 993 1004 1006 1008 1075 1113 1115 1120 
35 92 112 113 121 122 128 145 150 159 160 182 215 216 277 345 381 388 389 396 397 404 405 437 471 487 528 536 537 589 595 596 614 657 680 841 849 881 884 908 936 939 953 1016 1036 1092 1093 1143 
31 45 56 57 77 127 163 164 220 238 271 376 394 422 425 433 435 436 440 450 463 481 489 490 561 602 611 635 636 637 646 681 719 724 749 813 826 893 912 1061 1070 1090 1099 1102 1130 1149 1152 
16 25 27 41 53 59 126 173 188 189 255 289 309 343 356 359 448 457 458 461 462 531 554 560 597 612 627 630 705 717 718 728 757 812 822 916 925 926 981 994 1025 1111 
54 93 98 217 330 352 439 495 510 511 555 556 567 600 690 691 710 740 756 821 829 835 862 921 942 943 954 1024 1035 1039 1053 1058 1066 1072 1078 1109 1110 1119 1131 1132 1135 
0 15 151 208 254 259 284 307 358 403 423 476 479 480 488 574 656 684 685 692 693 714 743 744 750 779 808 859 899 961 1005 1050 1103 
78 129 141 362 369 469 517 533 576 581 663 668 727 775 796 801 815 845 851 866 877 929 930 957 969 992 1010 1062 1079 1128 
50 90 137 184 185 240 265 316 317 346 371 465 468 515 541 552 616 650 809 834 848 853 891 892 977 1013 1048 1073 1117 
60 89 136 257 258 283 342 360 361 424 535 575 605 625 745 773 805 806 886 933 989 1040 1074 1095 1106 
28 142 200 202 310 454 466 467 573 679 697 698 706 721 729 762 781 782 855 890 927 1000 
51 66 67 104 372 400 477 478 492 516 529 582 607 640 660 733 753 759 1076 1121 
91 99 231 338 339 431 459 460 579 807 833 844 858 868 905 922 938 984 1007 1080 
3 20 21 63 143 196 335 344 383 443 628 667 768 769 1087 1116 1133 
214 350 354 380 483 548 571 622 686 904 976 1026 1082 
209 398 399 619 712 758 774 777 878 914 944 964 
486 584 662 699 818 906 1042 
304 634 793 876 1081 
432 542 852 1028 1064 
152 564 950 1030 
