47 48 100 108 112 113 122 125 143 144 145 159 167 215 216 235 236 309 319 323 324 369 381 396 401 404 405 414 445 471 487 495 507 528 536 537 572 595 596 618 638 649 666 688 694 703 798 818 822 839 843 875 881 890 913 936 939 948 949 953 960 967 1009 1019 1029 1074 1084 1097 1101 
2 36 37 163 164 220 238 271 370 394 451 463 493 518 582 736 797 826 901 902 1077 1085 1139 
11 38 39 58 131 132 168 174 225 313 353 392 420 513 540 576 598 757 1037 1069 1147 
84 166 232 234 354 533 587 644 832 856 888 910 911 955 957 1003 1004 1008 1082 1113 1120 
245 255 256 301 307 308 469 470 479 619 647 801 803 821 887 896 1045 1103 
6 7 20 29 86 115 154 196 209 242 243 373 374 498 545 573 712 
4 5 273 302 326 439 503 652 673 987 1039 1060 1094 1131 1135 1136 
105 231 269 270 338 339 431 432 459 504 505 579 588 671 844 882 
71 111 124 189 268 310 342 422 706 762 782 861 909 1000 1141 
76 107 130 177 320 325 328 426 494 605 687 689 696 833 878 
69 109 291 306 543 674 675 747 886 919 920 982 1051 1130 
129 138 180 331 385 496 541 624 670 804 807 851 868 922 
172 173 205 257 259 475 525 584 585 714 780 885 900 916 
406 523 524 631 645 695 729 897 995 999 1021 1076 1086 1104 
8 9 51 66 67 114 266 400 478 591 660 739 935 
21 104 286 357 502 559 571 574 685 720 728 779 962 
30 366 449 556 669 772 814 853 947 1059 1119 1127 1138 
397 398 627 683 758 774 777 827 925 941 944 964 1148 
0 249 297 298 362 434 443 520 661 677 754 907 
16 17 43 96 417 437 697 721 760 994 1028 1038 
10 32 169 181 305 314 375 440 558 642 741 
26 27 157 193 364 812 859 990 1015 1032 1111 
62 142 253 254 446 569 594 684 834 914 1079 
15 151 158 227 279 389 529 578 597 1040 
136 137 185 210 250 317 546 848 891 1048 
149 150 190 281 455 664 699 704 713 951 
509 575 580 581 589 590 730 799 823 1016 
12 101 378 538 672 731 876 928 945 
14 135 148 186 340 341 734 1023 1095 
72 120 161 171 418 419 557 934 940 
91 98 99 217 756 835 1007 1012 1080 
146 192 284 530 562 711 753 1014 1049 
229 415 421 526 527 763 796 873 877 
261 337 682 707 708 903 993 1075 1115 
334 608 643 716 766 810 811 1055 1056 
349 410 499 570 623 686 698 905 918 
539 615 794 795 802 860 889 917 1031 
690 691 943 954 1035 1058 1109 1110 1132 
18 79 147 456 852 1047 1067 1100 
45 346 347 361 367 609 616 808 
57 435 489 635 636 724 893 912 
59 359 551 554 607 793 1081 1145 
80 207 295 296 358 705 942 965 
97 179 203 452 709 817 831 1044 
450 603 617 678 692 975 1098 1152 
3 327 343 583 1018 1126 1140 
52 239 276 464 500 632 633 
55 355 428 654 813 854 1125 
117 213 214 365 438 767 1071 
265 465 468 514 515 892 1117 
303 454 601 748 781 924 1068 
602 646 1061 1070 1090 1102 1149 
1 162 280 387 547 869 
13 61 966 1087 1096 1133 
19 663 842 904 976 977 
54 93 710 740 1053 1078 
56 160 272 345 425 561 
73 288 304 318 321 879 
75 103 386 1027 1088 1151 
78 178 211 263 282 837 
88 651 737 750 930 1144 
133 395 430 544 746 997 
152 383 521 612 700 933 
170 175 176 693 759 1121 
244 264 462 593 894 1146 
333 457 849 870 908 992 
441 442 534 771 883 988 
460 482 639 923 1043 1116 
484 491 648 723 1057 1091 
792 820 1022 1033 1034 1054 
22 63 204 230 532 
34 128 402 447 1066 
41 126 356 458 477 
42 106 350 991 1026 
53 380 657 1064 1083 
65 275 351 563 586 
74 368 884 1001 1118 
81 199 937 959 986 
82 118 483 531 613 
87 110 838 932 1006 
90 184 252 436 702 
165 292 606 650 1073 
182 233 825 1143 1150 
187 212 222 290 566 
195 202 466 467 1002 
200 246 287 784 830 
237 427 626 872 946 
251 641 653 1041 1123 
278 330 492 829 1042 
283 510 511 535 906 
315 316 552 656 1005 
352 599 600 722 790 
399 413 610 800 871 
476 743 744 895 1050 
577 732 836 974 1063 
23 155 198 221 
25 448 773 981 
28 604 676 1142 
35 388 629 1124 
44 208 335 787 
70 194 201 880 
83 300 733 1114 
89 412 424 989 
94 391 668 1046 
121 390 522 614 
127 139 486 662 
260 564 565 622 
267 717 718 972 
289 516 770 858 
293 379 407 667 
382 444 775 1108 
416 553 778 998 
497 634 665 1128 
517 857 969 996 
555 862 921 1024 
816 899 961 1013 
24 116 630 
31 77 1099 
40 188 628 
46 262 738 
49 119 789 
60 85 344 
64 715 791 
102 701 968 
123 680 952 
134 453 640 
140 727 958 
141 815 845 
153 372 490 
156 785 786 
183 218 620 
197 226 519 
206 788 850 
219 223 542 
224 655 1089 
228 783 874 
241 751 855 
248 621 726 
285 472 506 
311 433 481 
322 488 973 
336 625 809 
371 1025 1072 
376 377 637 
393 485 1137 
408 725 950 
409 898 971 
411 963 1052 
473 592 1011 
501 679 927 
560 658 867 
567 846 1030 
611 742 824 
755 983 1017 
768 769 1065 
805 806 1106 
