8 9 10 15 18 30 31 32 38 51 63 66 78 105 130 131 151 158 168 169 170 175 176 181 191 204 210 225 227 241 265 270 276 291 305 311 313 332 338 339 355 366 382 400 420 431 432 440 444 445 449 453 459 465 468 478 501 504 513 514 529 540 556 561 566 576 577 578 579 591 597 598 606 635 640 642 660 671 679 693 732 735 739 741 751 757 759 775 792 814 815 820 833 836 844 850 853 854 855 892 912 926 927 935 956 974 991 1022 1037 1040 1054 1059 1063 1069 1099 1108 1117 1119 1121 1127 1138 1147 
4 7 47 48 91 92 108 112 113 122 125 144 145 149 150 159 160 182 183 190 213 215 216 224 281 309 319 323 327 343 381 396 401 403 404 414 438 460 471 482 487 495 507 528 536 537 541 542 549 572 583 585 595 596 618 621 664 669 688 694 704 742 767 798 811 822 829 839 843 875 890 900 913 923 936 939 947 949 953 959 967 1005 1019 1036 1071 1074 1084 1097 1101 1107 1116 1126 1134 1140 1143 1150 
16 17 25 41 49 61 85 94 96 100 107 117 119 120 143 167 177 214 218 219 223 262 285 320 328 344 359 365 369 379 391 417 437 448 469 470 485 493 494 550 553 554 620 662 666 667 687 689 696 697 703 738 748 755 760 768 769 771 789 794 818 860 878 960 983 994 1009 1038 1046 1065 1096 1137 
1 24 33 39 44 50 65 68 70 88 95 104 116 118 162 178 194 197 201 208 211 231 233 236 247 251 263 275 280 286 351 353 357 387 423 456 476 502 547 559 562 563 568 571 574 586 630 651 685 720 726 728 737 743 744 750 776 779 787 823 825 837 869 880 881 962 985 1050 1144 
12 56 59 101 114 349 378 397 409 410 425 427 433 452 481 499 527 538 551 558 564 607 623 626 627 636 649 672 673 683 686 690 691 698 699 719 731 788 791 793 824 827 866 872 874 876 918 925 930 941 943 945 954 958 1010 1035 1058 1062 1079 1081 1089 1109 1110 1115 1132 1136 1145 1148 
37 57 67 93 97 109 111 129 179 180 253 266 294 303 310 331 342 385 398 405 415 416 418 421 422 443 454 455 489 492 496 526 588 601 624 631 670 709 710 713 758 762 763 774 777 778 781 782 790 796 807 817 847 858 873 909 922 924 944 951 964 998 1000 1068 1142 
2 36 138 139 172 229 230 232 316 326 360 370 393 394 407 408 451 463 505 517 518 552 582 587 602 603 617 659 715 736 845 877 902 914 1016 1070 1085 1098 1102 1139 
14 35 98 99 156 202 203 254 293 406 429 523 524 535 594 645 729 785 786 803 804 863 868 897 995 999 1007 1012 1017 1018 1021 1023 1044 1060 1066 1076 1086 1104 1105 1129 
62 80 135 142 148 186 187 206 207 295 296 324 335 340 341 356 411 569 604 676 684 701 705 707 734 834 928 942 948 963 965 981 996 1033 1034 1052 1095 
42 106 171 245 250 255 256 301 307 308 350 475 479 515 522 546 555 575 614 619 647 695 725 821 851 862 887 896 921 950 1024 1026 1045 1103 
11 79 102 123 147 274 441 442 472 506 512 539 570 615 639 668 680 745 752 802 852 883 901 917 933 952 978 988 1028 1043 1047 1067 1100 
21 34 83 84 128 132 189 261 300 447 557 593 654 655 706 733 764 765 770 795 879 889 903 968 993 997 1031 1073 1075 1077 1114 1141 1146 
81 166 174 199 234 354 446 474 533 548 590 644 761 819 832 840 856 857 895 910 911 937 955 957 969 986 1004 1008 1082 1113 1120 1122 
23 58 75 76 87 89 126 198 237 289 325 336 337 346 347 361 386 426 477 516 625 650 708 801 808 809 838 932 946 989 1006 
69 90 136 137 165 184 185 292 306 314 317 375 428 435 436 543 674 675 681 749 813 848 886 891 919 920 977 982 1048 1051 1130 
26 27 28 121 157 193 248 252 297 299 304 364 390 392 458 520 532 622 663 717 718 797 859 904 905 990 1015 1032 1111 
141 152 240 260 279 322 358 383 473 480 488 521 530 565 592 605 612 638 700 888 898 971 973 1003 1011 
0 52 212 222 228 249 258 267 290 362 434 545 661 677 711 754 783 805 806 812 828 907 1106 
5 54 55 273 302 439 503 567 637 652 740 756 835 846 987 1030 1039 1053 1080 1094 1125 1131 1135 
6 13 29 86 115 195 209 242 243 368 373 374 467 712 810 884 934 966 1002 1029 1087 1118 1133 
146 192 205 257 259 283 284 376 412 424 466 510 511 525 584 714 753 780 893 906 1001 1014 1049 
22 163 164 220 238 239 271 464 497 500 632 633 634 665 682 826 831 929 970 1128 
64 73 74 82 173 217 288 318 321 371 483 519 531 613 816 899 916 1013 1025 1072 
19 43 200 244 246 264 282 287 461 462 702 721 784 830 842 894 976 1112 
72 77 127 161 315 402 419 486 611 646 656 940 1061 1078 1090 1149 
20 140 154 235 352 573 599 600 641 653 722 724 727 1041 1123 
53 155 221 380 388 389 629 657 841 961 1064 1083 1092 1093 1124 
60 103 312 333 377 457 560 658 773 849 867 870 908 992 1088 
110 133 134 226 363 395 430 450 544 678 692 746 938 975 1152 
298 329 348 384 484 491 534 648 723 772 915 931 984 1057 1091 
45 277 278 367 399 413 498 609 610 616 800 871 885 1020 
40 188 196 508 509 580 581 589 628 730 799 972 
3 46 330 334 608 643 716 766 1042 1055 1056 
71 124 268 269 861 1027 1151 
153 272 345 372 490 747 882 
