7 33 39 44 47 48 50 54 55 91 92 93 108 112 113 122 125 143 144 145 149 150 159 160 170 175 176 182 183 190 213 215 216 224 281 309 319 323 327 343 381 396 403 404 405 414 438 456 471 487 495 507 528 536 537 541 542 549 572 583 585 595 596 618 621 638 664 669 688 690 691 692 693 694 704 710 740 759 767 776 787 798 811 818 822 829 839 843 869 875 883 890 900 913 936 939 949 954 960 967 1005 1019 1030 1035 1036 1039 1053 1058 1071 1074 1078 1084 1097 1101 1107 1109 1110 1121 1125 1126 1131 1132 1134 1140 1143 1150 
8 9 10 15 18 30 32 38 51 66 67 79 89 105 130 151 158 168 169 181 210 236 241 265 291 297 305 311 313 325 332 337 338 339 346 347 353 355 361 366 382 389 400 426 431 440 444 449 459 465 468 478 501 504 513 514 520 529 540 556 564 578 579 591 597 606 617 622 625 635 642 660 724 739 741 751 775 792 808 814 815 820 833 836 844 853 892 908 912 926 935 947 956 974 991 1016 1022 1038 1040 1059 1108 1117 1119 1127 1138 
1 11 16 17 41 61 68 70 74 76 85 88 94 95 96 100 107 117 118 120 162 167 177 178 194 197 201 211 214 219 223 233 262 280 282 285 320 328 344 365 369 379 387 391 417 437 442 448 485 493 494 506 522 530 547 548 550 553 614 620 651 662 666 667 685 687 689 696 697 703 726 737 738 748 750 760 769 771 794 825 837 838 860 878 880 985 994 1046 1065 1096 1137 1144 
12 21 56 59 101 104 114 116 263 269 270 272 289 345 357 372 378 397 398 409 410 425 433 452 453 476 481 490 502 516 527 538 551 558 561 567 574 627 671 672 673 683 699 720 728 730 731 743 744 747 758 764 765 774 777 778 779 788 823 824 827 854 874 876 882 895 903 925 941 943 944 945 953 958 962 964 988 989 993 997 1050 1057 1075 1089 1091 1115 1136 1145 1148 
0 52 58 64 75 82 103 146 191 192 212 222 228 249 258 267 274 284 290 312 333 354 362 371 377 386 434 445 457 483 519 531 543 545 560 562 563 566 586 613 658 661 677 681 711 715 735 753 754 755 773 780 783 805 806 812 816 828 849 856 867 870 884 899 907 992 1014 1025 1049 1072 1088 1106 
3 57 71 97 111 124 129 138 139 179 180 229 268 294 302 303 330 331 336 342 385 411 415 418 421 422 443 454 455 489 492 496 526 581 601 608 623 624 631 636 643 670 708 709 762 763 781 782 790 796 809 817 847 858 861 873 909 924 998 1027 1042 1055 1056 1151 
14 34 35 60 77 127 128 156 189 202 203 402 406 407 419 447 486 523 524 534 535 557 594 611 645 646 679 682 695 700 706 729 770 785 786 831 841 855 897 927 931 940 968 983 984 995 999 1009 1017 1018 1021 1023 1031 1044 1061 1066 1068 1076 1077 1086 1090 1104 1149 
2 4 5 23 36 172 198 225 239 260 273 326 360 370 408 429 439 473 503 505 517 518 582 587 592 607 637 640 652 659 676 686 736 756 810 835 845 846 877 888 987 1003 1011 1013 1073 1080 1085 1087 1094 1133 1135 1139 1141 
28 31 78 109 131 135 148 206 207 295 296 340 341 348 356 384 401 420 441 460 482 491 575 576 577 604 649 705 707 723 732 734 757 842 850 851 923 928 948 963 976 996 1052 1063 1069 1095 1099 1116 1147 
49 81 166 174 199 208 231 232 234 352 359 446 474 533 539 554 568 590 599 600 641 644 722 761 789 802 819 832 840 857 863 910 911 937 955 957 959 969 986 1004 1008 1041 1113 1120 1122 1123 
19 27 43 65 73 80 157 193 200 217 244 246 251 252 264 275 286 287 288 298 318 321 324 351 358 423 521 559 565 605 663 702 721 784 830 894 898 904 915 942 965 971 1111 1112 
90 136 137 165 171 184 185 245 250 255 256 301 306 307 308 317 428 435 436 479 515 546 555 619 647 656 813 821 848 862 887 891 896 921 977 1024 1045 1048 1103 1130 
83 84 110 132 133 134 226 247 261 300 363 395 430 450 544 593 598 602 603 654 655 678 733 742 746 795 879 889 932 938 975 1006 1070 1098 1102 1114 1146 1152 
26 37 72 123 161 253 304 315 322 349 364 380 472 499 570 615 639 668 680 698 725 745 752 797 859 902 905 917 918 933 950 952 978 990 1032 1043 
6 29 40 86 115 188 195 196 209 227 242 243 368 373 374 466 467 508 509 580 589 628 701 712 799 934 972 1001 1002 1029 1033 1034 1054 1118 
20 22 46 63 140 154 204 235 266 293 299 334 451 464 500 532 573 632 633 653 716 727 766 1015 
45 87 277 278 367 399 413 469 470 498 609 610 616 800 801 871 881 885 1020 1079 
24 25 310 427 458 461 462 626 717 718 791 793 872 1000 1081 1092 1093 
62 142 254 329 335 484 569 648 684 719 768 772 834 866 981 1010 1062 
119 121 187 218 248 292 314 375 390 392 674 675 919 920 1037 1051 
173 205 257 259 283 376 412 424 510 511 525 584 630 893 906 916 
163 164 220 230 238 271 316 393 394 463 552 650 826 914 
13 53 155 221 388 432 629 657 961 966 1064 1083 1124 
42 69 106 186 350 475 571 714 749 886 982 1026 1082 
98 99 276 803 804 807 868 922 1007 1012 1060 1105 1129 
141 152 153 240 279 383 480 488 612 930 973 
102 147 512 852 901 1028 1047 1067 1100 
126 237 416 477 588 713 946 951 1142 
497 634 665 929 970 1128 
