47 48 108 112 113 122 125 144 145 159 190 216 323 351 381 396 404 414 438 471 487 495 507 528 536 537 541 542 572 595 596 614 618 669 688 694 767 798 811 822 839 843 936 947 949 953 967 1019 1029 1074 1084 1097 1101 1150 
166 174 232 234 446 533 644 832 856 888 910 911 955 957 1003 1004 1008 1082 1113 1120 
18 130 265 332 355 465 468 514 529 561 591 597 739 833 892 935 1040 1117 
35 388 406 523 524 535 594 645 729 889 897 995 999 1021 1066 1086 1104 
4 5 273 302 326 439 503 652 656 673 987 1039 1094 1131 1135 1136 
10 32 57 79 169 181 305 440 445 558 635 636 642 724 741 912 
11 38 131 132 168 225 313 420 513 540 576 598 757 1037 1069 1147 
12 101 114 203 378 410 452 538 627 672 731 827 876 925 945 1044 
92 149 150 213 215 281 441 442 534 664 704 771 883 984 988 1036 
0 249 257 258 298 362 434 661 663 677 754 805 
19 73 121 217 288 318 321 390 392 756 835 879 
30 105 366 449 556 671 814 853 1059 1119 1127 1138 
98 690 691 943 954 1035 1058 1061 1090 1109 1110 1132 
152 383 611 612 646 700 737 878 914 933 1144 1149 
260 312 333 377 389 429 457 773 849 870 884 992 
6 7 29 86 115 196 242 243 373 374 498 
15 64 65 151 158 227 563 565 586 715 791 
27 147 157 275 812 852 1028 1047 1067 1100 1111 
33 39 44 58 208 211 297 353 456 520 787 
129 138 331 492 496 624 670 801 807 922 930 
163 164 220 238 239 271 276 464 632 633 826 
2 285 320 472 500 506 587 736 1085 1139 
8 9 51 66 67 266 400 478 660 753 
91 99 293 803 804 868 1007 1012 1060 1080 
209 398 399 712 758 774 777 934 944 964 
231 338 339 431 432 459 579 588 844 991 
16 17 96 417 437 697 760 994 1038 
20 60 85 140 235 344 727 1087 1133 
36 37 230 253 370 451 518 582 810 
56 160 272 345 425 743 744 895 1050 
90 137 184 185 317 848 891 977 1048 
104 357 502 571 574 720 728 779 962 
143 177 469 470 494 794 818 860 960 
13 195 368 466 467 1001 1002 1118 
26 193 304 364 797 859 990 1032 
42 106 186 350 475 695 714 1026 
173 192 525 584 780 916 1042 1049 
310 342 422 443 762 782 858 1000 
509 580 581 589 730 799 972 1089 
1 162 280 387 547 562 869 
53 155 221 380 629 1064 1124 
81 199 474 857 959 969 986 
93 405 421 526 710 740 1053 
171 245 619 821 887 896 1045 
207 295 296 356 705 928 948 
240 358 480 530 638 711 1014 
244 264 461 462 593 894 1146 
255 301 307 308 479 647 1103 
262 738 768 769 785 786 1065 
278 346 347 361 609 616 808 
292 314 674 675 919 920 1051 
303 485 748 781 924 1068 1137 
337 682 707 708 993 997 1075 
349 499 623 686 698 905 918 
14 109 135 148 734 1095 
49 119 359 550 554 789 
52 228 267 622 783 874 
69 543 681 749 886 982 
70 194 201 247 568 880 
83 84 300 733 795 1114 
97 179 631 687 709 817 
348 384 491 723 1057 1091 
413 426 610 625 800 871 
416 699 713 778 951 1142 
602 603 902 1070 1098 1102 
604 676 701 996 1033 1034 
28 189 706 1073 1141 
34 128 236 447 770 
41 107 120 328 1076 
59 256 551 607 1145 
61 662 689 966 1096 
62 142 335 569 684 
72 161 418 419 557 
75 386 809 1027 1151 
89 412 424 650 989 
95 299 564 792 1054 
124 210 250 268 546 
133 395 430 544 746 
136 165 428 606 813 
146 283 510 511 575 
170 175 176 759 1121 
251 641 653 1041 1123 
311 433 481 654 854 
327 343 583 1126 1140 
382 444 775 908 1108 
415 517 796 873 877 
450 678 692 975 1152 
539 615 639 802 1043 
21 229 261 903 
24 567 846 1030 
46 334 716 766 
54 55 1078 1125 
78 206 788 850 
82 483 531 613 
87 838 932 1006 
88 118 651 750 
94 391 668 1046 
111 909 998 1115 
117 214 365 1071 
127 402 486 940 
182 907 939 1143 
237 626 872 946 
246 287 784 830 
352 599 600 722 
397 941 958 1148 
403 423 549 1005 
409 605 898 971 
427 649 793 1081 
460 482 923 1116 
473 592 1011 1015 
484 488 648 931 
497 634 665 1128 
527 717 718 824 
555 862 921 1024 
608 643 1055 1056 
816 899 961 1013 
3 330 829 
31 77 1099 
40 188 628 
43 200 721 
50 776 1031 
71 269 861 
74 233 825 
80 324 904 
102 901 968 
123 680 952 
126 458 477 
139 336 578 
141 815 845 
153 372 490 
156 657 1083 
167 493 703 
172 885 906 
178 263 837 
180 385 407 
187 222 290 
191 408 735 
197 226 519 
205 259 893 
212 545 566 
219 223 570 
224 655 1077 
241 751 855 
252 436 702 
270 504 505 
277 881 1020 
279 322 973 
282 842 976 
286 559 823 
291 617 1016 
306 435 1130 
315 316 552 
329 772 915 
371 1025 1072 
393 394 463 
401 851 875 
411 963 1052 
454 601 763 
455 489 790 
501 679 927 
521 553 696 
560 658 867 
577 732 1063 
585 621 900 
590 761 863 
755 983 1009 
831 929 970 
834 981 1079 
841 1092 1093 
1017 1018 1023 
