8 9 10 15 18 30 31 32 38 51 63 66 76 78 79 89 105 130 131 151 158 168 169 170 175 176 181 191 204 210 227 241 265 270 291 297 305 311 313 325 332 338 346 347 353 355 361 366 382 420 426 440 444 445 449 453 465 468 501 504 513 514 520 529 540 556 561 576 578 579 591 597 606 622 625 629 640 642 650 660 671 679 735 739 740 741 751 757 759 775 792 808 814 815 820 833 836 850 853 854 855 892 908 926 927 935 956 974 991 1016 1022 1037 1040 1054 1059 1069 1099 1108 1117 1119 1121 1124 1127 1138 1147 
7 47 48 91 92 108 112 113 122 125 144 145 149 150 159 160 182 183 190 213 215 216 224 281 309 319 323 327 343 381 396 401 403 404 414 438 460 471 482 487 495 507 528 536 537 541 542 549 554 572 583 585 595 596 618 621 664 669 688 694 767 798 811 822 829 839 843 875 890 900 907 913 923 936 939 947 949 953 967 1005 1019 1036 1071 1074 1084 1097 1101 1107 1116 1126 1134 1140 1143 1150 
16 17 25 41 49 61 62 85 94 96 100 107 119 120 143 167 177 219 223 285 320 328 344 359 369 379 391 417 437 448 458 485 493 494 521 550 553 620 637 662 666 667 676 687 689 696 697 703 748 755 760 771 789 794 818 860 878 960 994 1038 1046 1096 1133 1137 
42 80 106 135 142 148 186 206 207 295 296 324 329 340 341 348 350 356 384 411 475 484 491 569 604 648 684 695 701 705 707 719 723 734 772 834 866 904 928 942 948 963 965 981 996 1010 1026 1033 1034 1052 1062 1095 1142 
35 98 99 156 202 203 254 276 293 388 389 461 523 524 535 594 645 657 785 786 803 804 841 863 868 897 983 995 999 1007 1009 1012 1017 1018 1021 1023 1044 1053 1060 1076 1083 1086 1092 1093 1104 1105 1129 
69 83 84 90 121 132 136 137 165 184 185 247 292 300 306 314 317 375 390 392 428 593 654 655 674 675 733 742 749 795 813 848 879 886 889 891 919 920 977 982 1048 1051 1114 1130 1146 
2 5 33 39 44 50 54 55 58 172 208 211 225 231 273 302 335 360 429 439 456 503 567 587 652 659 736 756 776 787 835 845 846 987 1030 1039 1080 1085 1094 1125 1131 1135 1139 
4 20 21 22 53 140 154 155 221 229 235 261 339 380 431 432 447 451 459 497 573 634 653 665 682 704 727 764 765 831 844 903 929 959 961 970 993 997 1064 1075 1128 
56 57 153 272 345 372 433 435 436 476 481 489 490 527 627 635 636 683 693 717 718 724 743 744 747 788 824 827 882 895 912 925 941 958 1050 1089 1148 
163 164 171 220 238 239 245 250 255 256 271 301 307 308 464 479 500 515 522 546 555 614 619 632 633 647 725 821 826 862 887 896 921 950 1024 1045 1103 
37 67 97 109 129 179 253 266 294 331 383 398 416 455 492 496 588 624 631 670 709 713 758 774 777 778 790 807 817 847 851 922 924 944 951 964 
26 123 304 349 364 409 441 442 472 499 506 570 623 668 680 686 698 745 752 797 859 883 905 918 933 952 978 988 990 1032 1043 1115 
81 166 174 199 232 234 354 446 474 533 548 590 644 761 819 832 840 856 857 910 911 937 955 957 969 986 1004 1008 1082 1113 1120 1122 
0 52 187 212 222 228 249 258 267 290 298 362 434 566 641 661 677 711 754 783 805 806 812 828 915 1041 1057 1106 1123 
11 24 102 104 116 147 197 236 286 357 502 512 559 571 574 630 720 726 728 779 823 852 901 962 1028 1047 1067 1100 
93 134 180 303 310 336 342 385 405 415 418 421 422 443 454 526 601 708 710 762 763 781 782 796 858 873 1000 1068 
77 127 141 152 240 260 279 322 402 419 473 486 565 592 611 612 646 700 888 940 973 1003 1011 1061 1078 1090 1149 
1 68 70 87 88 95 118 178 194 201 263 280 387 547 568 651 737 750 837 838 869 880 881 985 1006 1144 
36 230 316 326 393 394 400 408 463 478 505 517 518 552 582 602 603 810 877 902 914 1070 1087 1098 1102 
14 34 110 111 128 189 406 488 534 557 706 729 770 909 931 932 968 984 998 1031 1066 1073 1077 1141 
146 192 205 257 259 283 284 376 412 424 466 510 511 525 562 584 714 753 780 893 906 1001 1014 1049 
19 27 28 157 193 218 244 248 252 264 282 299 462 532 663 702 842 894 976 1015 1111 1112 
64 73 82 173 217 274 288 318 321 371 483 519 531 545 613 816 899 916 1013 1025 1072 
12 101 114 378 410 425 452 538 558 564 672 673 699 731 874 876 945 989 1091 1136 
133 138 226 337 363 370 395 407 430 450 544 598 617 678 692 715 746 938 975 1152 
6 13 29 86 115 195 209 242 243 368 373 374 467 712 934 966 1002 1029 1118 
43 65 74 162 200 233 246 251 275 287 351 423 563 586 685 721 784 825 830 
45 277 278 367 399 413 469 470 498 609 610 616 800 801 871 885 1020 1079 
60 103 312 333 377 457 543 560 658 681 773 849 867 870 884 992 1088 
3 40 46 188 196 330 334 608 628 643 716 766 1042 1055 1056 
59 397 551 607 690 691 943 954 1035 1058 1109 1110 1132 1145 
72 508 509 539 580 581 589 615 639 730 799 802 917 972 
126 237 427 477 575 626 649 791 793 872 930 946 1081 
23 75 198 289 386 516 577 732 809 1027 1063 1151 
139 352 358 480 530 599 600 605 638 722 898 971 
117 161 214 262 315 365 656 738 768 769 1065 
71 124 268 269 861 
