1 10 18 28 30 32 38 39 42 44 46 58 62 71 73 74 76 79 80 105 118 130 131 147 148 157 162 169 174 178 181 186 193 194 197 218 222 225 226 246 248 249 252 262 264 274 275 278 282 286 287 288 297 298 313 318 320 334 340 349 353 368 378 382 385 386 387 392 395 410 417 420 456 473 485 494 496 499 506 512 513 519 520 530 532 539 540 558 566 592 642 661 669 688 689 720 732 734 739 741 772 783 802 825 828 830 840 873 935 947 967 973 985 990 1015 1020 1037 1059 1060 1067 1069 1100 1112 1127 1137 1138 1147 
9 11 14 68 86 95 123 124 135 187 201 210 212 233 247 250 251 272 273 280 299 326 327 341 391 401 482 484 488 503 507 522 538 546 547 562 568 639 641 648 652 653 673 676 778 816 843 923 931 1041 1046 1123 1136 1150 
7 26 29 34 40 81 101 102 107 111 154 195 198 199 207 211 221 236 242 243 244 261 319 324 325 328 331 363 364 498 593 649 678 696 742 794 863 913 919 932 937 960 966 986 1009 1019 1032 1146 
43 61 96 146 155 156 191 192 245 332 347 466 470 501 509 563 569 580 581 586 590 629 647 722 730 776 780 799 819 824 965 1014 1022 1045 1096 1124 
5 69 177 292 306 314 366 375 475 521 583 671 674 675 725 747 820 832 885 918 920 941 982 1126 1140 1148 
47 48 85 108 140 167 223 235 290 323 514 518 572 598 618 638 694 798 822 839 948 949 1084 1097 1101 1122 
113 121 122 145 150 159 182 215 216 381 396 397 404 471 487 528 536 537 595 596 614 907 936 939 953 1143 
411 523 524 631 643 645 803 814 852 889 897 898 952 963 995 999 1028 1047 1051 1052 1055 1056 1064 1086 1104 
16 27 41 59 126 188 343 356 359 373 457 458 554 597 705 717 718 757 812 926 994 1111 
6 152 234 405 446 588 594 700 856 869 895 910 911 950 1004 1008 1021 1113 1120 
90 137 184 185 240 265 317 465 468 515 834 848 853 891 892 977 1048 1117 
293 379 416 427 449 504 683 711 787 909 924 970 991 998 1049 1068 1142 
8 51 66 67 75 400 477 478 492 582 591 660 733 753 759 1121 
22 87 88 138 139 204 205 230 370 617 624 692 715 761 871 1006 
56 57 433 435 436 481 561 635 636 724 893 912 1130 
78 129 369 533 576 668 727 801 807 851 922 992 1128 
115 170 219 321 419 542 570 613 713 879 934 951 1082 
2 37 144 253 285 354 483 548 736 945 1085 1139 
91 99 217 241 756 835 868 904 905 938 1007 1080 
36 232 451 505 603 686 810 901 902 1094 1098 
336 337 447 578 682 707 708 731 903 993 1075 
173 486 584 630 662 699 818 906 916 1042 
209 398 399 619 712 758 774 777 944 964 
231 270 338 339 431 432 459 460 579 844 
97 179 203 266 687 709 817 1023 1044 
141 163 164 220 238 271 815 826 845 
213 281 351 365 438 585 664 767 900 
352 439 600 690 691 1039 1072 1131 1135 
413 599 615 795 860 917 1027 1031 1151 
25 189 448 611 612 627 925 981 
33 120 161 171 384 474 557 940 
35 388 389 437 841 849 884 908 
54 93 710 740 1053 1078 1109 1110 
94 149 190 455 883 887 888 1003 
98 555 556 821 862 921 1024 1119 
103 116 208 307 479 728 779 1103 
106 214 350 380 695 976 1026 1071 
175 176 229 415 526 527 763 978 
180 357 406 407 500 729 962 1038 
19 72 165 348 390 606 790 
45 440 450 489 490 637 1152 
52 239 276 464 632 633 1012 
83 84 158 311 355 428 654 
260 333 426 565 644 870 1083 
263 409 430 792 837 971 1011 
23 516 770 833 858 1076 
53 289 309 461 462 1025 
82 295 531 666 716 811 
110 133 134 312 429 804 
227 279 374 497 508 665 
237 402 658 659 784 946 
269 305 445 663 842 861 
362 434 517 796 877 969 
367 549 604 701 748 867 
454 467 573 762 781 782 
550 620 651 737 872 1144 
0 750 859 899 961 
24 55 567 846 1125 
114 621 703 726 838 
125 543 544 746 997 
132 168 300 301 1114 
142 679 706 855 927 
172 452 601 623 1115 
196 344 383 1087 1133 
284 693 743 744 1050 
441 442 534 771 988 
491 493 702 723 797 
646 1061 1070 1090 1149 
745 752 773 933 1074 
943 954 1035 1058 1132 
12 13 425 928 
15 151 480 808 
17 371 760 987 
31 77 529 1099 
89 625 650 989 
104 453 607 640 
117 315 316 552 
228 622 874 882 
256 551 880 1145 
257 258 1040 1095 
302 608 672 955 
308 444 850 1108 
310 697 721 1000 
329 751 915 1065 
330 829 942 1066 
346 541 616 809 
421 626 836 974 
525 827 894 1089 
775 866 929 957 
785 786 857 996 
3 443 1116 
4 704 959 
20 335 545 
49 119 789 
60 535 984 
64 791 875 
92 128 1036 
100 268 502 
112 589 1016 
127 418 422 
224 655 1077 
259 574 714 
267 296 412 
342 361 605 
358 403 423 
376 377 719 
393 670 956 
394 463 813 
408 735 854 
469 930 1079 
472 831 968 
495 510 511 
559 823 975 
577 677 1063 
610 1073 1141 
656 684 1005 
793 876 1081 
805 806 1106 
1033 1034 1054 
