1 10 18 19 30 32 38 39 42 44 46 52 58 62 71 72 73 74 75 79 80 103 105 118 130 131 132 147 148 157 162 168 169 174 178 181 186 193 194 197 218 222 225 226 246 248 249 252 262 264 274 275 276 278 282 286 287 288 297 298 300 313 318 320 334 340 349 353 378 382 386 387 392 395 417 420 456 464 473 494 496 499 506 512 513 519 520 530 532 539 540 558 566 592 632 633 642 661 669 688 689 720 732 734 739 741 772 783 802 825 828 830 840 873 935 947 967 985 990 1012 1015 1037 1059 1060 1067 1069 1100 1112 1114 1127 1138 1147 
7 14 26 29 34 40 47 48 60 61 76 81 82 85 100 101 102 107 108 111 116 135 140 146 155 166 167 185 195 198 199 207 211 221 223 235 236 241 242 243 244 290 295 319 323 324 325 328 331 341 363 364 373 374 401 498 514 518 529 569 572 593 598 618 638 649 666 694 696 700 716 737 738 742 794 798 800 811 839 842 863 901 913 919 923 948 949 960 965 966 986 1009 1019 1032 1084 1096 1097 1101 1122 1144 1146 
9 11 68 86 123 201 212 233 272 273 280 326 327 391 482 484 507 522 545 547 562 639 648 652 816 843 931 1046 1150 
35 113 121 122 145 150 159 182 215 216 381 396 397 404 405 471 487 528 536 537 595 596 614 936 939 953 1143 
69 109 177 268 269 270 291 292 306 366 502 521 583 591 671 675 725 743 747 832 885 941 982 1126 1140 1148 
16 27 41 59 126 154 188 343 356 359 457 458 531 554 597 705 717 718 757 812 822 926 994 1111 
114 117 183 409 430 485 538 546 550 620 621 651 703 726 778 785 786 837 838 857 872 996 1011 1137 
6 232 234 263 446 587 588 594 644 728 761 856 869 888 895 910 911 1003 1004 1008 1088 1113 1120 
153 192 293 379 416 427 449 455 653 683 711 780 781 787 887 909 970 998 1014 1049 1068 1142 
43 96 156 245 385 470 501 509 580 590 629 647 722 730 776 799 803 824 972 1045 1124 
87 88 138 139 204 205 230 336 337 370 578 617 624 682 707 708 715 731 871 1006 1075 
50 90 137 184 240 265 317 465 468 515 834 848 853 891 892 977 1048 1117 
33 115 120 161 170 171 219 384 418 419 474 557 613 713 934 940 951 
523 524 631 645 695 814 897 898 952 995 999 1021 1047 1051 1056 1086 1104 
23 227 256 279 301 321 322 497 508 551 570 665 701 879 880 1145 
45 127 422 433 440 450 481 489 490 635 636 637 724 893 912 1152 
36 37 49 106 239 253 504 505 603 752 789 810 991 1094 1098 
91 99 217 372 567 756 807 835 868 905 922 938 1007 1080 
95 124 187 210 250 251 299 503 641 673 1020 1041 1123 1136 
51 66 67 266 400 478 516 582 660 753 759 1076 1121 
78 129 369 533 576 581 668 727 801 851 973 992 1128 
413 426 599 615 795 860 889 917 1027 1031 1083 1151 
97 179 203 687 709 817 831 1017 1018 1023 1044 
180 229 357 406 407 415 500 526 763 962 1038 
214 350 354 380 483 571 622 686 904 976 1026 
254 284 358 403 656 684 692 693 744 1005 1050 
2 22 144 451 736 902 945 1013 1085 1139 
209 398 399 619 712 758 774 777 944 964 
3 20 63 143 335 443 768 769 1116 
54 93 710 740 1039 1078 1109 1110 1131 
55 308 408 444 735 850 854 1108 1125 
98 555 556 821 862 921 1024 1053 1119 
213 281 351 365 438 585 664 767 900 
141 163 164 238 271 815 826 845 
231 338 339 431 459 460 579 844 
237 402 421 626 658 659 784 946 
5 314 375 674 820 920 1022 
8 158 311 355 428 448 654 
64 333 755 791 870 875 983 
362 434 517 663 796 877 969 
367 548 549 604 748 867 1082 
388 389 437 841 849 884 908 
25 189 612 627 925 981 
28 142 679 706 855 927 
94 149 190 441 883 1071 
119 165 348 390 606 790 
196 344 383 628 1087 1133 
257 258 424 805 1040 1095 
611 646 1061 1070 1090 1149 
0 750 859 899 961 
15 151 480 488 808 
53 289 309 766 1025 
57 220 394 463 813 
125 543 544 746 997 
136 283 535 575 886 
173 259 486 662 906 
208 307 479 779 1103 
261 577 677 678 1063 
310 697 721 729 1000 
329 423 751 915 1065 
352 439 600 1072 1135 
377 745 773 933 1074 
17 371 760 987 
24 630 846 916 
83 84 475 918 
175 176 527 978 
285 472 770 968 
302 608 672 955 
330 829 942 1066 
332 347 819 937 
342 360 361 605 
346 541 616 809 
442 534 771 988 
447 903 993 1115 
454 573 762 782 
491 702 723 797 
525 827 894 1089 
584 699 818 1042 
610 650 1073 1141 
775 866 929 957 
943 954 1035 1058 
4 704 959 
12 13 928 
31 77 1099 
56 425 561 
89 625 989 
92 128 1036 
104 607 640 
110 134 804 
112 589 1016 
133 312 429 
172 601 623 
191 563 586 
224 655 1077 
228 874 882 
260 565 676 
267 296 412 
303 924 958 
305 445 861 
315 316 552 
368 466 467 
393 670 956 
411 643 1055 
435 436 1130 
469 930 1079 
477 492 733 
495 510 511 
542 852 1028 
559 823 975 
609 754 907 
657 680 932 
690 691 1132 
793 876 1081 
833 858 984 
1033 1034 1054 
