8 9 12 22 24 25 30 31 44 45 51 56 57 60 63 66 67 68 69 75 83 98 99 102 109 114 129 130 131 133 134 139 152 153 158 169 180 201 202 203 206 228 229 233 234 245 250 265 266 279 302 303 304 310 314 315 321 329 332 333 335 340 342 355 360 363 378 379 383 393 395 400 406 408 409 410 411 415 416 421 422 427 429 430 435 439 440 444 452 454 455 462 477 478 481 489 490 491 497 508 521 526 527 529 533 546 547 549 551 558 564 565 566 573 577 578 582 591 593 599 601 615 624 631 635 636 637 640 642 654 660 669 672 673 674 678 679 681 684 692 701 706 710 719 724 732 733 739 745 747 748 751 759 763 768 769 772 778 781 782 785 786 787 792 796 802 813 827 830 831 832 836 845 855 861 866 873 876 877 885 893 903 909 912 919 920 933 937 945 957 966 968 969 978 996 998 1005 1033 1034 1054 1059 1060 1065 1068 1069 1072 1112 1127 1130 1136 1145 1146 1150 
0 1 10 11 18 19 23 28 32 33 38 39 42 43 46 52 58 59 61 62 70 73 74 76 77 78 79 80 95 96 107 108 117 118 132 148 157 162 168 174 175 176 178 179 181 186 187 193 194 197 210 211 212 218 222 225 226 246 247 248 249 251 252 264 275 276 282 286 287 297 298 313 318 334 341 353 375 382 386 387 390 392 417 420 423 434 448 453 456 485 486 496 499 506 512 513 520 532 538 539 540 550 572 622 661 663 676 688 698 734 754 757 773 775 783 812 825 828 840 847 869 894 905 917 929 935 947 953 958 967 974 982 990 994 1029 1036 1037 1052 1096 1101 1137 
13 27 47 48 65 87 88 110 111 138 140 141 198 199 204 223 224 230 235 236 237 244 268 295 296 312 324 327 328 336 337 343 344 346 347 356 359 361 369 370 376 377 391 426 457 458 469 470 482 501 507 509 516 522 523 524 541 542 544 592 605 607 609 610 612 625 628 638 643 649 657 667 670 682 696 700 703 705 707 708 715 716 727 731 737 738 761 762 791 801 808 810 811 822 838 839 857 863 871 872 926 928 930 932 946 955 965 981 983 989 993 997 1006 1009 1015 1017 1019 1030 1046 1067 1075 1076 1083 1086 1087 1095 1104 1111 1115 1133 1144 
16 81 82 97 146 147 172 173 191 192 205 219 257 259 267 283 284 330 424 466 493 525 530 548 562 563 569 583 584 585 620 629 630 646 651 662 711 714 718 726 736 752 753 780 837 856 906 916 927 941 956 959 972 975 1001 1014 1025 1028 1042 1049 1064 1100 1102 1126 1140 1148 1149 
2 3 119 120 127 128 149 161 165 170 171 232 277 278 309 316 384 385 402 403 418 419 461 492 503 557 613 619 641 656 699 709 795 860 886 911 934 940 951 952 961 999 1018 1020 1041 1047 1092 1123 1135 1139 
36 64 100 101 125 126 142 143 166 167 177 200 261 285 319 320 325 331 354 358 389 414 445 494 543 568 586 648 666 677 683 686 687 689 729 794 814 818 878 880 881 901 913 960 1000 1038 1063 1141 
4 5 17 91 92 93 94 150 182 183 190 213 214 280 281 323 351 352 365 438 495 511 552 554 618 664 694 704 760 767 829 900 943 962 963 987 1010 1071 1084 1097 1143 
71 72 84 105 106 231 269 270 291 292 293 338 339 348 394 428 432 449 459 465 476 504 505 579 587 588 671 675 749 820 833 844 882 924 991 995 1051 1055 1085 
6 7 20 26 29 40 85 86 115 135 154 195 196 207 209 221 227 242 243 368 373 374 401 498 597 852 899 948 949 1002 1023 1032 1040 1056 1118 
34 53 256 288 289 307 308 479 575 580 634 653 655 665 695 742 797 798 823 824 841 896 908 925 985 1031 1066 1077 1093 1103 1124 1128 
21 41 103 104 116 151 208 258 263 357 371 372 500 502 559 560 571 574 608 639 685 720 728 766 779 1008 1113 1120 
112 113 121 122 144 145 159 160 215 216 381 396 397 404 405 471 487 528 536 537 595 596 614 621 936 939 
54 55 217 567 740 741 756 835 846 854 971 1007 1053 1078 1080 1088 1125 1131 
49 50 253 254 388 446 447 553 594 680 789 834 914 992 1013 1079 
274 290 349 483 519 531 545 598 645 750 755 816 859 875 910 
262 299 322 366 367 380 412 413 570 697 721 725 867 1082 
450 616 668 793 809 897 898 1021 1027 1074 1081 1151 1152 
510 555 556 821 862 921 1012 1024 1045 1062 1099 1119 
89 90 184 305 306 436 514 606 650 702 1073 
163 164 220 238 239 271 463 632 633 815 826 
136 137 185 317 848 853 868 891 892 1048 
398 399 627 712 713 758 774 777 944 964 
124 611 626 658 659 784 788 889 890 
260 311 437 644 746 849 870 884 907 
156 255 581 590 776 799 800 819 
272 273 326 602 603 652 1094 1098 
345 425 600 693 743 744 895 1050 
534 535 735 770 858 931 984 1108 
240 241 468 515 561 790 1117 
14 15 480 484 488 973 
441 604 942 970 1043 1142 
473 474 887 888 1003 1004 
803 804 807 922 938 986 
954 1035 1058 1061 1070 1090 
155 589 647 722 1022 
300 301 879 1114 1122 
362 451 517 518 915 
364 850 851 923 950 
188 189 433 1011 
407 576 617 1016 
431 472 475 902 
443 460 717 1116 
690 691 1039 1132 
842 843 977 1044 
35 730 1089 
350 1026 1147 
442 771 883 
805 806 1106 
874 1057 1091 
