1 16 17 41 61 76 85 94 96 100 107 117 118 120 162 167 177 197 211 214 219 223 262 280 282 285 320 328 344 365 369 379 391 417 437 448 485 493 494 522 530 547 548 550 553 614 620 651 662 687 689 696 697 703 726 737 738 748 760 769 794 837 838 860 878 994 1046 1065 1096 1137 1144 
7 47 48 91 108 143 159 190 224 323 381 414 438 471 495 507 537 541 542 572 618 638 669 688 694 767 798 811 818 822 839 843 890 913 949 960 967 1019 1074 1084 1097 1101 1150 
8 9 15 51 66 67 151 158 265 311 332 355 389 400 465 468 478 529 578 591 597 660 739 892 935 1040 1117 
35 202 203 523 524 535 645 682 695 785 786 831 897 995 999 1021 1023 1044 1066 1076 1086 1104 
12 101 114 345 378 409 410 425 490 538 558 672 673 699 778 874 876 945 1057 1091 1136 
113 122 144 145 150 160 182 215 216 396 404 487 528 536 595 596 621 936 939 1143 
166 174 232 234 446 533 539 644 802 819 832 910 911 937 955 957 1004 1008 1113 1120 
10 18 32 38 79 168 169 181 210 297 313 353 513 520 540 622 635 642 912 
59 398 527 551 627 683 730 758 774 777 823 824 827 925 944 964 1089 1145 
83 84 132 247 261 300 593 654 655 678 733 742 795 879 889 1114 1146 
171 245 255 256 301 307 308 479 619 647 656 821 887 896 1045 1103 
34 128 189 534 557 679 706 770 855 927 931 968 984 1031 1077 
54 55 93 405 710 740 954 1035 1053 1058 1078 1109 1110 1125 1131 
28 131 206 348 384 420 441 491 604 723 757 996 1069 1147 
30 105 366 449 501 556 814 853 947 1038 1059 1119 1127 1138 
64 82 274 354 445 483 519 531 545 613 715 755 816 899 
2 172 429 587 736 756 835 845 846 1013 1080 1085 1139 
104 116 263 289 357 372 502 516 574 720 728 779 962 
4 5 225 273 326 439 503 637 652 987 1094 1135 
26 304 349 364 499 698 797 859 905 918 990 1032 
33 39 44 112 403 456 549 692 787 1005 1030 
36 239 370 408 505 686 810 1073 1087 1133 1141 
37 123 253 472 680 745 902 933 952 978 1043 
52 146 192 284 562 711 753 780 856 1014 1049 
72 322 380 570 615 639 668 725 752 917 950 
87 399 413 469 470 609 610 800 801 871 1079 
90 137 184 185 306 317 436 848 891 977 1048 
130 338 339 431 440 459 514 579 741 833 844 
312 333 377 457 543 681 773 849 870 884 992 
110 133 134 363 395 430 544 746 938 975 
163 164 220 238 271 393 394 463 650 826 
269 270 476 671 743 744 747 882 895 1050 
92 149 213 281 664 704 883 1036 1071 
109 135 148 401 460 482 923 1095 1116 
433 481 567 788 854 941 958 988 1148 
6 29 86 115 242 243 373 374 
60 77 127 402 419 486 700 940 
81 199 474 568 857 959 969 986 
99 803 804 807 868 922 1007 1060 
207 295 296 356 705 707 928 948 
292 314 375 674 675 919 920 1051 
42 106 186 350 475 714 1026 
62 142 254 335 569 684 768 
141 152 153 279 383 612 930 
229 415 421 526 763 796 873 
249 258 362 661 754 805 907 
260 473 592 676 888 1003 1011 
352 599 600 641 722 1041 1123 
382 444 606 775 815 908 1108 
3 330 422 443 858 1042 
11 70 95 194 201 880 
20 140 154 235 573 727 
21 903 993 997 1075 1115 
24 25 310 461 462 1000 
27 157 193 252 663 1111 
57 455 489 636 782 790 
138 342 492 624 670 762 
147 852 1028 1047 1067 1100 
170 175 176 693 759 1121 
173 376 525 584 630 916 
226 450 598 603 1098 1152 
228 267 434 783 812 828 
302 411 608 643 1055 1056 
327 343 583 869 1126 1140 
508 509 580 589 799 972 
65 251 275 351 565 
68 178 387 506 985 
73 217 288 318 321 
97 179 631 709 817 
121 248 390 392 1037 
227 701 1033 1034 1054 
346 347 361 625 808 
416 588 713 951 1142 
458 626 717 718 872 
564 724 792 820 1022 
0 222 290 677 
14 406 407 729 
31 575 576 1099 
40 188 196 628 
43 200 246 721 
46 334 716 766 
49 359 554 789 
53 155 221 961 
69 749 886 982 
74 233 685 825 
80 324 358 904 
89 325 337 426 
124 268 1027 1151 
126 237 477 946 
129 331 496 581 
139 336 708 809 
156 841 983 1009 
183 585 829 900 
195 368 466 467 
230 316 552 914 
240 480 488 973 
244 264 894 1112 
283 510 511 906 
303 454 781 924 
329 484 648 772 
427 791 793 1081 
442 666 667 771 
452 453 731 989 
464 500 632 633 
497 634 665 1128 
521 605 898 971 
555 862 921 1024 
646 1061 1090 1149 
690 691 1039 1132 
22 266 451 
45 367 616 
56 272 561 
58 75 386 
78 850 851 
98 276 1012 
102 512 901 
111 909 998 
119 187 218 
209 712 934 
250 515 546 
277 881 1020 
278 498 885 
287 784 830 
291 617 1016 
298 423 915 
299 532 1015 
371 1025 1072 
388 657 1083 
397 943 953 
418 601 623 
517 518 877 
560 658 867 
577 732 1063 
582 607 640 
590 761 863 
602 1070 1102 
649 842 976 
734 963 1052 
