4 7 47 48 91 92 98 99 108 112 113 122 125 144 145 147 149 150 159 171 190 213 215 216 224 241 245 255 265 281 293 301 307 308 319 323 327 343 379 381 396 401 403 404 414 423 429 438 460 465 468 469 470 471 475 479 482 487 495 507 514 515 522 528 536 537 541 542 549 555 572 575 583 595 596 614 618 619 647 664 666 667 669 688 694 704 714 725 742 751 767 771 798 801 803 804 811 821 822 839 843 852 855 862 868 875 887 890 892 896 912 913 921 923 936 947 949 950 953 967 1005 1007 1012 1019 1024 1028 1036 1045 1047 1060 1067 1074 1079 1084 1097 1100 1101 1103 1105 1116 1117 1126 1129 1140 1150 
2 5 36 37 54 55 64 65 81 93 117 138 139 156 166 174 199 214 229 230 232 234 251 253 262 273 277 302 309 315 316 326 351 354 360 365 370 405 408 415 421 439 446 451 474 503 505 517 518 526 533 548 552 565 567 582 586 587 590 602 603 637 644 652 656 659 710 736 738 740 756 761 768 769 785 786 791 796 810 819 832 835 845 846 856 857 863 873 877 881 902 910 911 914 937 955 957 959 969 986 987 1004 1008 1020 1025 1030 1039 1053 1065 1070 1078 1080 1082 1085 1087 1094 1098 1102 1113 1120 1125 1131 1133 1135 1139 
10 11 18 19 28 30 32 38 39 58 73 79 105 121 130 131 163 164 168 169 181 191 210 217 220 222 225 238 239 248 252 270 271 276 282 288 291 297 305 313 318 321 338 339 353 366 390 392 407 420 431 432 440 445 449 456 459 464 501 504 513 520 532 540 556 566 576 579 598 617 622 631 632 633 642 663 671 679 702 732 735 741 757 814 820 826 833 836 840 842 844 853 854 927 976 991 1016 1022 1037 1038 1059 1069 1108 1119 1122 1127 1138 1147 
8 9 15 22 23 51 63 66 75 76 87 103 126 140 151 158 170 175 176 198 204 227 237 260 289 311 312 325 332 333 336 337 355 382 386 389 393 394 400 426 427 444 453 457 458 463 477 478 516 529 560 578 591 597 625 626 635 640 658 660 727 739 759 775 809 815 838 849 850 867 870 872 884 908 926 932 935 946 956 974 992 1006 1040 1088 1121 
57 67 71 97 100 109 124 129 179 180 250 266 268 269 294 303 331 342 369 385 397 416 418 422 433 443 454 455 481 489 492 496 546 588 601 624 636 670 709 713 762 763 778 781 782 788 790 807 817 847 851 858 861 922 924 941 951 958 1017 1018 1023 1027 1068 1148 1151 
16 20 25 27 41 49 60 61 78 85 94 96 107 119 120 143 154 167 177 218 219 223 235 285 320 328 344 359 377 391 417 437 448 485 493 494 521 550 553 554 573 620 662 687 689 696 697 703 748 755 773 789 794 818 860 878 960 983 994 1009 1046 1096 1111 1137 
62 80 82 135 142 148 186 187 202 203 206 207 295 296 324 329 335 340 341 348 356 384 411 452 483 484 491 531 569 604 613 648 676 684 701 705 707 708 719 723 734 772 834 866 904 915 928 931 942 948 963 965 981 996 1010 1033 1034 1044 1052 1057 1062 1095 1142 
17 24 26 72 104 116 123 161 304 349 357 364 371 441 442 472 476 499 500 502 506 539 570 571 574 615 623 630 639 668 680 685 686 698 720 728 745 752 760 779 797 802 859 883 905 917 918 933 952 962 978 988 990 1032 1043 1072 1115 
12 56 59 101 114 153 160 256 272 310 345 372 378 410 425 490 527 538 551 558 561 564 607 627 649 672 673 683 690 691 699 717 718 731 747 793 824 827 874 876 882 925 943 945 954 1000 1035 1058 1081 1089 1091 1109 1110 1132 1136 1145 
14 21 34 35 83 84 111 128 132 189 247 261 300 406 447 523 524 534 535 557 593 594 645 654 655 706 729 733 764 765 770 795 879 889 897 903 909 968 984 993 995 998 999 1021 1031 1066 1073 1075 1076 1077 1086 1104 1114 1141 1146 
3 40 45 46 172 183 188 254 278 330 334 346 347 352 361 367 413 508 509 580 581 585 589 599 600 608 609 610 616 621 628 641 643 653 716 722 730 766 799 800 808 829 871 885 900 972 1041 1042 1055 1056 1071 1107 1123 1134 
6 13 29 43 74 86 115 193 195 196 200 209 242 243 244 246 264 286 287 368 373 374 398 399 461 462 467 498 559 712 721 758 774 777 784 823 830 894 934 944 964 966 1118 
1 33 44 50 68 70 88 95 118 162 178 182 194 201 208 211 231 233 236 263 275 280 387 547 568 651 715 726 737 750 776 787 825 837 869 880 907 939 985 1143 1144 
42 69 89 90 106 136 137 165 184 185 292 306 314 317 350 375 428 435 436 543 606 650 674 675 681 695 749 813 848 886 891 919 920 977 982 1026 1048 1051 1130 
0 52 157 197 212 226 228 249 258 267 290 298 299 362 434 473 519 545 577 592 661 677 724 754 783 792 805 806 812 828 888 1003 1011 1015 1054 1063 1106 1112 
53 102 110 133 134 155 221 274 363 380 388 395 430 450 512 544 629 657 678 692 746 816 841 899 901 938 961 975 997 1013 1064 1083 1092 1093 1124 1152 
146 173 192 205 257 259 283 284 376 412 424 466 510 511 525 562 563 584 693 711 743 744 753 780 893 895 906 916 989 1001 1014 1049 1050 
31 77 127 141 152 240 279 322 358 383 402 409 419 480 486 488 530 605 611 612 638 646 700 898 930 940 971 973 1061 1090 1099 1149 
497 634 665 682 831 929 970 1128 
