8 9 10 30 32 38 51 63 66 67 75 76 79 89 105 126 130 133 134 168 169 170 175 176 181 204 210 226 237 241 265 270 291 297 305 311 313 325 332 336 337 338 339 346 347 353 355 361 363 366 382 386 395 400 407 426 430 431 432 440 444 445 449 450 453 459 465 468 477 478 501 504 513 514 520 529 540 544 556 578 579 591 597 598 606 617 622 625 640 642 650 660 678 679 692 693 739 741 746 751 759 775 792 808 809 814 815 820 833 844 853 854 855 892 908 926 927 935 938 946 947 956 974 975 991 1016 1022 1027 1038 1040 1054 1059 1108 1117 1119 1121 1127 1138 1151 1152 
7 47 48 91 92 93 108 112 113 122 125 144 145 149 150 159 160 182 183 190 213 215 216 224 281 309 319 323 327 343 381 396 401 403 404 414 438 460 471 482 487 495 507 528 536 537 541 542 549 554 572 583 585 595 596 618 621 664 669 688 694 704 767 798 811 822 829 839 843 875 890 900 907 913 923 936 939 949 953 967 1005 1019 1036 1071 1074 1084 1097 1101 1107 1116 1126 1134 1140 1143 1150 
16 17 25 41 49 61 85 94 96 100 107 117 119 120 143 167 177 214 219 223 262 285 320 328 344 359 365 369 379 391 417 437 448 485 493 494 550 553 620 637 662 666 667 676 687 689 696 697 703 738 748 755 760 768 769 771 789 794 818 860 878 960 994 1046 1065 1096 1137 
6 11 15 18 20 27 29 65 86 102 110 111 115 147 151 154 157 158 193 196 209 227 235 236 242 243 251 252 275 351 373 374 423 456 512 565 573 586 663 712 852 901 909 932 934 1047 1067 1100 1111 
54 55 81 166 174 199 208 231 234 405 446 533 690 691 710 725 740 819 832 840 856 857 895 910 911 937 950 954 955 957 969 986 1004 1008 1021 1035 1039 1053 1058 1078 1082 1109 1110 1113 1120 1122 1125 1131 1132 
69 72 121 136 161 165 171 245 250 255 256 292 301 307 308 314 315 370 375 390 428 479 515 522 546 555 614 619 647 656 674 675 749 813 821 862 886 887 896 919 920 921 982 1024 1045 1051 1103 
0 64 73 80 82 187 212 217 222 249 258 274 288 290 298 318 321 324 362 371 483 519 531 545 566 613 641 661 677 715 754 805 806 816 899 904 915 942 965 1013 1025 1041 1057 1072 1106 1123 
28 31 58 78 109 131 135 148 198 206 207 211 295 296 340 341 356 392 411 420 576 577 604 629 705 707 708 732 734 757 836 850 851 928 948 963 996 1037 1052 1063 1069 1095 1099 1124 1142 1147 
68 70 95 146 173 178 191 192 194 201 205 257 259 263 283 284 376 387 412 424 466 506 510 511 525 562 563 568 584 714 735 753 780 837 880 881 893 906 916 985 1001 1014 1049 
24 39 103 104 116 229 260 303 312 333 357 377 389 415 421 454 457 502 526 543 560 571 574 587 630 658 681 720 728 763 773 779 781 796 849 867 870 873 884 962 992 1088 
56 57 153 272 345 372 433 435 436 441 442 476 481 489 490 527 561 627 635 636 671 683 717 718 724 743 744 747 788 824 827 882 883 912 925 941 958 988 1050 1089 1148 
2 4 5 33 44 50 172 225 230 273 302 360 429 439 474 503 567 644 645 652 659 736 756 776 787 835 845 846 914 987 1030 1080 1085 1094 1135 1139 
37 97 129 179 253 266 310 331 352 354 398 416 455 496 548 588 599 600 631 709 713 722 758 774 777 778 790 807 817 922 924 944 951 964 998 1000 
14 35 98 99 254 276 293 388 406 523 524 535 594 729 803 804 868 889 897 995 999 1007 1012 1017 1018 1023 1028 1060 1066 1068 1076 1086 1104 1105 1129 
26 123 304 349 364 409 472 499 539 570 615 623 639 668 680 686 698 745 752 797 802 859 905 917 918 933 952 978 990 1032 1043 1115 
34 83 84 128 132 189 247 300 534 557 593 654 655 706 733 742 770 795 879 931 968 984 1031 1073 1077 1114 1141 1146 
21 53 155 156 202 203 221 380 461 657 764 765 785 786 841 903 961 983 993 997 1009 1044 1064 1075 1083 1092 1093 
22 140 163 164 220 238 239 261 271 464 497 500 632 633 634 653 665 682 727 826 831 929 959 970 1128 
1 23 88 118 162 197 280 286 289 516 547 559 651 701 726 737 750 823 838 869 1006 1033 1034 1144 
36 232 316 326 393 394 408 451 463 505 517 518 552 582 602 603 810 877 902 1070 1087 1098 1102 1133 
71 124 138 180 268 269 294 342 385 418 422 443 492 590 601 624 670 761 762 782 847 858 861 863 
139 141 152 240 279 322 358 383 473 480 488 521 530 592 605 612 638 700 888 898 971 973 1003 1011 
45 87 277 278 367 399 413 469 470 498 580 581 609 610 616 730 800 801 871 885 972 1020 1079 
12 101 114 378 410 425 452 538 558 564 672 673 699 731 874 876 945 989 1091 1136 
62 142 329 335 348 384 484 491 569 648 684 719 723 772 834 866 981 1010 1062 
13 40 188 195 458 508 509 575 589 628 799 966 1002 1029 
60 77 127 402 419 447 486 611 646 940 1061 1090 1149 
3 46 330 334 467 608 643 716 766 1042 1055 1056 
52 228 248 267 299 434 532 711 783 812 828 1015 
19 218 244 264 282 462 702 842 894 976 1112 
90 137 184 185 306 317 848 891 977 1048 1130 
427 626 649 791 793 872 930 1081 
42 106 186 350 475 695 1026 
43 200 246 287 721 784 830 
59 397 551 607 943 1145 
74 233 368 685 825 1118 
