1 10 18 19 28 30 32 38 39 42 44 46 58 59 62 70 71 72 73 74 75 76 79 80 105 119 130 131 147 148 157 162 165 168 169 178 181 187 193 194 197 210 218 222 225 226 246 248 249 252 262 264 275 276 278 282 286 288 291 297 299 300 304 313 318 334 340 348 349 353 378 382 386 387 390 392 395 417 420 456 496 498 499 503 506 512 513 514 520 532 539 540 566 622 641 642 645 661 716 720 732 734 739 741 747 783 787 790 792 802 825 828 840 873 896 904 935 967 990 1012 1015 1020 1041 1059 1069 1100 1114 1123 1127 1138 1147 
26 29 40 45 81 82 85 96 101 102 107 111 120 135 140 142 146 154 156 158 167 171 191 192 198 199 206 207 211 235 236 237 242 243 244 245 261 267 269 287 295 296 302 305 324 325 328 331 337 356 363 367 412 428 445 474 491 509 529 563 569 577 580 586 604 608 629 647 649 657 658 659 666 672 677 678 696 700 702 707 722 727 730 737 754 771 776 780 784 794 797 799 800 819 830 842 861 863 867 890 909 919 928 932 948 955 960 963 965 966 972 983 986 996 998 1009 1014 1017 1018 1032 1045 1052 1063 1112 1124 1144 
4 12 13 35 47 48 56 91 92 94 99 108 112 113 122 128 145 149 150 159 160 182 183 190 195 213 215 216 223 224 254 281 284 323 329 341 345 351 365 381 396 403 404 425 438 441 442 460 471 487 528 536 537 542 549 572 585 589 595 596 618 621 656 664 669 684 692 693 694 704 743 744 767 772 798 811 822 829 839 883 900 905 907 936 939 947 949 953 959 1002 1005 1007 1019 1029 1036 1037 1050 1060 1071 1084 1097 1101 1105 1107 1122 1129 1134 1143 1150 
2 22 23 24 36 37 49 54 55 97 98 106 144 163 164 179 214 220 227 232 238 239 253 256 266 271 279 350 354 408 429 451 464 483 505 508 551 602 603 630 631 632 633 668 683 687 695 701 709 723 736 740 752 756 789 810 817 826 835 846 878 880 901 902 914 943 945 946 954 976 992 1026 1033 1034 1035 1053 1054 1058 1061 1070 1078 1080 1085 1090 1094 1098 1102 1125 1139 1145 
7 9 11 16 61 68 86 95 100 114 117 118 123 166 201 212 233 250 251 272 273 280 285 320 326 327 368 375 379 391 409 410 430 448 476 482 484 485 493 494 507 515 522 530 538 545 546 547 548 550 562 568 614 620 648 651 652 662 685 689 703 726 738 748 778 785 786 816 837 838 843 857 872 917 931 994 1011 1046 1065 1096 1118 1137 
5 57 69 143 177 268 270 292 303 306 314 338 339 366 393 394 397 431 433 435 440 450 459 463 481 489 490 502 504 521 579 583 598 599 635 636 637 670 671 674 675 724 725 735 749 788 813 820 833 844 854 858 860 885 912 920 941 956 958 982 988 991 1022 1027 1074 1108 1126 1130 1140 1148 1151 1152 
0 8 34 60 64 83 88 110 121 125 133 134 247 257 258 259 274 290 311 312 333 364 377 388 389 401 424 437 519 531 535 543 544 557 593 654 655 681 742 745 746 750 755 773 795 804 805 806 841 849 859 870 875 879 884 899 913 923 933 984 1040 1095 1106 1146 
17 33 65 87 89 115 161 170 209 219 260 298 315 321 322 371 380 384 398 399 413 414 423 426 470 472 553 565 570 571 609 610 613 615 619 625 639 644 676 680 686 712 713 751 758 760 774 777 871 915 934 944 951 964 987 989 1023 1043 1072 1082 1083 1141 
25 27 41 126 188 189 255 308 332 336 343 347 355 359 421 444 457 458 461 462 501 554 560 578 591 597 606 612 626 627 705 708 717 718 757 815 836 845 908 925 926 974 981 1067 1092 1093 1111 
6 138 139 174 204 205 234 370 446 534 590 594 617 679 688 706 715 761 770 832 855 856 869 893 895 910 911 927 968 1004 1006 1008 1021 1031 1068 1077 1113 1120 
50 90 137 184 185 230 241 265 316 317 346 436 465 468 541 552 561 616 650 809 834 848 853 891 892 977 1013 1048 1073 1117 
14 180 229 293 357 406 407 415 427 455 497 500 526 634 653 665 729 763 791 793 796 876 887 924 962 970 1038 1081 
202 203 411 432 523 524 559 643 803 814 823 852 889 897 898 952 975 995 999 1028 1044 1047 1051 1055 1056 1064 1086 1104 
3 20 21 53 63 155 196 221 289 309 319 335 344 373 374 383 443 628 667 766 768 769 961 1025 1087 1116 1133 
217 330 352 439 495 510 511 555 556 567 600 690 691 821 862 921 942 1024 1039 1066 1119 1131 1132 1135 
43 52 132 200 310 416 449 454 466 467 573 588 697 698 711 721 762 781 782 1000 1049 1142 
51 66 67 104 109 294 400 477 478 492 582 607 624 640 660 733 753 759 847 1121 
15 116 151 208 231 277 301 307 358 479 480 488 638 728 779 808 881 971 1103 
31 78 129 369 469 533 576 581 801 807 850 851 868 922 930 1016 1079 1099 1128 
228 362 434 517 518 558 663 673 812 874 877 882 969 1057 1091 1136 
77 127 385 402 418 419 422 486 584 699 818 906 940 1042 
141 152 153 240 473 564 592 888 950 973 1003 1030 
93 172 405 452 453 601 623 710 731 1109 1110 
175 176 263 372 516 527 824 938 978 985 1076 
124 447 611 764 765 903 993 997 1075 1115 
173 376 525 719 827 894 916 1001 1089 
682 775 831 866 929 937 957 1010 1062 
136 283 342 360 361 575 605 886 
186 475 574 646 714 918 1149 
84 103 587 1088 
