8 9 12 22 24 25 30 31 37 44 45 51 57 60 63 66 67 68 69 75 83 99 102 109 114 123 129 130 131 133 134 139 152 153 158 169 180 201 203 206 228 229 232 233 234 245 250 265 266 279 302 303 304 310 314 315 321 329 332 333 335 340 342 355 360 363 378 383 393 395 400 406 408 409 410 411 415 416 421 422 427 429 430 435 439 440 444 452 454 455 462 467 472 477 478 481 489 490 491 497 508 521 526 527 529 533 546 547 549 551 558 564 565 566 573 577 578 582 591 593 599 601 615 631 635 636 637 640 642 654 660 669 672 673 678 679 681 683 684 692 701 706 719 724 732 733 739 745 747 748 751 759 763 764 765 768 769 772 778 781 782 785 786 792 796 802 813 827 830 831 832 836 845 855 861 866 873 876 877 885 893 902 903 909 912 919 924 933 937 945 947 957 966 968 969 978 988 996 998 1005 1013 1033 1034 1054 1059 1060 1065 1068 1069 1072 1105 1108 1112 1127 1129 1130 1136 1145 1146 1150 
0 1 10 11 18 19 23 28 32 33 38 39 42 43 46 52 58 59 61 62 70 73 74 76 77 78 79 80 95 96 107 108 117 118 132 148 157 162 168 174 175 176 178 179 181 186 187 193 194 197 210 211 212 218 222 225 226 246 247 248 249 251 252 264 275 276 282 286 287 297 298 313 318 334 341 353 375 382 386 387 392 417 420 423 434 448 453 456 485 486 496 499 506 512 513 520 532 538 539 540 550 572 592 622 661 663 676 688 698 734 754 757 775 783 812 825 828 840 847 869 894 904 905 917 929 935 958 967 974 976 982 990 994 1036 1096 1101 1137 
13 27 47 48 65 87 88 110 111 138 140 141 198 199 204 223 224 230 235 236 237 244 268 295 296 312 324 327 328 336 337 343 344 346 347 356 359 361 369 370 376 377 391 426 457 458 469 470 482 501 507 509 516 522 523 524 541 542 544 605 607 609 610 612 624 625 628 638 643 649 657 667 670 682 696 700 703 705 707 708 715 716 727 731 737 738 761 762 773 791 801 808 810 811 822 838 839 857 863 871 872 926 928 930 932 946 955 965 981 983 989 993 997 1006 1009 1015 1017 1019 1030 1046 1047 1067 1075 1076 1083 1086 1087 1095 1104 1111 1115 1133 1141 1144 
6 7 20 21 26 29 36 40 41 64 85 86 100 101 103 104 115 116 125 126 135 142 143 151 154 166 167 177 195 196 200 207 208 209 221 227 242 243 258 260 261 262 263 285 299 311 319 320 322 325 331 354 357 358 366 367 368 371 372 373 374 380 389 401 412 413 414 437 445 494 498 500 502 543 559 560 568 570 571 574 586 597 608 639 648 666 677 685 686 687 689 697 720 721 725 728 729 746 766 779 794 814 818 849 852 867 870 878 880 881 884 899 901 907 913 948 949 960 1000 1008 1023 1032 1038 1040 1056 1063 1082 1113 1120 
34 35 53 124 155 156 202 255 256 288 289 300 301 307 308 407 441 442 450 479 503 534 535 575 576 580 581 589 590 604 611 616 617 619 623 626 634 644 645 646 647 653 655 658 659 665 668 695 722 730 735 742 770 771 776 784 788 793 797 798 799 800 809 817 819 823 824 841 858 879 883 889 890 896 897 898 908 918 925 931 942 970 984 985 1016 1021 1022 1027 1031 1043 1052 1061 1066 1074 1077 1081 1089 1093 1102 1103 1114 1122 1124 1128 1138 1142 1149 1151 1152 
56 71 72 84 89 90 105 106 136 137 184 185 231 240 241 269 270 291 292 293 294 305 306 317 338 339 345 348 390 394 425 428 431 432 436 443 449 459 460 464 465 468 475 476 504 505 514 515 561 579 587 588 600 606 650 671 674 675 693 702 717 743 744 749 790 803 804 807 820 833 842 843 844 848 853 868 882 891 892 895 920 922 938 977 986 991 995 1037 1044 1048 1050 1051 1055 1073 1085 1116 1117 1121 
2 3 119 120 127 128 149 161 165 170 171 274 277 278 290 309 316 349 350 364 384 385 402 403 418 419 461 483 492 519 531 545 548 557 598 613 641 656 699 709 750 755 795 816 850 851 859 860 875 886 910 911 923 934 940 950 951 952 961 999 1018 1020 1026 1041 1092 1123 1135 1139 1147 
16 81 82 97 146 147 172 173 191 192 205 219 257 259 267 283 284 330 379 424 466 493 525 530 562 563 569 583 584 585 620 629 630 651 662 711 714 718 726 736 752 753 780 787 837 856 906 916 927 941 956 959 972 975 1001 1014 1025 1028 1042 1049 1064 1100 1118 1126 1140 1148 
54 55 98 217 272 273 326 510 555 556 567 602 603 652 690 691 710 740 741 756 821 835 846 854 862 921 954 971 1007 1012 1024 1035 1039 1045 1053 1058 1062 1070 1078 1080 1088 1090 1094 1098 1099 1109 1110 1119 1125 1131 1132 
4 5 17 91 92 93 94 150 182 183 190 213 214 280 281 323 351 352 365 438 495 511 552 554 618 664 694 704 760 767 829 900 943 962 963 987 1010 1071 1084 1097 1107 1134 1143 
112 113 121 122 144 145 159 160 215 216 381 396 397 404 405 471 487 528 536 537 595 596 614 621 936 939 953 
49 50 188 189 253 254 388 433 446 447 553 594 680 789 834 914 992 1011 1079 
163 164 220 238 239 271 463 632 633 815 826 
398 399 627 712 713 758 774 777 944 964 
362 451 517 518 723 874 915 1057 1091 
14 15 480 484 488 973 
473 474 887 888 1003 1004 
805 806 1106 
