7 47 48 91 108 125 143 159 190 219 223 224 323 329 381 414 445 471 495 507 537 541 542 572 618 638 669 688 694 798 811 818 822 839 843 881 890 949 960 967 1019 1074 1084 1097 1101 1150 
14 34 35 60 83 84 128 189 247 254 300 406 523 524 534 535 557 593 634 645 654 655 695 706 729 733 770 795 879 889 897 931 968 984 995 999 1021 1023 1031 1066 1077 1086 1104 1114 1128 1146 
8 15 18 32 38 51 79 130 151 158 168 169 181 265 311 332 389 400 440 465 478 513 514 529 578 591 597 660 739 741 833 892 907 912 935 1040 
12 101 114 345 378 409 410 425 490 538 546 558 627 651 672 673 699 743 744 750 778 874 876 895 925 945 1050 1136 
135 140 148 167 198 207 237 295 296 324 356 649 700 705 707 727 863 928 946 948 965 1095 
41 61 107 120 285 320 328 448 485 493 550 620 662 687 689 703 748 872 878 1096 1137 
71 138 180 204 230 268 310 342 385 422 573 624 670 762 782 858 861 1000 1027 1151 
92 149 150 183 213 215 280 281 365 438 554 585 664 704 767 829 900 1036 1071 
28 131 132 206 225 313 392 420 441 540 604 732 757 836 996 1037 1069 1147 
113 122 144 145 160 182 216 396 404 487 528 536 595 596 621 936 939 1143 
36 163 164 220 238 239 271 370 393 394 451 463 505 582 607 683 826 
166 174 232 234 446 533 819 832 910 911 937 955 957 1004 1008 1113 1120 
10 30 66 67 261 366 449 556 642 814 853 947 1059 1119 1127 1138 
22 57 97 129 153 179 229 266 293 455 496 581 631 653 709 817 
52 146 192 284 466 562 563 584 711 714 753 780 856 1014 1049 
54 55 93 405 710 740 954 1035 1053 1058 1078 1109 1110 1125 1131 
76 82 95 117 118 162 178 197 211 214 282 613 726 837 838 
26 349 364 499 520 622 698 797 859 904 905 918 990 1032 
121 165 292 314 375 390 428 674 675 790 813 919 920 1051 
2 172 429 587 736 756 835 845 846 914 1080 1085 1139 
5 273 302 326 439 503 623 637 652 656 987 1094 1135 
64 274 401 519 531 545 715 742 755 816 875 899 913 
104 116 286 357 502 559 574 630 720 728 779 823 962 
37 123 253 304 472 680 745 902 933 952 978 1043 
398 416 489 588 713 758 774 777 944 951 964 1142 
312 333 377 457 543 681 773 849 870 884 992 
338 339 431 459 460 482 579 844 923 991 1116 
87 399 413 469 470 609 800 801 871 1079 
90 137 184 185 306 317 848 891 977 1048 
303 415 421 454 526 763 781 796 873 924 
33 39 44 297 335 353 456 787 1030 
72 322 380 539 570 615 639 802 917 
255 256 301 307 308 479 575 647 1103 
6 29 86 115 242 243 373 374 
16 96 154 417 437 697 994 1038 
81 199 474 568 857 959 969 986 
88 141 152 383 612 737 930 1144 
99 803 804 807 868 922 1007 1060 
105 269 270 476 504 671 747 882 
133 363 395 430 544 746 938 975 
171 245 501 619 821 887 896 1045 
260 473 592 644 676 888 1003 1011 
24 25 461 462 626 717 718 
27 157 193 252 663 1015 1111 
142 484 491 569 648 684 723 
352 599 600 641 722 1041 1123 
433 481 788 941 958 988 1148 
21 903 993 997 1075 1115 
42 106 186 350 475 1026 
68 74 387 506 530 985 
77 127 402 419 486 940 
112 403 549 678 692 1005 
147 852 1028 1047 1067 1100 
156 785 786 841 983 1009 
170 175 176 693 759 1121 
177 494 553 696 794 860 
226 450 598 603 1098 1152 
228 267 434 783 812 828 
257 258 259 424 805 906 
327 343 583 869 1126 1140 
382 444 606 775 908 1108 
435 436 561 635 636 1130 
508 509 580 589 799 972 
3 20 63 235 443 
11 70 194 201 880 
13 810 966 1087 1133 
23 263 289 516 1076 
31 576 629 1099 1124 
69 749 772 886 982 
73 217 288 318 321 
100 369 379 666 667 
109 291 407 617 1016 
139 279 336 708 809 
191 567 586 735 854 
241 468 702 751 1117 
262 738 768 769 1065 
277 278 498 885 1020 
298 423 915 1057 1091 
346 347 361 625 808 
411 701 1033 1034 1054 
0 222 290 677 
4 17 227 760 
9 94 391 1046 
40 188 196 628 
43 200 246 721 
46 334 716 766 
53 155 221 961 
58 62 75 386 
59 551 564 1145 
65 251 351 565 
89 325 337 426 
111 331 909 998 
161 315 316 552 
233 275 685 825 
240 480 488 973 
244 264 894 1112 
249 362 661 754 
283 412 510 511 
330 492 548 1042 
427 791 793 1081 
464 500 632 633 
497 665 929 970 
521 605 898 971 
555 862 921 1024 
608 643 1055 1056 
610 650 1073 1141 
646 1061 1090 1149 
690 691 1039 1132 
724 792 820 1022 
1 210 547 
19 842 976 
45 367 616 
49 359 789 
50 776 1013 
78 850 851 
80 358 942 
98 276 1012 
102 512 901 
119 187 218 
124 447 611 
126 458 477 
136 250 515 
195 368 467 
202 203 1044 
209 712 934 
248 299 532 
287 784 830 
354 483 686 
355 815 974 
371 1025 1072 
372 527 824 
388 657 1083 
397 943 953 
408 725 950 
442 771 883 
452 731 989 
517 518 877 
560 658 867 
602 1070 1102 
679 855 927 
730 827 1089 
734 963 1052 
