1 10 18 19 28 30 32 38 39 42 44 46 58 59 62 65 71 72 73 74 75 76 79 80 105 118 119 130 131 147 148 157 162 165 168 169 174 178 181 187 193 194 197 210 218 222 225 226 246 248 249 252 262 264 275 276 278 282 286 288 291 292 297 298 299 300 313 318 334 340 348 349 353 378 382 386 387 390 392 395 417 420 423 456 494 496 498 499 503 506 512 513 514 520 532 539 540 566 591 622 641 642 645 661 688 720 732 734 735 739 741 751 783 790 802 825 828 830 840 854 873 915 935 967 990 1012 1015 1020 1041 1043 1059 1060 1069 1100 1108 1114 1123 1127 1138 
47 48 91 108 112 113 122 145 159 190 215 216 223 224 323 329 341 381 396 404 405 460 471 487 528 536 537 542 572 595 596 618 621 669 694 772 798 811 822 839 890 936 939 947 949 953 1009 1019 1037 1084 1097 1101 1122 1150 
114 117 211 320 368 379 409 410 430 485 493 529 530 538 546 550 620 651 703 726 737 748 778 785 786 787 837 838 857 872 996 1011 1118 1137 1144 
7 9 11 68 86 95 123 201 212 233 250 251 272 273 280 326 327 391 482 484 507 515 522 547 562 614 639 648 652 816 843 931 1046 
67 96 155 156 171 245 385 481 509 580 624 629 647 657 722 730 776 799 819 824 985 988 1022 1045 1124 
26 81 102 111 154 198 199 235 236 304 331 364 568 577 901 909 932 937 986 998 1032 1063 
5 69 177 314 366 397 521 583 674 675 725 788 820 832 885 920 941 982 1126 1140 1148 
27 41 126 188 189 343 359 373 433 457 458 554 578 597 705 717 718 757 926 1067 1111 
29 109 135 206 207 242 243 295 296 324 356 367 604 700 707 867 928 948 965 983 1017 
90 137 184 185 265 317 435 436 465 468 650 834 848 853 891 892 977 1048 1073 1117 
432 523 524 803 814 852 889 897 898 952 995 999 1028 1047 1051 1056 1064 1086 1104 
352 439 555 556 600 690 691 821 862 921 1024 1039 1072 1119 1131 1132 1135 
56 440 450 489 490 561 598 603 635 636 637 749 893 912 1098 1152 
6 234 263 446 728 856 895 910 911 1004 1008 1021 1082 1113 1120 
78 129 369 469 533 581 727 747 801 850 851 930 1079 1128 
150 183 213 254 281 351 365 438 585 664 767 829 900 1071 
14 34 406 534 557 706 729 770 968 984 1031 1038 1077 
23 227 256 279 321 322 497 508 551 665 701 880 1145 
0 64 88 274 290 519 531 750 755 859 875 899 
8 110 125 133 134 158 311 312 543 544 746 804 
36 106 239 504 505 548 683 797 810 946 991 1094 
20 21 53 335 545 666 667 768 769 771 961 
24 54 55 630 740 756 835 846 1053 1080 1125 
209 398 399 619 712 758 774 777 944 964 1023 
261 284 403 549 656 677 678 684 692 693 1005 
40 107 120 140 167 325 328 363 794 960 
82 146 191 192 466 563 586 780 1014 
83 84 247 593 654 655 795 879 1146 
93 336 418 422 601 708 710 1109 1110 
121 388 389 437 841 849 884 908 1093 
214 350 380 571 695 904 976 1026 1147 
270 338 339 431 459 579 833 844 858 
2 144 232 736 902 945 1085 1139 
87 89 337 346 426 625 989 1083 
99 241 807 868 905 922 938 1007 
293 407 427 455 653 887 924 970 
12 160 345 425 743 744 1050 
16 85 101 285 448 696 994 
25 289 612 627 925 981 1025 
51 66 400 477 492 660 733 
97 179 266 631 687 709 817 
115 170 219 613 713 934 951 
124 237 287 402 658 659 784 
138 139 344 370 617 715 1006 
166 221 649 738 863 919 1065 
173 525 827 894 916 1001 1089 
257 258 259 424 805 1040 1095 
308 355 444 606 815 845 974 
13 195 374 589 1087 1133 
49 408 472 680 789 992 
98 429 943 954 1035 1058 
163 164 220 238 271 826 
208 231 307 479 779 1103 
217 330 567 942 1042 1066 
229 415 526 681 763 796 
244 428 800 966 972 1112 
269 305 445 663 842 861 
362 517 518 812 877 969 
454 467 573 762 781 782 
558 673 874 1057 1091 1136 
4 17 371 760 987 
15 151 480 488 808 
33 161 315 384 474 
45 541 616 634 809 
57 394 463 671 813 
61 662 689 869 1096 
77 127 419 486 940 
94 149 441 442 883 
116 358 638 792 971 
141 473 592 888 1003 
302 608 672 716 955 
3 443 1018 1116 
31 576 1016 1099 
50 316 552 1013 
103 333 377 870 
104 582 607 640 
175 176 527 978 
196 383 628 766 
310 697 721 1000 
416 449 588 1142 
464 500 632 633 
570 615 668 752 
574 646 714 1149 
584 699 818 906 
745 773 933 1074 
775 866 929 957 
791 793 876 1081 
903 993 997 1075 
1061 1070 1078 1090 
22 230 451 
35 182 1143 
52 711 1049 
70 301 896 
92 128 1036 
100 268 502 
152 153 950 
172 623 1115 
180 357 962 
186 475 918 
202 203 1044 
228 434 882 
260 565 676 
283 360 575 
332 347 501 
342 361 605 
372 516 1076 
393 670 956 
411 643 1055 
413 470 871 
421 626 836 
452 453 731 
461 462 1092 
491 702 723 
495 510 511 
559 823 975 
609 754 907 
679 855 927 
860 1027 1151 
1033 1034 1054 
