7 47 48 54 55 91 92 93 98 99 108 112 113 122 125 143 144 145 149 150 159 160 170 175 176 182 183 190 213 215 216 224 276 280 281 309 319 323 327 343 365 381 396 403 404 405 414 438 441 442 445 471 487 495 507 528 536 537 541 542 549 572 583 585 595 596 618 621 638 664 669 678 688 690 691 692 693 694 704 710 740 759 767 771 798 803 804 807 811 818 822 829 839 843 868 869 875 883 890 900 913 922 936 939 949 954 960 967 1005 1007 1012 1019 1035 1036 1039 1053 1058 1060 1071 1074 1078 1084 1097 1101 1105 1107 1109 1110 1121 1125 1126 1129 1131 1132 1134 1140 1143 1150 
2 5 21 23 33 36 39 44 49 50 161 163 164 166 172 174 198 208 220 230 231 232 234 238 239 260 271 273 297 302 315 316 326 353 354 359 360 370 393 394 429 439 446 456 463 473 483 503 517 518 533 552 554 571 582 587 590 592 607 644 652 659 676 683 686 736 756 761 764 765 776 787 789 819 826 832 835 840 845 846 863 877 888 903 910 911 914 937 955 957 987 993 997 1003 1004 1008 1011 1013 1030 1075 1080 1082 1085 1094 1113 1115 1120 1122 1135 1139 
8 15 18 28 31 32 38 51 78 79 109 130 131 135 148 151 158 168 169 181 206 207 225 236 265 291 295 296 305 311 313 332 340 341 355 356 382 389 392 400 408 420 435 436 440 444 465 478 513 514 529 540 561 576 577 578 591 597 604 606 617 635 660 701 705 707 724 725 732 734 739 741 753 757 775 792 815 820 833 836 850 851 892 907 908 912 926 928 935 948 950 956 963 974 996 1016 1022 1033 1034 1040 1052 1054 1063 1069 1095 1099 1108 1130 1147 
3 20 22 46 57 63 67 71 97 111 124 126 129 138 139 140 154 179 180 204 229 235 237 261 266 268 279 293 294 303 310 330 331 334 336 342 385 398 411 415 416 418 421 422 443 451 454 455 464 477 489 492 496 500 526 548 573 581 588 601 608 623 624 631 632 633 643 653 670 708 709 713 716 727 751 758 762 763 766 774 777 781 782 796 809 817 847 858 861 873 909 924 944 946 951 964 998 1000 1027 1042 1055 1056 1142 1151 
1 9 11 16 41 61 68 70 74 76 82 85 88 94 95 96 100 107 117 118 120 162 167 177 178 194 197 201 210 211 214 219 223 233 262 275 282 285 320 328 344 369 379 387 391 417 437 448 485 493 494 506 530 547 550 553 613 620 637 651 662 666 667 685 687 689 696 697 703 726 737 738 748 750 769 794 825 837 838 842 860 878 880 976 985 994 1046 1065 1096 1137 1144 
14 34 35 60 77 83 84 127 128 132 156 189 202 203 247 263 289 300 402 406 407 419 447 486 497 516 523 524 534 535 557 593 594 611 634 645 646 654 655 665 679 682 695 706 729 733 742 770 785 786 795 831 855 879 889 897 927 929 931 940 968 970 983 984 995 999 1009 1017 1018 1021 1023 1031 1044 1061 1066 1068 1076 1077 1086 1090 1104 1114 1128 1146 1149 
42 69 90 106 119 121 136 137 165 171 184 185 186 187 218 245 250 255 256 292 301 306 307 308 314 317 338 339 350 375 390 428 431 459 460 475 479 482 515 522 555 575 579 614 619 647 656 674 675 749 813 821 844 848 862 886 887 891 896 919 920 921 923 977 982 991 1024 1026 1037 1045 1048 1051 1103 1116 
12 56 59 101 105 114 191 269 270 272 345 372 378 397 409 410 425 433 452 476 481 490 504 505 527 538 546 551 558 564 567 586 627 636 671 672 673 699 730 731 735 743 744 747 778 788 824 827 854 874 876 882 895 925 941 943 945 953 958 988 989 1050 1057 1089 1091 1136 1145 1148 
0 52 58 64 75 212 222 228 249 257 258 259 267 274 283 290 312 333 362 371 377 386 412 424 434 457 510 511 519 531 543 545 560 566 658 661 677 681 711 715 754 755 773 783 805 806 812 816 828 849 867 870 884 899 906 992 1025 1072 1106 
19 27 43 65 73 103 104 116 157 193 200 217 241 244 246 248 251 252 264 286 287 288 298 299 318 321 351 357 423 468 502 532 559 565 574 663 702 714 720 721 728 779 784 790 823 830 894 915 962 1015 1088 1111 1112 1117 
4 6 13 17 29 40 53 86 115 155 188 195 196 209 221 227 242 243 368 373 374 388 432 467 508 509 580 589 628 629 657 712 760 799 810 841 934 961 966 972 1001 1002 1029 1064 1083 1087 1092 1093 1118 1124 1133 
45 87 102 146 147 173 192 205 277 278 284 367 376 399 413 466 469 470 498 512 525 562 563 584 609 610 616 630 650 780 800 801 852 856 871 881 885 893 901 916 1014 1020 1028 1047 1049 1067 1073 1079 1100 1141 
10 30 80 81 89 199 324 325 337 346 347 352 358 361 366 401 426 449 474 501 556 568 599 600 625 641 642 722 808 814 853 857 932 942 947 959 965 969 986 1006 1038 1041 1059 1119 1123 1127 1138 
62 66 141 142 152 153 240 254 329 335 348 383 384 453 480 484 488 491 521 569 605 612 640 648 684 700 719 723 768 772 834 866 898 971 973 981 1010 1062 
26 37 72 123 253 304 322 349 364 380 472 499 520 539 570 615 622 639 668 680 698 745 752 797 802 859 902 904 905 917 918 933 952 978 990 1032 1043 
24 25 110 133 134 226 363 395 427 430 450 458 461 462 544 598 602 603 626 649 717 718 746 791 793 872 930 938 975 1070 1081 1098 1102 1152 
