7 14 26 29 34 40 43 47 48 61 64 81 82 85 87 88 96 101 102 107 108 111 116 135 138 139 140 146 154 155 156 158 166 167 185 191 192 195 198 199 204 205 207 211 221 223 230 235 236 237 242 243 244 245 247 261 267 290 294 295 296 302 303 305 319 323 324 325 328 329 331 332 333 336 337 341 347 355 363 364 370 373 374 385 401 402 412 428 445 448 470 498 501 509 514 518 563 568 572 577 578 580 586 590 593 598 608 610 618 624 629 638 647 649 657 658 659 666 669 672 677 678 680 682 694 696 700 707 708 715 716 722 730 731 738 742 755 761 764 765 776 780 784 791 794 798 799 800 803 819 824 839 842 847 856 861 863 871 875 890 901 903 913 919 923 924 932 948 949 955 958 960 965 966 972 974 983 986 993 1009 1014 1019 1032 1037 1045 1063 1075 1084 1096 1097 1101 1115 1122 1124 1146 
1 10 18 19 28 30 32 38 39 42 44 46 52 58 62 70 71 72 73 74 75 79 80 103 105 118 119 130 131 132 147 148 157 162 165 168 169 174 178 181 187 193 194 197 218 222 225 226 246 248 249 252 262 264 275 276 278 282 286 287 288 297 298 300 313 318 320 334 340 348 349 353 368 378 382 386 387 390 392 395 417 420 456 464 473 485 494 496 499 506 512 513 519 520 530 532 539 540 558 566 592 606 632 633 642 661 688 689 720 732 734 739 741 772 783 790 802 825 828 830 840 873 896 935 947 967 985 990 1001 1012 1015 1059 1060 1067 1069 1100 1105 1112 1114 1118 1127 1129 1137 1138 1147 
2 22 23 24 36 37 49 65 97 106 144 179 203 224 227 228 232 239 253 256 270 279 285 301 304 315 321 322 354 410 451 472 483 491 493 497 504 505 508 515 525 551 565 570 630 634 655 665 687 701 702 709 723 736 752 770 789 793 797 810 817 827 831 846 874 879 880 882 894 902 937 945 946 959 968 978 991 1006 1013 1017 1018 1023 1043 1044 1057 1073 1077 1081 1085 1089 1091 1094 1139 1141 1145 
4 17 50 90 137 184 214 260 265 316 317 346 350 371 380 393 411 413 426 432 465 523 524 541 552 559 571 599 615 616 622 631 643 644 645 670 676 686 695 760 795 809 811 814 823 834 848 852 853 860 889 891 892 897 898 904 917 940 952 956 963 975 976 977 987 995 999 1026 1027 1028 1031 1047 1048 1051 1052 1055 1056 1064 1072 1083 1086 1104 1151 
5 55 69 83 84 100 110 125 133 134 172 173 177 186 213 259 268 269 281 292 306 311 312 314 351 365 366 375 408 429 433 438 452 453 475 476 481 486 502 521 543 544 574 583 584 585 601 623 654 662 664 671 674 675 685 699 714 725 735 743 746 747 767 804 818 820 832 854 885 900 906 916 918 920 941 982 997 1022 1042 1125 1126 1140 1148 
9 11 16 68 76 86 95 114 117 123 124 183 201 210 212 233 250 251 254 272 273 280 299 326 327 391 409 430 482 484 503 507 522 538 546 547 550 562 620 621 639 641 648 651 652 673 703 726 778 785 786 792 816 837 838 843 857 872 931 971 994 996 1011 1020 1033 1034 1041 1046 1054 1123 1136 1150 
6 35 92 112 113 121 122 128 145 150 159 160 182 215 216 234 308 345 381 388 389 396 397 404 405 437 444 446 471 487 528 536 537 587 588 589 594 595 596 614 841 849 869 870 884 895 907 908 910 911 936 939 953 1004 1008 1016 1021 1036 1065 1068 1088 1092 1093 1108 1113 1120 1143 
25 27 41 53 59 126 188 189 255 289 309 343 356 359 421 447 457 458 461 462 554 560 597 602 611 612 626 627 646 705 717 718 728 757 766 812 822 836 925 926 981 1025 1061 1070 1090 1102 1111 1149 
0 31 45 56 57 77 127 274 376 377 394 422 425 435 436 440 450 463 468 489 490 531 561 603 635 636 637 650 719 724 744 749 750 813 859 893 899 912 961 1050 1098 1099 1117 1130 1152 
94 149 153 180 190 200 293 310 357 379 406 407 414 416 427 441 449 455 500 553 653 683 697 698 704 711 721 729 787 876 883 887 888 909 962 970 998 1000 1003 1038 1049 1071 1107 1134 1142 
54 93 98 330 352 439 495 510 511 555 556 600 690 691 710 740 821 829 862 921 942 943 954 1024 1035 1039 1053 1058 1066 1078 1109 1110 1119 1131 1132 1135 
33 115 120 161 170 171 219 284 358 384 403 418 419 423 474 542 557 613 656 684 692 693 713 751 915 934 951 1005 
8 51 66 67 104 263 266 372 400 477 478 492 516 582 607 640 660 733 753 759 1076 1121 
78 129 362 369 434 469 517 533 576 581 663 668 727 801 851 877 930 969 973 992 1079 1128 
15 151 208 231 240 277 307 338 339 431 459 460 479 480 488 579 779 808 844 881 1103 
91 99 217 241 567 756 807 833 835 858 868 905 922 938 984 1007 1080 
89 257 258 360 424 625 745 773 805 806 933 989 1040 1074 1095 1106 
142 202 442 466 467 534 569 573 679 706 762 771 782 855 927 988 
3 20 21 60 63 143 335 443 535 545 628 667 768 769 1116 
12 13 109 196 206 291 344 383 591 617 788 850 928 1087 1133 
141 163 164 220 238 271 775 815 826 845 866 929 957 1010 1062 
209 398 399 619 712 758 774 777 878 914 944 964 
175 176 229 415 454 526 527 681 763 781 796 
136 283 342 361 575 605 886 
367 548 549 604 748 867 1082 
529 609 737 754 1144 
152 564 950 1030 
