7 26 29 34 40 43 47 48 61 64 81 82 85 96 101 102 107 108 111 116 140 142 146 154 155 156 166 167 191 192 195 198 199 207 211 221 223 235 236 237 241 242 243 244 245 267 269 277 290 295 296 302 305 319 323 324 325 328 331 332 347 363 364 402 412 445 470 498 501 509 514 518 531 563 569 572 577 580 581 586 590 593 598 608 609 618 629 630 638 647 649 657 658 659 666 672 677 678 679 680 694 696 702 706 716 722 730 737 738 742 754 770 776 780 784 791 794 798 799 800 803 819 823 824 839 842 855 861 863 875 881 901 913 919 927 932 946 948 949 955 960 965 966 968 972 986 1009 1014 1019 1032 1045 1063 1084 1096 1097 1101 1122 1124 1144 1146 
1 10 18 19 28 30 32 38 39 42 44 46 52 58 62 70 71 72 73 74 79 80 105 118 119 130 131 132 147 148 157 162 165 168 169 174 178 181 186 193 194 197 218 222 225 226 246 248 249 252 262 264 274 275 276 278 282 286 287 288 297 298 300 313 318 320 334 340 348 349 353 368 378 382 385 386 387 390 392 395 410 417 420 456 464 473 485 494 496 499 506 512 513 519 520 530 532 539 540 558 566 592 606 622 632 633 642 661 669 688 689 720 732 734 739 741 772 783 790 802 825 828 830 840 873 896 935 947 967 973 985 990 1012 1015 1020 1037 1059 1060 1067 1069 1100 1105 1112 1114 1127 1129 1137 1138 1147 
2 22 23 36 37 49 65 97 103 106 144 179 203 214 224 228 239 253 256 261 266 279 285 301 315 316 350 354 367 423 434 451 472 483 491 493 497 504 505 508 525 548 549 551 552 587 603 604 631 655 665 686 687 701 709 723 736 748 752 789 797 817 827 831 867 874 880 882 894 902 904 945 976 991 1017 1018 1023 1026 1043 1044 1047 1057 1073 1077 1085 1088 1089 1091 1094 1098 1139 1141 1145 
5 8 51 69 83 84 100 109 110 125 133 134 158 172 177 206 213 268 281 291 292 306 308 311 312 314 351 355 365 366 375 393 408 428 429 438 444 452 453 475 502 521 543 544 567 583 585 591 601 623 654 664 670 671 674 675 725 735 746 747 767 788 804 820 832 850 854 885 900 918 920 941 956 982 997 1022 1108 1126 1140 1148 
50 90 137 184 185 240 260 265 317 380 411 413 426 465 468 515 523 524 542 559 565 594 599 610 615 643 644 645 695 795 810 811 814 834 848 852 853 860 879 889 891 892 897 898 917 952 963 975 977 995 999 1013 1021 1028 1031 1048 1051 1052 1055 1056 1064 1068 1083 1086 1104 1117 
9 11 14 68 86 95 123 124 135 187 201 210 212 233 247 250 251 272 273 280 299 303 326 327 333 341 391 401 482 484 488 503 507 522 538 546 547 562 568 639 641 648 652 653 673 676 778 816 843 870 923 924 931 958 1041 1046 1123 1136 1150 
6 12 13 24 55 87 88 138 139 196 204 205 230 232 234 294 344 370 383 388 389 405 437 446 588 617 624 715 761 841 846 847 849 856 869 871 884 895 908 910 911 928 1004 1006 1008 1087 1092 1093 1113 1120 1125 1133 
16 20 21 25 27 41 53 59 126 188 189 255 289 309 335 343 356 359 373 448 457 458 461 462 545 554 560 597 611 612 627 628 667 705 717 718 728 757 766 768 769 812 822 925 926 981 994 1025 1111 
4 33 94 115 120 149 161 170 171 190 219 321 322 329 384 418 419 441 442 455 474 534 557 570 571 613 700 704 713 751 755 771 883 887 888 915 934 940 951 959 983 988 1003 1065 1071 1082 1107 1134 
91 99 153 217 231 270 293 338 339 372 379 416 421 427 431 432 449 459 460 516 579 626 683 711 756 787 833 835 836 844 858 868 905 909 938 970 974 998 1007 1049 1076 1080 1142 
0 31 45 56 57 77 127 374 376 394 422 425 433 435 436 440 450 463 481 489 490 529 561 635 636 637 681 719 724 749 750 813 859 893 899 912 961 1099 1130 1152 
54 93 98 173 330 352 439 495 510 511 555 556 600 690 691 710 740 821 829 862 916 921 942 943 954 1024 1035 1039 1053 1058 1066 1072 1078 1109 1110 1119 1131 1132 1135 
114 117 183 254 263 284 358 403 409 430 550 620 621 651 656 684 692 693 703 726 743 744 785 786 792 837 838 857 872 971 996 1005 1011 1033 1034 1050 1054 
35 92 112 113 121 122 128 145 150 159 160 182 215 216 345 381 396 397 404 471 487 528 536 537 589 595 596 614 907 936 939 953 1016 1036 1143 
17 75 76 227 336 337 346 371 447 541 578 616 682 707 708 731 760 764 765 809 903 987 993 1027 1075 1115 1151 
78 129 362 369 469 517 533 576 663 668 727 796 801 807 851 877 922 930 969 992 1079 1128 
175 176 180 229 357 406 407 414 415 500 526 527 553 729 763 962 978 1038 
66 67 104 400 477 478 492 582 607 640 660 733 753 759 1121 
141 163 164 220 238 271 775 815 826 845 866 929 957 1010 1062 
200 202 310 454 466 467 573 697 698 721 762 781 782 890 1000 
15 151 208 259 307 476 479 480 574 685 714 779 808 1103 
89 257 258 424 625 650 805 806 989 1040 1095 1106 
209 398 399 619 712 758 774 777 878 914 944 964 
60 377 535 745 773 933 984 1074 
136 283 342 360 361 575 605 886 
486 584 662 699 818 906 1042 
602 646 1061 1070 1090 1102 1149 
304 634 793 876 937 1081 
3 63 143 443 1116 
152 564 950 1030 
