11 16 17 41 61 76 85 96 107 117 120 167 214 219 223 262 285 320 328 344 365 417 437 448 485 493 494 522 550 553 614 620 662 687 689 696 697 703 738 748 760 769 878 994 1065 1096 1137 
7 47 48 91 108 159 190 224 323 329 381 414 438 471 495 507 537 541 542 572 618 669 688 694 767 798 811 822 839 843 890 949 967 1019 1074 1084 1097 1101 1150 
166 174 234 354 446 533 587 594 644 686 832 856 910 911 955 957 1004 1008 1021 1068 1082 1113 1120 
113 122 144 145 150 160 182 215 216 396 404 487 528 536 595 596 621 936 939 1143 
338 339 398 416 459 579 588 713 758 774 777 844 924 944 951 964 1142 
30 105 366 449 501 556 679 814 853 947 1038 1059 1119 1127 1138 
54 55 93 405 710 740 954 1035 1053 1058 1078 1109 1110 1125 1131 
103 312 333 377 421 457 543 681 773 849 870 873 884 992 1088 
171 245 255 256 301 307 308 479 619 647 821 887 896 1045 1103 
83 84 247 261 300 593 654 655 678 733 795 879 1114 1146 
35 254 523 524 535 645 889 897 995 999 1066 1086 1104 
109 135 148 237 295 296 324 356 700 928 948 965 1095 
4 5 225 273 302 439 503 637 652 987 1094 1135 
6 29 86 115 195 242 243 368 373 374 466 467 
8 18 130 311 332 578 591 597 739 833 935 1040 
12 114 409 410 425 538 546 651 672 778 876 945 
26 304 349 364 499 698 797 859 905 918 990 1032 
94 101 143 177 378 391 699 794 818 860 960 1046 
2 172 429 736 756 835 845 846 1080 1085 1139 
9 51 63 66 67 266 400 478 640 660 753 
10 32 79 169 181 305 440 445 642 741 854 
36 232 326 370 408 505 582 810 946 1087 1133 
38 131 132 168 313 420 513 540 757 1069 1147 
87 399 413 469 470 609 610 800 801 871 1079 
104 286 357 502 559 574 720 728 779 823 962 
123 442 472 680 745 883 933 952 978 988 1043 
163 164 220 238 239 271 464 500 632 633 826 
0 249 258 362 434 661 677 754 805 907 
31 78 206 207 576 705 707 850 1016 1099 
57 97 179 455 489 631 636 709 790 817 
64 274 519 531 545 715 755 816 899 1013 
72 322 539 570 615 639 725 802 917 950 
81 199 474 568 666 771 857 959 969 986 
90 137 184 185 306 317 436 848 891 1048 
241 265 465 468 514 751 892 912 1117 
345 476 671 743 744 747 882 895 1050 
33 39 44 297 456 520 787 1030 
92 149 213 281 664 704 1036 1071 
99 803 804 807 868 922 1007 1060 
119 121 187 353 390 392 663 1037 
140 433 481 727 788 941 958 1148 
229 303 415 454 526 763 781 796 
292 314 375 674 675 919 920 1051 
497 634 665 682 831 929 970 1128 
527 627 683 730 824 827 925 1089 
15 151 158 227 279 563 586 
20 27 154 193 235 573 1111 
134 363 430 544 746 938 975 
260 473 592 676 888 1003 1011 
316 393 394 431 463 552 650 
352 599 600 641 722 1041 1123 
1 162 280 387 547 869 
23 198 337 701 1033 1034 
28 189 534 706 1073 1141 
34 60 128 557 931 984 
62 335 484 648 684 768 
69 749 772 886 982 991 
73 217 288 318 321 567 
77 127 402 419 486 940 
106 350 571 622 695 1026 
116 358 389 530 630 638 
142 348 384 491 569 723 
146 192 284 562 1014 1049 
147 852 1028 1047 1067 1100 
170 175 176 693 759 1121 
173 376 525 584 780 916 
226 450 598 603 1098 1152 
382 444 606 775 908 1108 
508 509 580 589 799 972 
558 564 673 874 1091 1136 
3 330 492 548 1042 
21 903 993 997 1075 
22 293 451 653 902 
53 155 221 380 961 
95 178 211 282 837 
129 331 383 496 581 
138 342 624 670 762 
156 785 786 983 1009 
157 248 299 532 1015 
218 244 264 894 1112 
228 267 783 812 828 
263 289 516 575 1076 
327 343 583 1126 1140 
346 347 361 625 808 
388 629 657 1083 1124 
411 608 643 1055 1056 
427 649 791 793 1081 
724 792 820 1022 1054 
14 406 407 729 
24 25 461 462 
37 253 310 1000 
40 188 196 628 
42 186 475 714 
43 200 246 721 
46 334 716 766 
49 359 554 789 
59 551 607 1145 
65 251 351 565 
68 74 506 985 
70 194 201 880 
82 118 483 613 
110 838 932 1006 
112 403 549 1005 
124 268 1027 1151 
125 401 851 875 
139 336 708 809 
141 152 153 612 
183 585 829 900 
204 441 604 996 
233 275 685 825 
240 480 488 973 
283 510 511 906 
298 423 915 1057 
355 635 815 974 
422 443 782 858 
452 453 731 989 
521 605 898 971 
529 737 930 1144 
555 862 921 1024 
626 717 718 872 
646 1061 1090 1149 
690 691 1039 1132 
770 968 1031 1077 
19 252 702 
45 367 616 
56 272 561 
58 75 386 
71 269 861 
80 904 942 
89 325 426 
102 512 901 
111 909 998 
126 458 477 
133 395 836 
136 250 515 
161 315 656 
165 428 813 
197 236 726 
202 203 1044 
209 712 934 
210 276 566 
212 222 290 
277 881 1020 
278 498 885 
287 784 830 
291 617 692 
371 1025 1072 
397 943 953 
460 482 1116 
517 518 877 
560 658 867 
577 732 1063 
590 761 863 
602 1070 1102 
734 963 1052 
742 913 923 
841 1092 1093 
842 976 977 
1017 1018 1023 
