8 9 24 25 30 31 37 44 45 51 56 57 60 63 66 67 69 75 83 84 99 102 109 114 129 130 131 133 134 139 152 158 169 180 201 203 206 228 229 233 234 245 250 265 266 279 302 303 310 315 321 329 332 333 335 340 342 350 355 363 383 393 395 400 406 408 411 415 416 421 422 427 429 430 439 440 444 452 454 455 462 467 477 478 481 489 490 491 497 508 516 521 526 527 529 533 546 547 548 549 551 558 561 564 565 566 573 577 578 582 591 593 599 601 615 631 635 636 637 640 642 654 660 669 678 679 681 683 684 692 701 706 719 724 727 732 733 739 751 759 763 768 769 772 778 781 782 785 786 792 796 802 813 827 830 831 832 836 845 855 861 866 873 877 885 893 901 903 909 912 919 924 947 957 966 969 985 996 998 1005 1026 1033 1034 1054 1059 1060 1065 1067 1068 1069 1072 1108 1112 1127 1145 1146 1147 1150 
0 1 10 11 18 19 23 28 32 33 38 39 42 43 46 52 58 59 61 62 68 70 73 74 76 77 78 79 80 95 96 107 108 117 118 148 157 162 168 174 175 176 178 179 181 186 187 193 194 197 210 211 212 218 222 225 226 246 247 248 249 251 252 264 275 276 282 286 287 297 298 313 318 334 353 382 386 387 392 417 420 423 434 448 453 456 485 486 496 499 506 512 513 520 530 532 538 539 540 550 572 592 622 661 663 676 688 698 754 757 775 783 812 825 828 840 847 894 904 905 917 929 935 958 967 974 976 982 990 994 1036 1096 1101 1137 
27 47 48 65 87 88 110 111 138 140 198 199 204 223 224 230 235 236 237 244 268 312 324 327 328 336 337 344 346 347 359 361 369 370 376 377 391 426 469 470 482 501 507 509 522 523 524 541 542 544 605 607 609 610 624 625 638 643 649 657 667 670 682 696 703 707 708 715 716 731 737 738 761 762 791 801 808 811 822 839 857 863 871 872 930 932 955 983 989 993 997 1006 1009 1015 1019 1030 1046 1075 1076 1079 1083 1086 1104 1111 1115 1144 
16 81 82 97 146 147 172 173 191 192 205 219 257 259 267 283 284 330 360 424 466 493 525 562 563 569 583 584 585 620 629 630 651 662 711 714 718 726 736 752 753 780 837 856 869 906 916 927 941 956 972 975 1014 1025 1028 1042 1049 1064 1100 1126 1140 1148 
36 64 100 101 125 142 143 166 167 177 200 261 285 319 320 325 331 354 358 414 445 494 568 586 648 666 677 686 687 689 729 748 794 814 818 878 880 881 913 960 1000 1038 1063 
2 3 119 120 127 128 149 161 165 170 171 232 278 309 316 384 385 402 403 418 419 461 492 557 613 641 656 709 860 886 934 940 951 961 999 1041 1047 1123 1135 1139 
34 35 53 156 255 256 288 289 307 308 479 575 580 581 590 647 695 730 742 770 799 800 819 823 824 841 896 908 925 968 1031 1066 1077 1089 1092 1093 1103 
4 5 17 91 92 93 94 150 183 190 213 214 280 281 323 351 352 365 438 495 511 554 618 664 694 704 760 767 829 962 963 987 1010 1071 1084 
6 7 20 26 29 40 85 86 115 135 154 195 196 207 209 221 227 242 243 341 368 373 374 401 498 597 746 852 870 899 948 949 1032 1056 
112 113 121 122 144 145 159 160 182 215 216 381 396 397 404 405 471 487 528 536 537 552 595 596 614 621 900 936 939 943 953 1097 1143 
105 106 153 231 270 291 293 294 338 339 394 431 432 443 449 459 460 504 505 579 587 588 717 749 833 844 991 995 1055 1085 1116 1121 
89 90 136 137 184 185 240 241 305 306 317 464 465 468 514 515 606 650 702 790 842 843 848 853 891 892 1044 1048 1073 1117 1141 
21 41 103 104 116 126 151 208 258 263 357 371 372 500 502 559 560 571 574 608 639 685 720 728 766 779 1008 1040 1113 1120 
71 72 269 292 314 345 348 375 390 425 428 475 476 600 671 674 675 693 743 744 747 820 882 895 920 977 1037 1050 1051 
98 272 273 326 510 555 556 602 603 652 862 921 1012 1024 1094 1098 1119 
54 55 217 567 740 741 756 835 846 854 971 1007 1053 1080 1088 1125 
141 295 296 343 356 457 458 612 700 705 773 926 928 965 1074 
49 50 253 254 388 446 447 553 594 680 789 834 914 981 
262 299 322 366 367 380 412 413 570 697 721 725 867 1082 
690 691 710 954 1035 1039 1058 1070 1078 1090 1109 1110 1131 1132 
274 290 349 483 519 531 545 598 750 755 816 859 910 
450 616 668 793 809 897 898 1021 1027 1081 1151 1152 
123 304 472 745 797 798 933 937 978 988 1043 
163 164 220 238 239 271 463 632 633 815 826 
12 378 409 410 672 673 699 876 945 1136 
124 503 619 626 658 659 784 788 889 992 
398 399 627 712 713 758 774 777 944 964 
260 311 389 437 543 849 884 907 
803 804 807 868 922 938 986 
13 810 838 946 1087 1133 
14 15 480 484 488 973 
364 850 851 875 923 950 
473 474 887 888 1003 1004 
132 300 795 1114 1122 
155 589 722 776 1022 
362 451 517 518 915 
611 646 1061 1102 1149 
634 655 665 1124 1128 
22 902 959 1013 
188 189 433 1011 
301 735 858 879 
379 653 787 970 
407 576 617 1016 
441 604 942 1142 
534 535 931 984 
723 874 1057 1091 
821 1045 1062 1099 
435 436 1130 
442 771 883 
805 806 1106 
1017 1018 1023 
