1 10 18 19 30 32 38 39 42 44 46 52 58 62 71 72 73 74 79 80 105 118 119 130 131 132 147 148 157 162 165 168 169 174 178 181 186 193 194 197 218 222 225 226 246 248 249 252 262 264 274 275 276 278 282 286 287 288 297 298 300 313 318 320 334 340 348 349 353 368 378 382 385 386 387 390 392 395 417 420 456 464 473 485 494 496 499 506 512 513 519 520 530 532 539 540 558 566 592 606 632 633 642 661 669 688 689 720 732 734 739 741 772 783 790 802 825 828 830 840 873 935 947 967 973 985 990 1012 1015 1037 1059 1060 1067 1069 1100 1112 1114 1127 1137 1138 1147 
7 14 26 29 40 47 48 61 81 82 85 100 101 102 107 108 111 116 135 140 146 154 166 167 187 195 198 199 207 211 221 223 235 236 241 242 243 244 261 290 295 319 323 324 325 328 331 333 341 363 364 373 374 377 401 498 514 518 569 572 593 598 618 638 649 666 678 694 696 700 716 737 738 742 794 800 839 842 863 870 901 913 919 923 932 948 949 960 966 986 1009 1019 1032 1084 1096 1097 1101 1122 1144 1146 
9 11 68 76 86 95 114 117 123 183 201 210 212 233 250 251 272 273 280 299 326 327 391 409 430 482 484 507 522 538 545 546 547 550 562 620 621 639 641 648 651 652 653 703 726 778 785 786 792 816 837 838 843 857 872 931 971 996 1011 1020 1033 1034 1041 1046 1054 1123 1150 
34 64 75 103 158 224 523 524 594 645 655 695 770 791 814 875 889 897 952 968 995 999 1021 1047 1051 1056 1068 1077 1086 1104 
35 113 121 122 145 150 159 160 182 215 216 345 381 396 397 404 405 471 487 528 536 537 595 596 614 936 939 953 1143 
43 96 155 156 245 332 347 470 501 509 580 590 629 647 722 730 776 799 803 819 823 824 937 965 972 1045 1124 
16 27 41 59 126 188 343 356 359 457 458 531 554 597 705 717 718 728 757 812 822 926 994 1111 
5 69 109 177 291 292 306 314 375 521 591 671 674 675 747 820 832 920 941 982 1022 1148 
17 23 227 256 279 301 321 322 413 497 508 551 570 615 665 701 760 879 880 917 987 1145 
90 137 184 185 240 265 317 465 468 515 650 834 848 853 891 892 977 1048 1073 1117 
33 115 120 161 170 171 219 384 418 419 474 557 613 713 934 940 951 
6 232 234 263 446 588 761 856 895 910 911 1004 1008 1113 1120 
45 127 422 433 440 450 481 489 490 636 637 724 893 912 1152 
87 88 138 139 204 205 230 370 610 617 624 715 871 1006 
254 284 358 403 423 656 684 692 693 743 744 1005 1050 
36 49 106 239 270 451 504 505 789 991 1094 1141 
37 97 179 203 253 631 687 709 817 831 1023 1044 
78 129 369 533 576 581 668 727 801 851 992 1128 
336 337 447 578 682 707 708 731 903 993 1075 1115 
180 229 357 406 407 415 500 526 763 962 1038 
94 149 190 441 455 883 887 888 1003 1071 
209 398 399 619 712 758 774 777 944 964 
2 144 285 587 736 945 1085 1088 1139 
53 173 289 309 461 462 630 916 1025 
91 99 807 868 905 922 938 1007 1080 
98 555 556 821 862 921 1024 1053 1119 
163 164 220 238 271 394 463 813 826 
213 281 351 365 438 585 664 767 900 
214 350 380 571 622 904 976 1026 1082 
330 352 439 600 829 1066 1072 1131 1135 
366 475 583 725 869 885 918 1126 1140 
66 67 400 477 529 660 759 1121 
231 338 339 431 459 460 579 844 
237 402 421 626 658 659 784 946 
51 372 478 516 582 753 1076 
54 93 710 740 1078 1109 1110 
367 549 604 676 748 867 1043 
388 389 437 841 849 884 908 
454 466 467 573 762 781 782 
28 142 679 706 855 927 
55 355 428 654 854 1125 
110 133 134 312 429 804 
153 293 379 766 787 970 
191 192 563 586 780 1014 
196 344 383 628 1087 1133 
308 408 444 735 850 1108 
362 517 663 796 877 969 
411 643 810 811 898 1055 
0 750 859 899 961 
12 13 795 928 1031 
15 151 480 488 808 
60 745 773 933 1074 
125 543 544 746 997 
208 307 479 779 1103 
217 567 756 835 942 
257 258 805 1040 1095 
260 426 565 644 1083 
310 697 721 729 1000 
346 371 541 616 809 
416 449 711 1049 1142 
491 702 723 797 798 
646 1061 1070 1090 1149 
8 83 84 311 
20 21 335 667 
25 448 612 981 
31 77 611 1099 
50 316 552 1013 
56 57 425 561 
124 503 673 1136 
175 176 527 978 
228 434 874 882 
269 305 445 861 
302 608 672 955 
329 751 915 1065 
354 483 548 686 
427 683 909 998 
435 436 635 1130 
442 534 771 988 
525 827 894 1089 
584 699 818 1042 
599 860 1027 1151 
690 691 1039 1132 
775 866 929 957 
943 954 1035 1058 
3 443 1116 
4 704 959 
22 266 752 
65 315 472 
89 625 989 
92 128 1036 
104 607 640 
112 589 1016 
141 815 845 
172 601 623 
189 627 925 
259 574 714 
267 296 412 
283 535 575 
303 924 958 
342 361 605 
393 670 956 
469 930 1079 
486 662 906 
495 510 511 
542 852 1028 
577 677 1063 
603 902 1098 
609 754 907 
793 876 1081 
833 858 984 
