7 47 48 54 55 91 92 93 108 112 113 122 125 143 144 145 149 150 159 160 170 175 176 182 183 190 213 215 216 219 223 224 280 281 309 319 323 327 329 343 365 381 396 403 404 405 414 438 445 471 487 495 507 528 536 537 541 542 549 554 572 583 585 595 596 618 621 638 664 669 678 688 690 691 692 693 694 704 710 719 740 759 767 798 811 818 822 829 839 843 866 869 881 890 900 936 939 949 954 960 967 1005 1010 1019 1035 1036 1039 1053 1058 1062 1071 1074 1078 1084 1097 1101 1107 1109 1110 1121 1125 1126 1131 1132 1134 1140 1143 1150 
2 22 57 71 97 126 129 138 139 153 161 172 179 180 204 229 230 266 268 279 293 294 303 310 315 316 336 342 360 385 398 415 416 418 421 422 429 454 455 458 464 477 489 496 500 526 552 573 581 587 588 601 624 631 632 633 653 659 670 708 709 713 736 756 758 762 763 774 777 781 782 796 809 817 835 845 846 847 858 861 873 914 924 944 951 964 1000 1027 1080 1085 1139 1142 1151 
4 8 15 17 18 28 32 38 51 79 109 130 131 132 151 158 168 169 181 206 225 227 236 265 291 305 311 313 332 355 382 389 392 400 407 408 420 435 436 440 441 444 465 478 513 514 529 540 561 577 578 591 597 604 606 617 635 636 660 724 725 732 739 741 757 760 775 792 815 820 833 836 892 907 908 912 926 935 950 956 974 996 1016 1022 1037 1040 1063 1069 1108 1130 1147 
14 34 35 60 77 83 84 111 124 127 128 156 189 202 203 247 254 300 331 402 406 419 447 486 523 524 534 535 557 593 594 611 634 645 646 654 655 679 695 706 729 733 770 785 786 795 841 855 879 889 897 909 927 931 940 968 983 984 995 998 999 1009 1017 1018 1021 1023 1031 1044 1061 1066 1068 1077 1086 1090 1092 1093 1104 1114 1128 1146 1149 
42 69 90 106 121 136 137 165 171 184 185 186 245 250 255 256 292 301 306 307 308 314 317 338 339 350 375 390 428 431 459 460 475 479 482 501 515 522 555 575 579 614 619 647 674 675 749 772 790 813 821 844 848 862 886 887 891 896 919 920 921 923 977 982 991 1024 1026 1045 1048 1051 1103 1116 
9 16 41 61 76 82 85 94 95 96 100 107 117 118 120 154 162 177 178 197 211 214 262 282 285 320 328 344 369 379 391 417 437 448 485 493 494 550 553 613 620 662 666 667 687 689 696 697 703 726 738 748 768 769 794 837 838 860 872 878 994 1038 1046 1065 1096 1137 
12 24 25 56 101 105 114 269 270 272 345 372 378 409 410 425 433 442 452 461 462 476 481 490 504 527 538 546 558 626 627 651 671 672 673 699 717 718 730 731 743 744 747 750 771 778 788 824 827 874 876 882 883 895 925 941 945 958 988 989 1050 1089 1136 1148 
0 5 21 58 62 64 75 119 187 212 218 222 228 249 267 273 274 290 302 326 362 371 386 401 434 439 503 519 531 545 566 623 637 652 656 661 677 715 742 754 755 764 765 783 812 816 828 875 899 903 913 987 993 997 1025 1072 1075 1094 1115 1135 
19 80 135 140 142 148 167 198 207 237 295 296 324 340 341 356 358 484 491 569 648 649 684 700 705 707 723 727 734 834 842 863 928 942 946 948 963 965 976 981 1052 1095 
10 30 66 67 81 89 199 261 325 337 352 366 426 449 474 556 568 599 600 641 642 722 814 853 857 932 947 959 969 986 1006 1041 1059 1119 1123 1127 1138 
166 174 232 234 260 348 354 384 446 473 483 533 571 590 592 644 676 686 761 819 832 840 888 910 911 937 955 957 1003 1004 1008 1011 1082 1113 1120 1122 
43 65 103 104 116 191 200 244 246 251 264 286 287 351 357 502 559 565 567 574 586 630 720 721 728 735 779 784 823 830 854 894 962 1088 1112 
52 146 173 192 205 257 258 259 283 284 376 412 424 466 510 511 525 562 563 584 711 714 753 780 805 806 856 893 906 916 1014 1049 1106 
45 87 277 278 367 399 413 469 470 498 508 509 580 589 609 610 616 650 799 800 801 871 885 972 1020 1073 1079 1141 
26 37 123 253 304 349 364 472 499 520 622 680 698 745 797 859 902 904 905 918 933 952 978 990 1032 1043 
6 13 29 86 115 195 209 242 243 368 373 374 467 712 810 934 966 1001 1002 1029 1087 1118 1133 
110 133 134 226 363 395 427 430 450 544 598 602 603 746 791 793 938 975 1070 1081 1098 1102 1152 
36 163 164 220 238 239 271 370 393 394 451 453 463 505 517 518 582 607 640 683 826 877 
88 141 152 240 346 347 361 383 480 488 521 605 612 625 737 808 898 930 971 973 1144 
23 73 217 263 288 289 298 318 321 411 423 516 701 915 1033 1034 1054 1057 1076 1091 
1 11 68 70 74 194 201 210 233 275 387 506 530 547 685 825 880 985 
3 20 46 63 235 330 334 443 492 548 608 643 716 766 1042 1055 1056 
31 53 78 155 221 388 432 576 629 657 850 851 961 1064 1083 1099 1124 
27 157 193 241 248 252 299 468 532 663 702 751 1015 1111 1117 
33 39 44 50 208 231 297 335 353 456 776 787 1013 1030 
312 333 377 457 543 560 658 681 773 849 867 870 884 992 
40 102 147 188 196 512 628 852 901 1028 1047 1067 1100 
98 99 276 803 804 807 868 922 1007 1012 1060 1105 1129 
72 322 380 539 570 615 639 668 752 802 917 
49 59 359 397 551 564 789 943 953 1145 
497 665 682 831 929 970 
