8 9 24 25 30 31 37 44 45 51 60 63 66 67 69 75 83 102 109 114 129 130 131 133 152 158 169 201 202 203 206 233 234 245 250 265 266 279 304 310 314 315 321 329 332 333 335 340 342 355 363 383 393 395 400 408 411 416 427 429 430 435 439 440 444 452 462 467 477 478 481 491 508 521 529 533 548 549 551 558 564 565 566 573 577 578 582 591 593 599 601 615 631 635 640 642 654 660 678 679 683 684 692 701 706 719 732 733 739 747 759 768 769 778 785 786 792 796 802 827 830 831 832 836 845 861 866 877 885 903 909 937 947 957 966 996 998 1005 1033 1034 1054 1059 1060 1065 1068 1069 1072 1108 1127 1145 1146 1150 
0 1 10 11 18 19 23 28 32 33 38 39 42 43 46 52 58 59 61 62 68 70 73 74 76 77 78 79 80 95 96 107 108 117 118 132 148 157 162 168 174 175 176 178 179 181 186 187 193 194 197 210 211 212 218 222 225 226 246 247 248 249 251 252 264 275 276 282 286 287 297 298 313 318 334 341 353 375 382 386 387 392 417 420 423 434 448 453 456 485 486 496 499 506 512 513 520 532 538 539 540 550 572 592 622 661 663 676 688 698 754 757 775 783 812 825 828 847 869 894 904 905 917 929 935 958 967 974 976 982 985 990 994 1036 1096 1101 1137 
27 47 48 65 87 88 110 111 138 140 198 199 204 223 224 230 235 236 244 268 295 296 312 324 327 328 336 346 347 359 361 370 376 377 391 470 482 501 507 509 516 522 523 524 541 542 605 607 609 610 612 624 625 638 643 649 657 667 670 682 696 703 707 708 715 716 727 731 737 738 761 762 791 808 811 822 838 839 857 863 871 872 930 932 983 989 1006 1009 1015 1017 1019 1030 1046 1067 1075 1076 1083 1086 1104 1111 1115 1141 1144 
20 21 26 36 41 64 100 101 103 104 116 125 126 142 143 151 167 177 200 207 208 258 260 261 263 285 311 319 320 325 331 350 354 357 358 371 372 389 414 437 445 494 500 502 543 559 560 568 571 574 586 597 608 639 648 666 685 686 687 689 720 728 746 766 779 794 814 818 849 870 878 880 881 884 901 907 913 960 1008 1026 1032 1040 1056 1113 1120 1147 
16 81 82 97 146 147 172 173 191 192 205 219 257 259 267 283 284 330 424 466 493 525 530 562 563 569 583 584 585 620 629 630 651 662 711 714 718 726 736 752 753 780 837 856 906 916 927 941 956 972 975 1001 1014 1025 1028 1042 1049 1064 1100 1118 1126 1140 1148 
2 3 119 120 127 128 149 161 165 170 171 232 277 278 309 316 384 385 402 403 418 419 461 492 557 613 641 656 699 709 795 840 860 886 934 940 951 961 999 1018 1020 1041 1047 1092 1123 1135 1139 
71 72 84 105 106 153 231 269 270 291 292 293 305 338 339 348 390 394 428 431 432 449 459 475 504 505 579 587 588 606 671 674 675 749 790 820 833 844 882 920 991 995 1037 1051 1055 1085 
4 5 17 91 92 93 94 150 182 183 190 213 214 280 281 323 351 352 365 438 495 511 552 554 618 664 694 704 760 767 829 900 962 963 987 1010 1071 1084 1097 1143 
54 55 217 567 690 691 710 740 741 756 835 846 854 954 971 1007 1035 1039 1053 1058 1078 1080 1088 1090 1109 1110 1125 1131 1132 
112 113 121 122 144 145 159 160 215 216 381 396 397 404 405 471 487 528 536 537 595 596 614 621 936 939 943 953 
134 139 180 228 229 302 303 360 406 415 421 422 454 455 526 527 681 751 763 781 782 855 873 874 919 924 1091 
6 7 29 40 85 86 115 135 154 195 196 209 221 227 242 243 368 373 374 401 498 852 899 1023 
34 53 288 289 307 308 575 580 653 695 742 770 797 798 823 824 841 908 925 1031 1066 1077 1093 
136 137 184 240 241 306 317 436 468 514 515 561 702 848 853 868 891 892 1048 1117 1130 
124 503 611 619 626 646 658 659 784 788 889 890 992 1061 1102 1149 
49 50 253 254 388 446 447 469 553 594 680 789 834 914 1079 
262 299 322 366 367 380 412 413 570 697 721 725 867 1082 
450 616 668 793 809 897 898 1021 1022 1027 1074 1081 1151 1152 
12 378 409 410 497 546 547 672 673 876 945 1112 1136 
274 290 349 483 519 531 545 598 750 755 816 859 910 
163 164 220 238 239 271 463 632 633 815 826 
56 345 425 476 600 693 743 744 895 1050 
98 326 510 555 556 862 921 1012 1024 1119 
398 399 627 712 713 758 774 777 944 964 
35 156 581 590 730 776 799 800 819 
57 489 490 636 637 724 813 893 912 
272 273 602 603 652 1070 1094 1098 
123 472 745 933 968 978 988 
185 464 465 723 842 843 977 
337 426 544 801 955 993 997 
343 344 457 458 773 926 1133 
14 15 480 484 488 973 
166 677 729 1000 1038 1063 
237 356 700 705 928 965 
255 256 479 647 896 1103 
364 850 851 875 923 950 
534 535 735 858 931 984 
803 804 807 922 938 986 
89 90 650 1044 1073 
300 301 879 1114 1122 
604 748 942 1043 1142 
13 810 946 1087 
22 902 959 1013 
99 669 772 969 
188 189 433 1011 
407 576 617 1016 
441 442 771 883 
443 460 717 1116 
634 665 1124 1128 
821 1045 1062 1099 
887 888 1003 1004 
141 369 981 
155 589 722 
362 451 517 
379 787 970 
518 915 1057 
805 806 1106 
