8 9 25 30 31 37 44 45 51 56 57 60 63 66 67 68 69 75 76 83 98 99 102 109 114 129 130 131 133 134 139 152 153 158 169 201 203 206 232 233 234 241 245 250 265 266 279 302 304 310 314 315 321 322 329 332 333 335 340 342 355 363 378 383 393 395 400 408 409 410 411 415 416 421 422 427 429 430 435 439 440 444 452 462 467 477 478 481 489 490 491 497 508 516 521 529 533 546 547 548 549 551 558 564 565 566 573 577 578 582 591 593 599 601 607 615 624 631 635 636 637 640 642 654 660 669 672 673 674 678 679 684 692 701 706 710 719 724 732 733 739 747 751 759 768 769 772 778 782 785 786 792 802 813 827 830 831 832 836 845 855 861 866 876 877 885 893 903 909 912 919 920 933 937 945 957 966 968 969 978 996 998 1005 1033 1034 1039 1054 1059 1060 1065 1069 1072 1112 1127 1136 1145 1146 1150 
0 1 10 11 18 19 28 32 33 38 39 42 46 52 58 59 62 73 74 79 80 95 108 117 118 148 157 162 168 174 175 176 178 179 181 186 187 193 194 197 210 211 212 218 222 225 226 246 247 248 249 251 252 264 275 276 282 286 287 297 298 313 318 334 341 353 382 386 387 390 392 417 420 423 434 456 496 499 506 512 513 520 532 538 539 540 550 572 620 622 661 663 676 688 698 734 754 757 775 783 812 825 828 840 869 894 904 905 929 935 947 953 967 976 990 994 1029 1037 1101 
6 7 20 21 26 29 36 40 41 64 85 86 103 104 115 116 125 126 135 142 151 154 195 196 207 208 209 221 227 242 243 258 260 261 263 311 319 331 354 357 358 368 371 372 373 374 389 401 437 445 498 500 502 543 559 560 568 571 574 586 597 608 639 648 666 685 720 728 746 766 771 779 814 849 870 880 881 884 899 901 907 923 948 949 1002 1008 1023 1032 1040 1056 1113 1118 1120 1141 
13 47 48 65 87 88 110 111 138 140 198 199 204 223 224 230 235 236 244 268 327 328 336 343 344 346 347 359 361 369 370 391 457 469 470 482 501 507 509 522 523 524 541 542 605 609 610 625 638 643 649 657 667 670 696 703 707 708 715 716 727 731 737 738 761 762 791 808 810 811 838 839 857 863 871 872 932 981 989 1006 1030 1046 1075 1076 1086 1087 1104 1115 1133 1144 
16 24 81 82 97 146 147 172 173 191 192 205 219 257 259 267 283 284 330 424 466 493 525 530 562 563 569 583 584 585 629 630 646 651 662 711 714 718 726 736 752 753 780 837 856 906 916 927 941 956 972 975 1001 1014 1025 1028 1042 1049 1064 1066 1100 1102 1126 1140 1148 1149 
71 72 84 105 106 231 240 269 270 291 292 293 338 339 348 394 431 432 443 449 459 460 475 476 504 505 579 587 588 671 675 717 749 820 833 844 882 991 995 1051 1055 1085 1116 
4 5 17 91 92 93 94 150 182 183 190 213 214 280 281 323 351 352 365 438 495 511 552 554 618 664 694 704 760 767 829 900 943 962 963 987 1010 1071 1084 1097 1143 
34 35 53 156 255 256 288 289 307 308 479 575 580 581 590 626 647 655 683 695 730 742 770 776 797 798 799 800 819 823 824 841 889 896 908 925 985 1077 1089 1093 1103 
89 90 136 137 184 185 305 306 317 428 436 464 465 468 514 515 561 606 650 702 842 843 848 853 868 891 892 977 1044 1048 1073 1117 1130 
119 120 127 128 149 161 165 170 171 278 309 316 384 385 402 403 418 419 461 492 557 613 656 699 860 886 934 940 951 961 1047 1092 1135 
2 274 290 349 350 483 519 531 545 598 623 641 686 709 750 755 795 816 851 859 875 910 999 1026 1041 1123 1138 1139 1147 
112 113 121 122 144 145 159 160 215 216 381 396 397 404 405 471 487 528 536 537 595 596 614 621 936 939 
100 101 143 166 167 177 200 285 320 325 414 472 494 677 687 689 729 794 818 878 913 960 1000 1038 1063 
155 407 450 576 589 616 617 634 665 668 722 793 809 897 898 1016 1021 1022 1027 1074 1081 1124 1128 1151 1152 
23 43 61 70 77 78 96 132 375 448 453 485 486 773 917 958 974 982 1036 1096 1137 
180 228 229 303 360 406 454 455 526 527 681 745 748 763 781 790 796 873 924 1015 1068 
27 237 295 296 324 356 458 612 700 705 822 926 928 930 946 965 1067 1111 
272 273 326 510 555 556 603 652 821 862 921 1012 1024 1045 1094 1098 1119 
49 50 253 254 388 446 447 553 594 680 789 834 914 992 1079 
262 299 366 367 380 412 413 570 697 721 725 867 
124 503 611 619 644 645 658 659 784 788 852 
163 164 220 238 239 271 463 632 633 815 826 
398 399 627 712 713 758 774 777 944 964 
217 567 740 741 756 846 1007 1053 1080 
337 426 544 682 801 955 993 997 1083 
22 379 653 787 902 959 970 1013 
54 55 835 854 971 1088 1125 1131 
345 425 600 693 743 744 895 1050 
602 954 1035 1058 1061 1070 1078 1090 
441 604 942 1043 1052 1082 1142 
534 535 735 858 931 984 1108 
14 15 480 484 488 973 
362 451 517 518 915 1057 
473 474 887 888 1003 1004 
803 804 807 922 938 986 
300 301 879 1114 1122 
123 442 883 988 
188 189 433 1011 
983 1009 1017 1019 
312 376 377 
364 850 950 
690 691 1132 
723 874 1091 
805 806 1106 
