1 10 18 19 28 30 32 38 39 42 44 46 52 58 62 71 72 73 74 75 79 80 103 105 118 119 130 131 132 147 148 157 162 165 168 169 174 178 181 186 187 193 194 197 218 222 225 226 246 248 249 252 262 264 274 275 276 278 282 286 287 288 297 298 300 313 318 334 340 348 349 353 378 382 386 387 390 392 395 417 420 456 464 473 494 496 499 506 512 513 519 520 530 532 539 540 558 566 592 606 632 633 642 661 669 688 689 720 732 734 739 741 772 783 790 802 825 828 830 840 873 935 947 967 985 990 1012 1015 1059 1060 1067 1069 1100 1112 1114 1127 1138 1147 
7 14 26 29 34 40 47 48 60 82 85 101 102 107 108 111 116 135 140 155 166 167 185 195 198 199 207 221 223 235 236 241 242 243 290 295 319 323 324 325 328 331 341 363 364 373 374 401 498 514 518 535 572 593 598 618 638 649 666 694 696 700 716 738 742 794 798 811 839 842 863 901 913 919 923 948 949 960 1009 1019 1032 1037 1084 1097 1101 1122 1146 
11 16 68 76 95 100 114 117 154 183 201 210 211 212 233 244 250 251 268 280 368 409 430 485 502 503 507 538 546 547 550 562 620 621 641 651 673 703 726 778 785 786 800 837 838 843 857 872 876 994 996 1001 1011 1020 1041 1118 1123 1136 1137 1150 
50 260 265 316 432 465 515 523 524 541 552 599 615 631 676 695 795 809 814 834 852 860 879 889 897 898 917 952 995 999 1027 1028 1031 1047 1051 1056 1064 1086 1104 1151 
35 113 121 122 145 150 159 182 215 216 381 396 397 404 405 471 487 528 536 537 595 596 614 936 939 953 1143 
43 96 156 245 332 347 385 470 501 509 580 590 629 647 722 730 776 799 803 819 824 965 972 1045 1124 
2 22 23 37 49 144 253 285 320 321 354 451 472 483 736 770 789 902 945 968 1013 1077 1085 1139 
27 41 59 126 188 343 356 359 457 458 531 554 597 705 717 718 728 757 812 822 926 1111 
36 106 214 232 239 270 350 380 504 505 571 686 752 810 946 976 991 1026 1073 1094 1141 
9 86 123 124 272 273 326 327 391 482 484 522 639 648 652 816 931 1046 
33 115 120 161 170 171 219 384 418 419 542 557 570 613 713 934 940 951 
45 127 422 440 450 489 490 603 635 636 637 724 893 912 1098 1152 
54 93 690 691 710 740 954 1035 1039 1053 1058 1078 1109 1110 1131 1132 
56 90 137 184 240 317 425 468 561 848 853 891 892 977 1048 1117 
87 88 138 139 204 205 230 370 610 617 624 715 761 871 1006 
4 94 149 190 213 281 438 441 664 704 767 883 959 1071 
6 234 446 588 856 895 910 911 1004 1008 1021 1113 1120 
78 129 369 533 576 581 668 727 801 851 973 992 1128 
57 163 164 220 238 271 394 463 650 813 826 
81 142 261 267 296 412 474 568 569 937 986 
91 99 807 868 904 905 922 938 1007 1080 
209 398 399 619 712 758 774 777 944 964 
15 151 301 479 480 488 779 808 1103 
97 179 203 687 709 817 831 1023 1044 
98 555 556 821 862 921 943 1024 1119 
254 284 358 403 656 684 692 693 1005 
292 306 521 671 675 747 832 941 1148 
8 66 67 266 400 660 759 1121 
51 263 372 478 516 582 753 1076 
180 357 406 407 500 729 962 1038 
231 338 339 431 459 460 579 844 
362 415 434 517 663 796 877 969 
388 389 437 841 849 870 884 908 
55 311 433 481 654 854 1125 
64 158 333 755 791 875 983 
146 191 192 563 586 780 1014 
153 293 427 455 887 888 1003 
366 583 725 869 885 1126 1140 
416 449 711 909 998 1049 1142 
573 679 706 762 782 855 927 
25 189 612 627 925 981 
69 177 820 920 982 1022 
173 584 699 818 916 1042 
175 176 454 527 781 978 
227 256 279 551 880 1145 
336 578 903 993 1075 1115 
0 750 859 899 961 
53 289 309 766 1025 
125 543 544 746 997 
217 567 756 835 942 
237 402 658 659 784 
247 577 677 678 1063 
257 258 424 1040 1095 
269 305 445 743 861 
310 683 697 721 1000 
322 497 508 665 701 
337 682 707 708 731 
352 439 600 1072 1135 
646 1061 1070 1090 1149 
5 314 375 674 
17 371 760 987 
20 335 545 628 
65 315 565 1043 
83 84 475 918 
136 283 575 886 
202 466 467 890 
206 591 788 850 
228 622 874 882 
259 486 662 906 
302 608 672 955 
304 634 793 1081 
308 444 1065 1108 
329 423 751 915 
342 360 361 605 
351 365 585 900 
367 604 867 1082 
379 653 787 970 
413 426 932 1083 
421 626 836 974 
442 534 771 988 
491 702 723 797 
525 827 894 1089 
745 773 933 1074 
775 866 929 957 
3 443 1116 
12 13 928 
24 630 846 
31 77 1099 
61 966 1096 
89 625 989 
92 128 1036 
104 607 640 
110 134 804 
112 589 1016 
133 312 429 
141 815 845 
172 601 623 
196 344 383 
229 526 763 
299 792 971 
303 924 958 
330 829 1066 
355 428 448 
376 377 719 
393 670 956 
411 643 1055 
435 436 1130 
469 930 1079 
477 492 733 
495 510 511 
529 737 1144 
548 549 748 
559 823 975 
609 754 907 
805 806 1106 
833 858 984 
1033 1034 1054 
