5 47 48 100 108 112 113 122 125 143 144 145 159 202 215 216 273 277 302 309 319 323 325 326 369 376 381 396 401 404 414 439 471 487 495 503 507 528 536 537 541 542 572 595 596 618 637 649 652 656 669 673 687 688 694 737 742 798 811 818 822 839 843 852 875 881 890 913 936 939 940 947 949 953 960 967 987 1019 1020 1028 1039 1074 1084 1094 1097 1101 1131 1135 1136 1144 1150 
16 17 23 25 41 61 62 76 96 107 117 120 167 183 198 211 214 218 248 253 254 262 289 328 335 347 361 365 417 437 446 448 469 470 485 493 494 516 550 553 594 620 621 684 689 696 697 703 726 738 760 768 769 773 808 834 847 878 914 966 981 994 1038 1065 1071 1079 1096 1107 1134 1137 
2 6 7 15 24 29 37 86 104 115 116 141 151 158 196 209 227 242 243 285 320 357 360 373 374 398 399 472 476 498 500 502 506 560 571 574 587 597 630 639 658 659 685 712 720 725 728 736 743 744 758 774 777 779 815 845 867 895 934 944 962 964 1040 1043 1050 1085 1139 
10 22 32 57 130 131 132 163 164 168 169 181 220 225 238 239 271 276 305 313 411 420 440 445 464 489 513 532 540 558 576 577 598 617 632 633 635 636 642 692 724 732 741 757 813 816 820 826 833 836 899 961 963 974 1013 1016 1022 1037 1052 1063 1069 1147 
19 26 27 28 52 90 137 142 157 184 185 189 193 228 252 267 306 317 349 364 409 435 436 473 491 499 569 592 605 622 623 686 698 702 706 723 745 752 783 797 812 828 848 859 874 891 898 904 905 918 971 990 1011 1015 1032 1048 1057 1091 1111 1112 1130 1141 
0 14 73 80 82 109 121 135 148 197 207 217 226 249 258 288 295 296 298 304 315 318 321 324 356 362 390 392 434 460 482 483 519 531 613 661 663 677 705 734 754 756 805 806 835 879 923 928 942 948 965 1095 1106 1116 
34 35 127 128 156 203 224 388 402 406 441 442 447 452 486 523 524 534 535 557 645 655 729 770 771 785 786 841 883 889 897 984 988 995 999 1017 1018 1021 1023 1044 1066 1076 1077 1086 1089 1092 1093 1104 
11 18 33 39 44 50 58 79 139 146 147 172 173 192 205 208 257 259 297 353 403 423 456 520 525 549 584 585 662 776 780 787 885 893 900 906 916 1005 1014 1047 1067 1100 
20 60 65 81 85 140 154 182 187 199 212 222 235 236 251 290 314 344 351 352 474 545 563 565 566 573 586 599 600 641 653 722 857 907 959 969 986 1041 1087 1123 1133 1143 
42 68 69 105 106 186 231 270 291 292 338 339 350 431 432 459 475 504 521 543 579 588 671 674 675 681 695 714 747 749 844 882 886 919 920 982 985 991 1026 1051 
49 54 93 119 166 174 232 234 316 348 354 384 405 415 421 526 533 552 644 710 740 789 796 832 856 873 877 888 910 911 950 955 957 1003 1004 1008 1053 1078 1113 1120 
12 21 30 38 101 114 123 177 261 279 322 366 378 410 449 538 556 627 672 680 731 764 765 794 814 827 853 860 876 903 925 945 952 973 1031 1059 1119 1127 1138 
71 97 111 124 129 138 179 180 229 268 269 310 331 342 385 418 422 443 492 496 624 631 670 709 727 762 782 801 807 817 851 858 861 909 922 930 998 1000 1115 
1 70 88 95 118 136 162 178 194 201 210 233 247 250 263 275 280 282 299 340 341 387 546 547 562 568 651 750 792 825 837 842 869 880 976 977 1054 1073 
8 9 51 63 66 67 78 170 175 176 191 204 206 266 284 294 382 400 408 444 478 591 660 693 735 739 753 759 775 788 850 908 935 1108 1121 
171 241 245 255 265 301 307 308 465 468 479 501 514 515 555 561 619 647 679 751 821 855 862 887 892 896 912 921 927 1024 1045 1103 1117 
91 98 99 293 379 407 666 667 683 690 691 803 804 868 943 954 1007 1012 1035 1058 1060 1061 1080 1090 1105 1109 1110 1129 1132 
40 87 188 375 413 508 509 539 580 581 589 590 609 610 615 628 730 761 799 800 802 838 863 871 917 972 1006 
64 75 103 126 237 336 371 386 393 394 463 477 529 578 650 715 791 809 926 946 956 1025 1027 1072 1088 1151 
45 133 337 363 367 395 427 430 450 544 626 678 682 707 708 746 793 872 938 975 993 997 1075 1081 1152 
55 83 84 165 300 311 355 397 428 433 481 606 654 733 795 854 941 958 1114 1125 1148 
56 59 153 160 256 272 345 359 372 425 458 490 527 551 554 564 607 717 718 824 1145 
4 92 149 150 190 213 281 416 438 455 664 699 704 713 767 778 790 951 1036 1142 
94 303 391 454 548 601 604 668 676 701 748 763 781 924 996 1033 1034 1046 1068 1082 
72 152 161 219 223 383 419 522 570 611 612 614 646 700 755 933 983 1009 1149 
13 74 195 244 264 286 368 461 462 466 467 559 593 823 894 1001 1118 1146 
3 46 327 330 334 343 583 608 643 716 766 829 1042 1055 1056 1126 1140 
36 230 370 451 505 517 518 582 602 603 810 901 902 1070 1098 1102 
31 53 77 155 221 380 629 657 1049 1064 1083 1099 1124 
260 312 333 377 389 426 429 457 849 870 884 932 992 
329 484 488 648 719 772 866 915 931 1010 1062 
43 200 246 287 721 784 830 840 1122 
102 274 278 346 512 616 625 968 978 
89 283 412 424 510 511 575 989 
497 634 665 831 929 970 1128 
240 358 480 530 638 711 
332 567 819 846 937 1030 
110 134 453 640 
