7 47 48 54 55 91 92 93 108 113 122 125 144 145 149 150 159 160 182 183 190 213 215 216 224 281 309 319 323 381 396 401 404 405 414 438 460 471 482 487 495 507 528 536 537 541 542 572 585 595 596 618 621 664 669 688 690 691 694 704 710 740 742 767 798 811 822 829 839 843 875 890 900 913 923 936 939 949 954 967 1019 1035 1036 1039 1053 1058 1071 1074 1078 1084 1097 1101 1107 1109 1110 1116 1125 1131 1132 1134 1143 1150 
1 11 16 17 41 61 76 82 85 88 94 95 96 100 107 117 118 120 143 162 167 177 178 197 211 214 219 223 262 280 282 285 320 328 344 365 369 379 391 417 437 448 483 485 493 494 522 529 547 548 550 553 613 614 620 651 662 666 667 687 689 696 697 703 726 737 738 748 750 760 769 771 794 818 837 860 878 960 994 1042 1046 1065 1096 1137 1144 
9 10 18 22 30 32 38 51 66 67 79 89 105 130 168 169 181 210 236 248 266 291 297 299 305 313 325 337 346 347 353 361 366 400 426 440 449 451 478 501 504 513 514 520 532 540 556 617 622 625 642 660 679 724 732 741 753 792 808 814 820 836 853 902 947 1015 1016 1022 1038 1059 1119 1127 1138 
19 27 28 43 65 73 90 119 121 136 137 157 165 184 185 187 193 200 217 218 233 244 246 251 252 264 275 287 288 292 298 306 314 317 318 321 351 375 390 392 423 428 435 436 565 663 674 675 685 702 721 784 813 825 830 848 891 894 915 919 920 977 1037 1048 1051 1057 1111 1112 1130 
35 49 50 156 202 203 230 254 265 316 359 393 465 468 497 523 524 535 552 554 594 634 645 665 682 695 776 785 786 789 831 841 889 892 897 912 914 929 970 983 995 999 1009 1017 1018 1021 1023 1044 1066 1068 1086 1092 1093 1104 1117 1128 
14 23 81 166 174 189 198 199 232 234 352 354 406 407 446 474 533 534 568 590 599 600 641 644 686 706 722 729 761 770 819 832 855 857 863 910 911 927 937 955 957 959 968 969 986 1004 1008 1031 1041 1073 1077 1113 1120 1123 1141 
37 57 97 111 129 138 139 179 180 229 253 294 303 310 331 336 342 385 415 418 421 422 443 454 455 489 496 526 581 601 623 624 631 636 670 708 709 762 763 781 782 790 796 809 817 847 873 909 924 998 1000 
12 59 101 114 134 378 397 409 410 433 442 452 453 481 527 538 546 551 558 564 567 584 627 672 673 683 699 731 778 788 824 827 854 874 876 883 925 941 943 945 953 958 988 989 1089 1091 1136 1145 1148 
31 62 78 80 109 131 135 148 206 207 237 295 296 324 335 340 341 356 420 441 576 577 604 684 700 705 707 734 757 768 834 850 851 928 942 948 963 965 981 996 1052 1063 1069 1095 1099 1147 
2 4 5 21 33 39 44 172 208 225 231 273 302 360 429 439 456 503 587 637 652 659 736 756 764 765 787 835 840 845 846 903 987 993 997 1030 1075 1080 1085 1094 1115 1122 1135 1139 
8 15 20 140 151 154 158 191 227 235 279 311 332 355 382 444 561 563 573 578 586 591 597 606 635 650 701 727 735 739 775 815 908 926 935 956 974 1033 1034 1040 1054 1108 
36 163 164 220 238 239 260 271 326 370 394 408 463 473 505 517 518 582 592 607 640 676 810 826 877 888 946 1003 1011 1087 1133 
56 104 263 269 270 272 286 289 345 357 372 425 476 490 502 516 559 574 671 720 728 743 744 747 779 823 882 895 962 1050 1076 
63 171 204 241 245 255 256 301 307 308 464 479 500 555 575 619 632 633 647 656 730 751 821 862 887 896 921 1024 1045 1103 
6 29 40 86 115 188 195 196 209 242 243 368 373 374 466 467 508 509 580 589 628 712 799 934 972 1001 1002 1029 1118 
112 133 170 175 176 226 363 395 403 430 450 544 549 598 602 603 678 692 693 746 759 938 975 1005 1070 1098 1102 1121 1152 
0 52 58 75 212 222 228 249 258 267 290 362 386 434 566 661 677 711 754 783 805 806 812 828 907 1106 
146 173 192 205 257 259 283 284 376 412 424 510 511 525 562 780 856 893 906 916 1014 1049 
3 46 293 327 330 334 343 411 492 583 608 643 653 716 766 858 869 1055 1056 1126 1140 
26 123 304 349 364 472 499 680 698 745 797 859 905 918 933 952 978 990 1032 1043 
98 99 276 338 339 431 459 579 803 804 807 833 844 868 922 1007 1012 1060 1105 1129 
68 70 74 116 194 201 277 358 387 445 506 530 630 638 880 881 985 1020 
13 53 110 155 221 388 432 629 657 838 932 961 966 1006 1064 1083 1124 
45 87 278 367 399 413 469 470 498 609 610 616 800 801 871 885 1079 
103 312 333 377 389 457 543 560 658 681 773 849 867 870 884 992 1088 
34 60 77 127 128 402 419 447 486 557 611 646 940 1061 1090 1149 
142 329 348 384 484 491 569 648 719 723 772 866 931 984 1010 1062 
72 161 315 322 380 539 570 615 639 668 725 752 802 917 950 
42 69 106 186 350 475 571 714 749 886 982 991 1026 1082 
83 84 132 247 261 300 593 654 655 733 795 879 1114 1146 
126 398 416 458 477 588 713 758 774 777 944 951 964 1142 
141 152 153 240 383 480 488 521 605 612 898 930 971 973 
64 274 371 519 531 545 715 755 816 899 1013 1025 1072 
102 147 512 852 901 1028 1047 1067 1100 
24 25 461 462 626 717 718 872 
71 124 250 268 515 861 1027 1151 
427 649 791 793 842 904 976 1081 
