8 9 24 25 30 31 37 44 45 51 56 57 60 63 66 67 69 75 83 102 109 114 129 130 131 133 134 139 152 158 169 180 201 202 203 206 228 229 233 234 245 250 265 266 279 302 303 310 314 315 321 332 333 335 340 342 355 360 363 375 383 393 395 400 406 408 411 415 416 421 422 427 429 430 439 440 444 452 454 455 462 467 477 478 481 489 491 497 508 521 526 527 529 533 546 547 548 549 551 558 564 565 566 573 577 578 582 591 593 599 601 615 631 640 642 654 660 674 678 679 681 683 684 692 701 706 719 732 733 739 747 751 759 763 768 769 778 781 782 785 786 792 796 802 827 830 831 832 836 845 855 861 866 873 877 885 901 903 909 912 919 920 924 937 947 966 969 985 996 998 1005 1033 1034 1054 1059 1060 1065 1067 1068 1069 1072 1108 1112 1127 1128 1145 1146 1150 
0 1 10 11 18 19 23 28 32 33 38 39 42 43 46 52 58 59 61 62 68 70 73 74 76 77 78 79 80 95 96 107 108 117 118 148 157 162 168 174 175 176 178 179 181 186 187 193 194 197 210 211 212 218 222 225 226 246 247 248 249 251 252 264 275 276 282 286 287 297 298 313 318 334 353 382 386 387 392 417 420 423 434 448 453 456 485 486 496 499 506 512 513 520 530 532 538 539 540 550 572 592 622 661 663 676 688 698 754 757 775 783 812 825 828 847 894 904 905 917 929 935 957 958 967 974 976 982 990 994 1036 1096 1101 1137 
27 65 110 111 140 141 198 199 235 236 237 244 295 296 312 324 327 328 336 337 343 356 359 376 377 391 457 458 482 507 509 522 544 612 628 638 643 649 657 667 682 696 700 703 705 707 708 727 731 738 762 773 791 822 857 926 932 955 965 983 989 1009 1017 1019 1030 1046 1075 1076 1095 1111 1115 
21 41 64 103 104 116 126 142 151 208 258 260 261 263 311 357 358 371 372 389 437 500 502 543 559 560 571 574 586 597 608 639 648 685 720 728 746 766 779 849 881 884 907 1008 1040 1113 1120 
71 72 84 105 106 153 241 269 270 291 292 293 294 305 348 390 394 428 432 449 475 476 504 505 587 606 650 671 675 702 743 749 790 820 882 991 995 1037 1051 1073 1121 
34 35 53 255 256 288 289 301 307 308 479 575 580 611 646 647 655 695 730 742 800 817 823 824 841 896 908 918 925 968 1031 1061 1066 1077 1089 1093 1102 1103 1149 
36 100 101 125 143 166 167 177 200 285 319 320 325 331 354 414 445 494 568 620 623 666 677 686 687 689 729 748 794 814 818 878 880 913 960 1000 1038 1063 1138 
47 48 87 88 138 204 223 224 230 268 344 370 470 516 523 524 541 542 607 610 624 670 715 737 761 839 863 871 872 928 930 1006 1047 1086 1104 1133 1141 1144 
4 5 17 91 92 93 94 150 183 190 213 214 280 281 323 351 352 365 438 495 511 554 618 664 694 704 760 767 829 962 963 987 1010 1071 1084 
6 7 20 26 29 40 85 86 115 135 154 195 196 207 209 221 227 242 243 341 368 373 374 401 498 852 870 899 948 949 1023 1032 1056 
112 113 121 122 144 145 159 160 182 215 216 381 396 397 404 405 471 487 528 536 537 552 595 596 614 621 900 936 939 943 953 1097 1143 
119 120 127 128 149 161 165 170 171 277 278 309 316 384 385 402 403 418 419 461 492 557 613 656 860 886 934 940 951 961 1020 1092 1135 
97 147 172 205 257 259 283 284 424 525 583 584 585 629 630 662 714 736 752 753 780 837 869 906 941 1064 1100 1126 1140 1148 
2 232 274 290 349 350 483 519 531 545 598 641 709 750 755 816 840 859 910 999 1026 1041 1123 1139 1147 
89 90 136 137 184 185 240 306 317 464 465 468 514 515 842 843 848 853 868 891 892 977 1044 1048 1117 
155 450 616 617 634 665 668 722 793 809 897 898 1021 1022 1027 1074 1081 1124 1151 1152 
98 272 273 326 510 555 556 602 603 652 862 921 1012 1024 1094 1098 1119 
54 55 217 567 740 741 756 835 846 854 971 1007 1053 1080 1088 1125 
81 82 173 219 267 330 493 569 651 718 726 916 956 975 1025 1042 
231 338 339 431 443 459 460 579 588 717 833 844 1055 1085 1116 
16 146 191 192 466 562 563 711 856 927 972 1014 1028 1049 
49 50 253 254 388 446 447 553 594 680 789 834 914 1013 
262 299 322 366 367 380 412 413 570 697 721 725 867 1082 
690 691 710 954 1035 1039 1058 1070 1078 1090 1109 1110 1131 1132 
346 347 361 426 501 605 609 625 808 993 997 1083 
12 378 409 410 490 672 673 699 876 945 1136 
124 503 619 626 658 659 784 788 889 890 992 
163 164 220 238 239 271 463 632 633 815 826 
398 399 627 712 713 758 774 777 944 964 
435 436 561 635 636 637 724 813 893 1130 
123 304 472 745 797 798 933 978 988 
362 451 517 518 723 874 915 1057 1091 
534 535 735 770 795 858 879 931 984 
13 716 810 811 838 946 1015 1087 
22 379 653 787 902 959 970 
345 425 600 693 744 895 1050 
14 15 480 484 488 973 
156 581 590 776 799 819 
364 850 851 875 923 950 
473 474 887 888 1003 1004 
803 804 807 922 938 986 
441 604 942 1043 1142 
99 329 669 772 
132 300 1114 1122 
188 189 433 1011 
407 576 589 1016 
821 1045 1062 1099 
442 771 883 
469 801 1079 
805 806 1106 
