47 48 108 112 113 122 125 144 145 159 215 216 323 381 396 404 471 487 495 507 528 536 537 541 572 595 596 618 649 669 688 694 737 798 811 822 839 843 936 939 947 949 953 967 1019 1074 1084 1097 1101 1144 1150 
12 30 38 101 114 177 366 378 410 449 538 556 627 672 731 794 814 827 853 860 876 925 945 1031 1059 1119 1127 1138 
49 119 166 174 232 234 316 354 533 552 644 789 832 856 888 910 911 950 955 957 1003 1004 1008 1113 1120 
5 273 302 309 326 439 503 652 656 673 940 987 1039 1094 1131 1135 1136 
25 41 61 107 120 167 328 448 485 493 550 703 773 847 966 1096 1137 
35 388 406 523 524 535 645 729 889 897 995 999 1021 1066 1076 1086 1104 
129 138 180 229 331 385 418 492 496 624 670 727 801 807 851 922 930 
19 90 137 184 185 252 306 317 435 436 702 848 891 1048 1130 
104 357 476 502 571 574 685 720 728 743 744 779 895 962 1050 
33 39 44 58 208 297 353 403 423 456 520 549 787 1005 
62 253 254 335 446 469 553 594 684 834 878 914 981 1079 
139 172 173 257 259 525 584 585 662 780 885 900 906 916 
171 245 255 301 307 308 479 619 647 821 887 896 1045 1103 
69 291 292 521 674 675 747 882 886 919 920 982 1051 
71 124 268 269 310 342 422 443 762 782 858 861 1000 
100 143 319 325 369 401 414 687 742 818 875 913 960 
105 231 270 338 339 431 432 459 504 579 588 671 844 
4 92 149 150 190 213 281 438 664 704 767 1036 
98 690 691 943 954 1035 1058 1061 1090 1109 1110 1132 
131 132 225 313 420 540 576 598 757 1037 1069 1147 
0 249 258 298 362 434 661 663 677 754 805 
2 37 285 320 472 500 506 587 736 1085 1139 
6 7 29 86 115 196 242 243 373 374 498 
8 9 51 66 67 266 400 478 591 660 753 
80 207 295 296 324 356 705 928 942 948 965 
91 99 293 407 803 804 868 1007 1012 1060 1080 
163 164 220 238 239 271 276 464 632 633 826 
260 312 333 377 389 426 429 849 870 884 932 
14 109 135 148 460 482 734 923 1095 1116 
26 27 157 193 364 812 859 990 1032 1111 
36 230 370 451 505 517 518 582 810 901 
64 126 237 336 477 529 578 715 791 946 
191 382 408 444 735 739 775 908 935 1108 
209 398 399 712 758 774 777 934 944 964 
508 509 580 581 590 730 761 799 863 972 
16 17 96 417 437 697 760 994 1038 
73 217 288 304 318 321 756 835 879 
13 74 195 368 466 467 1001 1118 
32 130 168 181 440 513 741 833 
42 106 186 350 475 695 714 1026 
59 256 359 551 554 564 607 1145 
152 383 611 612 646 700 933 1149 
170 175 176 284 294 693 759 1121 
1 162 280 387 547 562 869 
11 18 79 147 1047 1067 1100 
15 151 158 227 597 725 1040 
53 155 221 380 657 1064 1083 
55 311 433 481 654 854 1125 
81 199 474 857 959 969 986 
133 363 395 430 544 746 938 
244 264 461 462 593 894 1146 
349 499 623 686 698 905 918 
441 442 534 771 883 984 988 
604 676 701 996 1033 1034 1082 
10 169 305 445 558 642 
28 142 189 569 706 1141 
31 77 629 1049 1099 1124 
52 228 267 622 783 904 
57 489 635 636 724 813 
70 194 201 247 568 880 
83 84 300 733 795 1114 
265 465 514 515 892 912 
303 548 748 781 924 1068 
375 539 589 615 802 917 
416 699 713 778 951 1142 
491 723 797 874 1057 1091 
602 603 902 1070 1098 1102 
34 128 447 557 770 
60 85 344 1087 1133 
65 351 563 565 586 
72 161 419 522 614 
75 386 809 1027 1151 
93 405 421 526 710 
97 179 631 709 817 
140 187 222 236 290 
251 641 653 1041 1123 
262 738 768 769 1065 
282 842 976 977 1073 
314 352 599 600 722 
327 343 583 1126 1140 
337 682 707 708 1075 
413 609 610 800 871 
458 527 717 718 824 
577 732 836 974 1063 
3 330 829 1042 
20 154 235 573 
43 200 246 721 
46 334 716 766 
54 740 1053 1078 
76 248 621 726 
78 206 788 850 
82 483 531 613 
88 118 651 750 
89 412 424 989 
94 391 668 1046 
95 299 792 1054 
111 909 998 1115 
117 214 365 1071 
136 210 250 546 
165 355 428 606 
197 226 315 519 
224 655 1077 1089 
278 346 616 625 
283 510 511 575 
358 530 638 711 
393 394 463 650 
397 941 958 1148 
409 605 898 971 
415 796 873 877 
450 678 975 1152 
470 494 689 696 
473 592 1011 1015 
484 488 648 931 
497 634 665 1128 
543 681 749 991 
555 862 921 1024 
608 643 1055 1056 
816 899 961 1013 
21 261 903 
23 289 516 
24 116 630 
40 188 628 
56 272 425 
87 838 1006 
102 968 978 
121 390 392 
123 680 952 
127 402 486 
141 815 845 
146 192 1014 
156 785 786 
160 345 490 
178 263 837 
182 907 1143 
183 218 620 
203 452 1044 
212 545 566 
219 223 570 
233 275 825 
241 751 855 
277 881 1020 
279 322 973 
286 559 823 
287 784 830 
329 772 915 
332 819 937 
347 361 808 
371 1025 1072 
411 963 1052 
427 793 1081 
454 601 763 
468 561 1117 
501 679 927 
542 852 1028 
560 658 867 
567 846 1030 
617 692 1016 
755 983 1009 
831 929 970 
841 1092 1093 
1017 1018 1023 
