0 10 13 30 32 38 52 57 61 69 94 95 105 131 132 133 168 169 181 205 225 231 239 269 270 276 279 292 299 303 305 306 313 314 322 338 339 366 391 395 420 431 432 449 454 459 464 476 488 489 501 504 513 521 540 543 549 556 558 564 576 577 579 588 598 601 604 632 633 636 642 668 669 671 674 675 676 677 679 681 701 724 732 743 744 747 748 749 757 763 772 781 792 814 820 836 844 853 882 886 893 895 912 919 920 924 927 947 966 973 974 982 991 996 1022 1033 1034 1037 1046 1050 1051 1054 1059 1063 1068 1069 1082 1096 1119 1127 1138 1147 
25 45 47 48 55 76 100 107 108 110 111 120 125 130 138 143 144 159 165 167 177 311 319 323 324 325 328 355 367 369 381 393 401 414 426 428 433 435 440 445 448 471 481 485 493 494 495 507 537 541 572 606 618 620 635 638 649 650 654 666 687 688 689 694 696 703 741 773 798 813 818 822 833 839 843 854 875 878 881 890 909 913 932 948 949 953 960 967 1019 1073 1074 1076 1084 1097 1101 1125 1130 1137 
3 14 87 88 113 117 121 122 135 145 148 204 214 215 216 230 241 245 262 265 315 316 327 340 341 343 365 370 390 392 396 403 404 423 460 465 468 469 470 475 482 487 514 515 522 528 536 552 555 561 583 595 596 614 619 656 714 734 738 751 761 768 769 801 821 838 855 862 863 871 887 892 896 921 923 936 940 1005 1006 1017 1018 1023 1024 1045 1065 1071 1095 1107 1116 1117 1126 1134 1140 
21 24 41 56 59 104 116 126 153 160 237 255 256 272 301 307 308 345 356 357 359 372 397 398 411 425 427 458 477 479 490 502 527 551 554 571 574 575 607 626 627 630 647 683 685 690 691 717 718 720 728 742 758 774 777 779 793 823 824 827 872 925 926 941 943 944 946 954 956 958 962 963 964 1035 1052 1058 1081 1089 1103 1109 1110 1132 1145 1148 
23 34 35 53 75 89 103 128 146 155 183 192 198 221 224 236 248 283 284 289 380 386 388 389 402 406 412 424 447 461 510 511 516 523 524 535 560 562 621 629 631 645 655 657 658 695 726 729 753 770 780 809 841 858 867 897 906 931 984 989 995 999 1014 1021 1027 1049 1064 1066 1077 1083 1086 1088 1092 1093 1104 1124 1151 
4 54 71 92 93 97 124 129 149 150 179 180 190 203 213 229 268 281 294 310 331 342 385 407 415 416 421 422 438 441 442 443 452 455 496 517 526 534 624 664 670 699 704 709 710 713 740 762 767 771 778 782 796 807 817 831 847 851 859 861 873 877 883 922 951 988 998 1000 1036 1044 1053 1078 1121 1142 
19 46 73 74 80 82 90 91 98 99 184 195 202 207 217 218 244 264 286 287 288 293 295 296 318 321 334 358 368 379 436 462 466 467 483 530 531 559 569 593 608 613 643 667 702 705 711 716 756 766 803 804 810 811 835 868 879 894 904 942 965 1001 1002 1007 1012 1029 1055 1056 1060 1080 1105 1118 1129 1146 
1 16 17 43 70 96 118 136 137 162 178 185 194 197 200 201 210 226 233 246 247 249 250 263 275 280 282 298 317 362 363 387 417 430 434 437 450 519 544 546 547 568 651 661 678 697 721 746 750 754 760 784 825 828 830 837 842 848 869 880 891 938 975 976 977 993 994 997 1038 1048 1112 1150 1152 
8 9 22 31 51 63 66 67 77 78 83 109 134 140 170 175 176 191 206 261 266 291 300 336 337 382 400 408 444 453 478 532 578 591 611 617 625 640 646 660 682 692 693 707 708 727 733 735 739 759 764 765 775 788 816 850 899 903 908 935 961 1013 1061 1075 1090 1099 1108 1114 1115 1149 
2 15 37 84 141 151 156 158 163 164 166 174 227 232 234 238 271 285 304 320 330 332 354 360 405 472 492 500 506 529 533 548 587 597 644 659 725 736 785 786 815 819 826 829 832 840 845 856 888 910 911 937 939 950 955 957 1003 1004 1008 1040 1085 1113 1120 1122 1139 
5 36 64 65 81 187 199 212 220 222 251 273 274 290 302 309 326 351 376 377 394 439 451 463 474 503 505 512 518 525 545 563 565 566 582 586 602 603 637 641 652 673 715 791 857 901 902 959 969 986 987 1039 1041 1070 1094 1098 1102 1123 1131 1135 1136 
6 7 20 29 49 60 72 85 86 115 119 127 152 154 161 171 182 196 209 219 223 235 242 243 257 258 344 373 374 383 418 419 498 542 550 557 573 612 639 653 700 712 737 755 789 805 806 907 930 933 934 983 1009 1043 1087 1106 1133 1143 1144 
11 18 40 79 102 112 139 147 172 173 188 259 277 278 346 347 352 361 371 399 413 486 508 509 580 581 584 585 589 590 599 600 609 610 616 628 662 722 730 790 799 800 808 852 885 900 916 968 972 978 1016 1020 1025 1028 1042 1047 1067 1072 1100 
26 27 28 42 106 142 157 186 189 193 228 252 260 267 312 333 349 350 364 409 410 429 457 473 499 570 592 605 622 623 663 686 698 706 745 752 783 812 849 870 874 884 898 905 918 971 990 992 1011 1015 1026 1032 1111 1141 
12 33 39 44 50 58 68 101 114 123 208 211 297 353 375 378 456 520 538 539 567 615 672 680 731 776 787 794 795 802 846 860 876 889 917 928 945 952 985 1030 1031 
62 240 253 254 329 335 348 384 446 480 484 491 553 594 648 684 719 723 797 834 866 914 915 981 1010 1057 1062 1079 1091 
497 634 665 929 970 1128 
