1 10 11 18 19 28 30 32 38 39 42 44 46 52 58 62 70 71 72 73 74 76 79 80 105 118 130 131 132 147 148 157 162 163 164 165 168 169 174 178 181 186 193 194 197 218 220 222 225 226 238 239 246 249 252 262 264 271 274 275 276 278 282 286 287 288 297 298 300 313 318 320 334 340 348 349 353 368 378 382 386 387 390 392 395 410 417 420 456 464 473 483 485 494 496 499 506 512 513 519 520 530 532 539 540 558 566 592 606 632 633 642 661 669 688 689 720 732 734 739 741 772 783 790 802 825 826 828 830 840 873 896 935 947 967 973 985 990 1012 1015 1037 1059 1060 1067 1069 1100 1105 1112 1114 1127 1129 1137 1138 1147 
7 14 26 29 34 40 47 48 61 81 82 85 100 101 102 107 108 111 117 135 140 154 166 167 187 195 198 199 207 211 221 223 235 236 241 242 243 244 261 290 295 302 303 319 323 324 325 328 331 341 363 364 373 374 401 491 493 498 518 569 572 577 593 598 608 609 618 649 666 672 677 678 694 696 702 703 716 723 737 738 742 754 794 797 798 800 810 811 839 913 919 923 932 948 949 955 958 960 966 972 986 1002 1009 1019 1029 1032 1057 1063 1068 1084 1091 1096 1097 1101 1122 1144 1146 
17 50 75 90 137 184 224 227 240 260 265 279 316 317 333 346 358 371 403 413 423 426 465 468 497 508 514 515 523 524 541 542 552 559 565 599 615 616 631 643 644 645 655 665 676 760 795 803 809 814 823 834 848 852 853 860 863 870 889 891 892 897 898 917 952 968 975 977 987 995 999 1013 1027 1028 1031 1047 1048 1051 1055 1056 1064 1077 1083 1086 1104 1117 1151 
9 68 86 95 114 123 183 201 210 212 233 247 248 250 251 254 272 273 280 299 322 326 327 391 409 430 482 484 507 522 538 546 547 562 568 571 610 620 621 639 641 648 650 651 652 653 706 726 785 786 792 816 837 838 843 857 872 931 971 996 1011 1020 1033 1034 1041 1046 1054 1073 1123 1141 1150 
2 36 37 49 97 106 119 144 179 203 214 228 232 253 266 284 285 315 350 354 380 451 504 505 525 548 603 622 656 684 686 687 693 695 709 736 743 744 752 789 817 827 831 874 882 894 901 902 904 945 976 1001 1005 1017 1018 1023 1026 1044 1050 1071 1085 1089 1094 1098 1107 1118 1134 1139 
6 24 35 55 92 112 113 121 122 128 145 150 159 160 182 215 216 234 263 345 381 388 389 396 397 404 405 437 446 471 487 528 536 537 567 587 588 589 594 595 596 614 841 846 849 856 869 884 895 907 908 910 911 936 939 953 1004 1008 1016 1021 1036 1088 1092 1093 1113 1120 1125 1143 
16 20 21 25 27 41 53 59 60 103 126 188 189 255 289 309 335 343 356 359 443 457 458 461 462 531 545 554 560 597 602 611 612 627 628 646 667 705 717 718 728 745 757 766 768 769 773 812 822 925 926 933 981 994 1025 1061 1070 1074 1090 1102 1111 1116 1149 
5 69 109 172 177 206 213 268 281 291 292 306 308 314 351 365 366 375 393 408 438 444 452 472 475 502 521 583 585 591 601 623 664 670 671 674 675 725 747 767 788 820 832 850 885 900 918 920 941 956 982 991 1108 1115 1126 1140 1148 
31 43 77 96 142 155 156 245 267 296 332 336 337 347 385 412 447 470 501 509 529 578 580 581 590 629 647 657 679 680 682 707 708 722 730 731 764 765 776 799 819 824 855 903 927 937 965 993 1022 1045 1075 1099 
22 23 87 88 138 139 173 204 205 230 256 294 301 367 370 411 486 516 549 551 584 604 607 617 624 662 692 699 701 715 748 761 770 818 833 847 858 867 871 880 906 916 963 1006 1042 1052 1076 1145 
54 93 98 202 217 330 352 439 454 467 495 510 511 555 556 573 600 690 691 710 740 756 762 781 782 821 829 835 862 890 921 942 943 954 1024 1035 1039 1053 1058 1066 1072 1078 1109 1110 1119 1131 1132 1135 
0 45 56 57 127 175 176 229 376 377 394 415 422 425 433 435 436 440 450 463 481 489 490 526 527 561 635 636 637 681 719 724 749 750 763 813 859 893 899 912 961 978 1130 1152 
4 33 94 115 120 149 161 170 171 190 219 321 329 384 418 419 441 442 455 474 534 557 570 613 704 713 751 755 771 879 883 887 888 915 934 940 951 959 983 984 988 1003 1065 1082 
91 99 153 180 200 293 310 357 372 379 406 407 427 500 683 697 698 721 729 787 868 905 909 924 938 962 970 1000 1007 1038 1080 
12 13 196 231 270 338 339 344 383 414 416 431 432 449 459 460 553 579 711 778 844 928 998 1049 1087 1133 1142 
78 129 141 369 469 533 576 668 727 775 801 807 815 845 851 866 922 929 930 957 992 1010 1062 1079 1128 
3 8 51 63 66 67 104 143 400 453 477 478 492 582 640 660 733 753 759 1121 
15 116 151 208 259 307 476 479 480 488 574 630 638 685 714 779 808 1103 
64 65 146 158 191 192 277 466 563 586 780 791 875 881 1014 1043 
83 84 110 125 133 134 311 312 429 543 544 746 804 997 
89 257 258 360 424 550 625 805 806 989 1040 1095 1106 
124 237 402 421 503 626 658 659 673 784 836 946 1136 
185 269 305 362 434 445 517 663 796 842 861 877 969 
209 398 399 619 712 758 774 777 878 914 944 964 
136 283 342 361 535 575 605 886 
355 428 448 654 735 854 974 
304 634 793 876 1081 1124 
152 564 700 950 1030 
