0 1 10 11 18 19 23 28 32 33 38 39 42 43 46 52 58 59 61 62 68 70 73 74 76 77 78 79 80 95 96 107 108 117 118 148 157 162 168 174 175 176 178 179 181 186 187 193 194 197 210 211 212 218 222 225 226 246 247 248 249 251 252 264 275 276 282 286 287 297 298 313 318 334 353 382 386 387 392 417 420 423 434 448 453 456 485 486 496 499 506 512 513 520 530 532 538 539 540 550 572 592 622 661 663 676 688 698 754 757 775 783 812 825 828 840 847 869 894 904 905 929 935 958 967 974 976 982 990 994 1036 1096 1101 1137 
8 9 24 25 30 31 44 45 51 60 63 66 67 69 75 83 84 109 130 131 133 152 158 169 206 234 245 265 266 315 329 332 333 340 342 355 363 393 395 400 408 411 429 430 439 440 444 462 477 478 491 516 529 549 564 565 566 577 578 582 591 593 615 631 640 642 654 660 669 678 679 684 692 719 732 733 734 735 739 759 772 792 802 830 836 845 861 866 885 903 947 957 966 985 996 1005 1052 1059 1060 1065 1067 1069 1072 1108 1127 1146 
47 48 65 87 88 102 110 111 138 140 141 198 199 204 223 224 230 235 236 244 268 327 328 336 369 370 391 470 482 507 509 522 523 524 541 542 607 609 610 624 638 643 649 657 667 670 696 703 715 716 737 738 761 762 791 810 811 838 839 857 863 871 872 901 930 932 983 1006 1009 1019 1030 1046 1076 1086 1104 1115 1144 
16 81 82 97 146 147 172 173 191 192 205 219 257 259 267 283 284 330 360 424 466 493 525 562 563 569 583 584 585 620 629 630 651 662 711 714 726 736 752 753 780 837 856 906 916 927 941 956 972 975 1014 1025 1042 1049 1064 1100 1126 1140 1148 
21 36 41 64 103 104 116 125 126 142 143 151 208 258 261 263 319 331 350 354 357 358 371 372 414 445 500 502 548 559 560 568 571 574 586 597 608 639 648 666 685 686 720 728 766 779 814 880 881 1026 1040 1147 
2 3 119 120 127 128 149 161 165 170 171 232 277 278 309 316 384 385 402 403 418 419 461 492 557 599 613 641 656 709 860 886 934 940 951 961 999 1020 1041 1047 1123 1135 1139 
37 129 134 139 180 228 229 302 303 310 383 406 415 416 421 422 427 454 455 467 526 527 533 573 601 681 683 706 727 751 763 781 782 796 855 873 877 909 924 969 998 1068 
4 5 17 91 92 93 94 150 183 190 213 214 280 281 323 351 352 365 438 495 511 552 554 618 664 694 704 760 767 829 962 963 987 1010 1071 1084 
6 7 20 26 29 40 85 86 115 135 154 195 196 207 209 221 227 242 243 341 368 373 374 401 498 852 899 923 948 949 1028 1032 1056 
89 90 136 137 184 185 240 241 305 306 317 428 464 465 468 514 515 606 650 702 842 843 848 853 891 892 977 1044 1048 1073 1117 1141 
112 113 121 122 144 145 159 160 182 215 216 381 396 397 404 405 471 487 528 536 537 595 596 614 621 900 936 939 943 953 1097 1143 
71 72 105 106 269 270 291 292 348 390 394 449 475 504 505 671 675 749 790 820 882 991 995 1037 1051 
27 188 237 295 296 324 343 356 359 457 458 612 628 700 705 718 822 926 928 946 965 1095 1111 
153 231 293 338 339 431 432 443 459 460 579 587 588 717 833 844 1055 1085 1116 
54 55 217 567 740 741 756 835 846 854 971 1007 1053 1080 1088 1125 
56 57 435 436 481 489 490 561 635 636 637 724 813 893 912 1130 
49 50 253 254 388 446 447 553 594 680 789 834 914 981 
203 279 321 322 452 497 508 551 701 785 786 827 831 1145 
132 255 256 300 301 307 308 479 647 896 1103 1114 1122 
274 290 349 483 519 531 545 598 750 755 816 859 875 
450 616 668 793 809 897 898 1021 1022 1027 1081 1151 1152 
53 288 289 695 742 823 824 841 908 925 1092 1093 
12 378 409 410 558 672 673 699 876 945 1136 
22 379 604 653 787 942 959 970 1013 1082 1142 
34 35 534 535 655 858 879 931 984 1066 1089 
155 156 580 581 590 722 730 776 799 800 819 
163 164 220 238 239 271 463 632 633 815 826 
262 299 366 367 380 412 413 570 725 867 1015 
123 304 472 745 797 798 933 937 978 1043 
260 311 389 437 543 746 849 870 884 907 
398 399 627 712 713 758 774 777 944 964 
114 201 233 250 546 547 778 1112 1150 
124 503 619 626 658 659 784 788 992 
166 200 677 697 721 729 1000 1038 1063 
345 425 476 600 693 743 744 895 1050 
346 347 361 426 501 605 625 808 1083 
99 803 804 807 868 922 938 986 
100 167 177 325 794 818 913 960 
101 285 320 494 687 689 748 878 
272 273 326 603 652 902 1094 1098 
710 954 1035 1058 1078 1109 1110 1131 
314 521 674 747 832 919 920 
337 682 707 708 731 989 1075 
14 15 480 484 488 973 
407 575 576 589 617 1016 
473 474 887 888 1003 1004 
98 510 556 1012 1119 
312 376 377 773 1074 
362 451 517 518 915 
441 442 771 883 988 
555 821 862 921 1024 
13 344 1087 1133 
364 850 851 950 
544 955 993 997 
602 1070 1090 1102 
611 646 1061 1149 
634 665 1124 1128 
690 691 1039 1132 
723 874 1057 1091 
189 433 1011 
335 768 769 
469 801 1079 
770 968 1077 
795 889 1031 
805 806 1106 
910 911 952 
1008 1113 1120 
1017 1018 1023 
1033 1034 1054 
1045 1062 1099 
