8 9 25 30 31 44 45 51 57 60 63 66 67 68 69 75 83 98 109 114 130 131 133 152 158 169 201 206 233 245 250 265 266 302 314 315 332 333 335 342 355 363 378 393 395 400 408 409 410 411 415 429 430 435 439 440 444 477 478 481 489 490 491 508 516 521 529 546 547 549 558 564 565 566 578 582 591 593 599 601 607 615 624 631 635 636 637 640 642 654 660 672 673 674 678 679 684 692 719 724 732 733 739 747 759 768 769 772 778 792 802 813 836 845 861 876 877 885 893 912 919 920 945 966 996 1005 1033 1034 1039 1054 1059 1060 1065 1069 1072 1112 1127 1136 1146 1150 
0 1 10 11 18 19 28 32 33 38 39 42 46 52 58 59 62 70 73 74 77 79 80 95 108 117 118 148 157 162 168 174 175 176 178 179 181 186 187 193 194 197 210 211 212 218 222 225 226 246 247 248 249 251 252 264 275 276 282 286 287 297 298 313 318 334 353 382 386 387 392 417 420 423 434 456 496 499 506 512 513 520 532 538 539 540 550 572 622 661 663 676 688 698 734 754 757 775 783 812 825 828 869 894 904 905 929 935 947 953 967 976 990 994 1029 1037 1052 1101 
6 7 20 21 26 29 40 41 64 85 86 103 104 115 116 126 135 142 151 154 195 196 207 208 209 221 227 242 243 258 260 263 311 357 358 368 371 372 373 374 389 437 472 498 500 502 543 559 560 571 574 597 608 639 648 685 720 728 746 766 779 849 852 870 881 884 899 907 948 949 1002 1008 1023 1032 1040 1056 1113 1118 1120 
16 24 81 82 97 146 147 172 173 191 192 205 219 257 259 267 283 284 330 424 466 493 525 530 562 563 569 583 584 585 620 629 630 646 651 662 711 714 718 726 736 752 753 780 837 856 906 916 927 941 956 972 975 1001 1014 1025 1028 1042 1049 1064 1066 1100 1102 1126 1140 1148 1149 
37 99 102 129 134 139 153 180 228 229 232 234 241 303 304 310 329 360 383 406 416 421 422 427 454 455 467 526 527 533 548 573 577 669 681 706 710 745 748 751 763 781 782 790 796 831 832 855 873 903 909 924 937 957 968 969 978 998 1068 
71 72 84 105 106 231 240 269 270 291 292 293 338 339 348 394 431 432 443 449 459 460 475 476 504 505 579 587 588 671 675 717 743 749 820 833 844 882 991 995 1051 1055 1085 1116 
27 110 111 140 198 235 236 244 327 343 344 359 376 390 391 457 458 482 507 509 522 628 638 643 649 667 716 727 738 811 822 863 926 932 1015 1030 1046 1067 1095 1111 1115 1133 
4 5 17 91 92 93 94 150 182 183 190 213 214 280 281 323 351 352 365 438 495 511 552 554 618 664 694 704 760 767 829 900 943 962 963 987 1010 1071 1084 1097 1143 
47 48 87 88 138 204 223 224 230 268 328 370 377 469 470 523 524 541 542 610 657 670 683 696 703 715 737 761 762 791 838 839 871 872 930 1006 1047 1076 1086 1104 1144 
36 100 101 125 143 166 167 177 200 261 285 319 320 325 331 354 414 445 494 568 586 666 677 687 689 729 771 794 814 818 878 880 901 913 960 1000 1038 1063 1141 
119 120 127 128 149 161 165 170 171 277 278 309 316 384 385 402 403 418 419 461 492 503 557 613 619 641 656 699 860 886 934 940 951 961 1020 1041 1092 1123 1135 
89 90 136 137 184 185 305 306 317 428 436 464 465 468 514 515 561 606 650 702 842 843 848 853 868 891 892 977 1044 1048 1073 1117 1130 
112 113 121 122 144 145 159 160 215 216 381 396 397 404 405 471 487 528 536 537 595 596 614 621 936 939 
2 274 290 349 350 401 483 519 531 545 598 645 709 750 755 795 816 859 875 910 923 999 1026 1139 1147 
155 407 450 576 589 616 617 634 665 668 722 793 809 897 898 1016 1021 1022 1027 1074 1081 1124 1128 1151 1152 
23 43 61 78 96 107 132 375 448 453 485 486 773 840 847 917 933 958 974 982 1036 1096 1137 
54 55 217 567 740 741 756 835 846 854 971 1007 1053 1080 1088 1125 1131 
203 279 321 322 340 341 452 462 497 551 701 785 786 827 830 866 1145 
34 288 289 308 575 580 626 655 695 742 770 823 925 1077 1089 
49 50 253 254 388 446 447 553 594 680 789 834 914 992 1079 
326 510 555 556 603 821 862 921 1012 1024 1045 1062 1098 1099 1119 
262 299 366 367 380 412 413 570 697 721 725 867 
163 164 220 238 239 271 463 632 633 815 826 
237 295 296 324 356 612 700 705 928 965 
256 300 301 479 647 879 896 1103 1114 1122 
398 399 627 712 713 758 774 777 944 964 
337 426 544 682 801 955 993 997 1083 
53 797 798 824 841 908 985 1093 
156 255 581 590 776 799 800 819 
602 954 1035 1058 1061 1070 1078 1090 
76 336 625 707 708 989 1075 
345 425 600 693 744 895 1050 
346 347 361 501 605 609 808 
534 535 735 858 931 984 1108 
14 15 480 484 488 973 
202 658 659 784 788 890 
362 451 517 518 915 1057 
379 653 787 889 970 1031 
441 604 942 1043 1082 1142 
473 474 887 888 1003 1004 
803 804 807 922 938 986 
56 272 273 652 1094 
13 810 946 1087 
22 902 959 1013 
188 189 433 1011 
364 850 851 950 
623 644 686 1138 
983 1009 1017 1019 
12 123 988 
35 307 730 
65 199 857 
690 691 1132 
723 874 1091 
805 806 1106 
