3 46 47 48 92 108 112 113 122 125 126 144 145 146 149 150 159 173 190 192 213 215 216 281 319 323 327 330 334 343 381 396 403 404 414 416 423 438 441 458 460 471 477 482 487 495 507 528 536 537 541 542 549 572 583 584 588 595 596 608 614 618 643 664 669 688 694 699 704 711 713 716 753 766 767 778 780 798 810 811 822 829 839 843 883 890 916 923 936 939 947 949 951 953 967 1005 1014 1019 1036 1049 1055 1056 1074 1084 1097 1101 1116 1126 1140 1142 1150 
8 9 21 22 23 51 63 66 67 75 76 83 84 103 138 139 170 171 175 176 198 204 224 229 245 255 261 263 266 289 300 301 302 307 308 311 325 332 336 346 347 361 386 400 453 470 478 479 501 516 532 555 577 578 591 619 640 647 654 655 660 679 732 733 739 759 764 765 795 808 809 821 862 879 887 896 903 921 935 1024 1027 1045 1063 1088 1103 1114 1121 1151 
0 10 11 19 32 38 39 52 58 73 79 121 131 163 164 168 169 181 197 217 220 222 225 226 228 238 239 247 248 249 252 257 258 267 271 276 288 297 298 305 313 318 321 353 362 382 390 392 415 417 420 434 445 464 513 519 520 540 558 576 598 622 632 633 661 663 677 702 741 754 757 783 796 805 806 812 826 828 873 874 877 1037 1069 1106 1112 1147 
2 24 36 37 54 55 93 166 174 230 232 234 253 315 316 354 360 370 393 394 405 408 421 446 451 463 505 518 526 533 548 552 567 582 587 602 603 604 644 659 676 701 710 736 740 756 832 835 840 846 856 878 902 910 911 914 955 957 996 1004 1008 1030 1033 1034 1053 1077 1078 1080 1082 1085 1098 1102 1113 1120 1122 1125 1139 
1 33 43 44 50 68 70 74 88 95 117 118 132 157 162 178 194 200 201 208 210 211 214 231 233 244 246 264 275 280 282 287 299 365 387 456 461 462 506 529 547 562 568 593 651 721 737 750 776 784 787 792 825 830 837 842 869 880 894 966 976 1015 1054 1071 1107 1134 1144 1146 
16 17 18 25 41 60 61 85 94 96 101 107 120 130 143 167 177 196 219 223 285 303 320 328 344 377 391 437 448 485 493 494 521 550 553 570 620 649 662 668 687 689 696 697 703 748 755 760 773 781 794 818 820 833 860 960 983 994 1009 1022 1038 1046 1087 1096 1133 1137 
20 26 27 28 72 102 111 140 147 154 161 189 193 235 274 304 349 364 472 499 512 522 534 539 573 597 615 623 639 686 698 706 727 745 752 797 802 852 855 859 901 905 909 918 927 932 968 984 990 998 1028 1032 1040 1043 1047 1067 1073 1100 1111 1115 1141 
35 91 98 99 293 379 388 406 442 523 524 535 594 645 666 667 683 690 691 729 771 803 804 868 889 897 924 943 954 995 999 1007 1012 1021 1035 1058 1060 1061 1066 1070 1076 1086 1090 1104 1105 1109 1110 1129 1132 
15 64 65 81 104 116 151 158 199 227 277 351 357 371 474 476 502 560 563 565 571 574 586 630 658 685 715 720 725 728 779 791 819 857 867 881 937 950 959 962 969 986 1020 1025 1072 
30 105 191 241 265 270 291 338 339 366 411 431 432 440 449 459 465 468 504 514 556 561 579 642 671 735 751 814 844 853 854 892 963 991 1052 1059 1068 1108 1117 1119 1127 1138 
14 42 80 82 106 135 148 186 207 295 296 324 340 341 350 356 475 483 531 613 695 705 714 734 904 928 942 948 965 1026 1042 1095 
69 90 136 137 165 184 185 292 306 314 317 428 436 543 606 674 675 681 747 749 813 848 882 886 891 919 920 977 982 1048 1051 
141 152 240 279 322 355 358 383 409 473 480 530 592 605 611 612 638 646 700 815 836 845 888 898 933 971 973 974 1003 1011 1149 
4 5 187 212 251 273 290 309 326 376 439 503 525 545 566 637 641 652 653 656 673 719 987 1039 1041 1094 1123 1131 1135 1136 
6 7 13 29 86 115 195 209 242 243 368 373 374 398 399 466 467 498 712 758 774 777 934 944 964 1001 1002 1029 1118 
56 153 160 182 272 284 345 372 425 490 527 627 693 717 718 743 744 824 827 895 907 925 985 1050 1089 1143 
71 100 109 124 180 250 268 269 294 310 342 369 385 407 422 443 492 515 546 624 762 782 847 858 861 1000 
97 129 179 331 352 454 455 496 599 600 601 631 670 709 722 763 790 801 807 817 851 922 930 1017 1018 1023 
31 53 155 156 221 262 380 629 657 738 768 769 785 786 841 1064 1065 1083 1092 1093 1099 1124 
45 110 133 134 363 367 395 430 450 544 617 678 692 746 816 899 938 961 975 1013 1016 1152 
12 114 123 237 378 410 427 500 538 626 672 680 731 793 872 876 945 946 952 1031 1081 
87 172 278 337 413 426 609 610 616 625 682 707 708 800 838 871 885 993 997 1006 1075 
57 205 259 397 433 435 481 489 635 636 724 788 893 912 941 958 988 1130 1148 
62 142 183 254 286 335 469 559 569 585 621 684 726 823 834 900 981 1079 
40 188 508 509 580 581 589 590 628 730 761 799 863 972 978 
202 203 452 497 634 665 831 866 929 970 1010 1044 1062 1128 
329 348 384 484 488 491 517 648 723 772 915 931 1057 1091 
34 77 127 128 236 402 418 419 447 486 557 770 940 
49 59 119 218 256 359 551 554 564 607 789 1145 
89 283 412 424 510 511 575 650 906 989 
260 312 333 389 429 457 849 870 884 992 
78 206 444 775 850 908 926 956 
401 742 875 913 
