7 47 48 91 108 125 159 190 224 323 381 414 438 471 495 507 537 541 542 572 618 669 688 694 767 798 811 822 839 843 890 947 949 953 967 1019 1074 1084 1097 1101 1150 
166 174 234 446 533 590 644 761 819 832 856 895 910 911 937 955 957 1004 1008 1082 1113 1120 
26 27 28 157 193 252 297 364 458 520 622 663 717 718 859 904 905 990 1032 1111 
113 122 144 145 150 160 182 215 216 396 404 487 528 536 595 596 621 936 939 1143 
30 105 270 291 338 366 449 504 556 579 671 814 853 991 1059 1119 1127 1138 
35 254 523 524 535 594 645 863 897 995 999 1021 1066 1076 1086 1104 
41 85 107 120 219 223 320 328 344 485 493 550 620 666 771 1137 
180 310 342 385 418 422 443 454 601 762 781 782 858 1000 
8 10 18 51 169 305 311 332 445 591 642 739 935 
68 70 95 118 178 194 201 263 568 837 880 881 985 
83 84 132 300 593 654 655 733 795 879 889 1114 1146 
90 137 184 185 306 317 435 436 848 891 977 1048 1130 
5 273 302 439 503 637 652 987 1039 1094 1131 1135 
12 114 349 409 410 425 499 538 672 698 918 945 
33 39 44 208 211 231 233 275 353 456 787 825 
57 398 455 489 713 758 774 777 790 944 951 964 
104 286 357 502 559 571 574 720 728 779 823 962 
143 167 177 469 470 494 553 696 794 818 860 960 
54 55 567 740 756 835 846 1030 1053 1080 1125 
163 164 220 238 239 271 464 500 632 633 826 
4 92 149 213 281 664 704 959 1036 1071 
67 109 129 331 492 496 624 670 807 922 
146 192 284 466 584 714 753 780 1014 1049 
241 265 465 468 514 751 855 892 912 1117 
397 690 691 943 954 1035 1058 1109 1110 1132 
16 17 96 417 437 697 760 994 1038 
32 38 130 168 181 440 513 741 833 
36 232 326 408 505 582 603 902 1098 
93 303 405 415 421 526 710 763 924 
131 313 420 540 598 757 1037 1069 1147 
255 256 301 307 308 479 575 647 1103 
2 172 451 587 736 845 1085 1139 
6 29 86 115 242 243 373 374 
11 79 147 852 1028 1047 1067 1100 
19 244 264 461 462 702 894 1112 
45 277 278 367 498 616 885 1020 
53 155 221 380 657 961 1064 1083 
64 82 173 483 519 531 916 1025 
99 293 803 804 868 1007 1012 1060 
123 441 442 680 883 933 952 988 
207 295 296 356 705 707 928 948 
292 314 375 674 675 919 920 1051 
508 509 580 581 589 730 799 972 
1 247 280 387 547 562 869 
21 261 447 903 993 997 1075 
62 142 335 569 684 834 981 
65 162 251 351 423 563 586 
72 127 161 402 419 486 940 
73 74 217 288 318 321 613 
133 363 395 430 544 746 938 
135 148 186 187 340 341 1095 
171 245 619 821 887 896 1045 
206 604 676 701 996 1033 1034 
260 473 565 592 888 1003 1011 
329 484 534 648 772 931 984 
539 570 615 668 752 802 917 
9 66 400 478 529 660 
20 140 154 235 573 727 
22 497 634 665 970 1128 
42 106 350 475 695 1026 
60 333 377 457 773 870 
81 199 474 857 969 986 
97 179 266 631 709 817 
101 649 791 793 876 1081 
126 237 336 477 708 946 
170 175 176 693 759 1121 
189 706 1031 1073 1077 1141 
226 450 678 692 975 1152 
228 267 434 783 812 828 
240 279 322 480 488 973 
249 258 362 754 805 907 
348 384 491 723 1057 1091 
399 413 609 610 800 871 
416 588 778 998 1068 1142 
433 481 788 941 958 1148 
472 506 639 745 978 1043 
13 810 966 1087 1133 
31 78 576 850 1099 
34 128 557 770 968 
69 543 681 749 982 
88 651 737 750 1144 
94 379 391 667 1046 
141 152 383 612 700 
195 368 467 884 1118 
262 738 768 769 1065 
285 687 703 748 878 
327 343 583 1126 1140 
339 431 432 459 844 
346 347 361 625 808 
352 599 600 722 724 
355 561 635 815 974 
370 407 617 715 1016 
388 389 629 841 1124 
427 626 872 930 1079 
476 685 743 744 1050 
558 564 673 874 1136 
0 222 290 677 
15 151 158 227 
40 188 196 628 
46 334 716 766 
49 359 554 789 
56 636 827 1089 
58 75 386 809 
59 551 607 1145 
61 662 689 1096 
76 325 426 801 
77 611 646 1149 
87 838 932 1006 
102 274 512 901 
112 403 549 1005 
121 248 390 392 
124 268 1027 1151 
183 585 829 900 
191 735 854 1108 
210 225 276 566 
230 316 552 914 
246 287 784 830 
283 510 511 906 
382 444 606 775 
401 742 875 913 
411 734 963 1052 
460 482 923 1116 
521 605 898 971 
555 862 921 1024 
560 658 867 992 
577 732 836 1063 
608 643 1055 1056 
641 653 1041 1123 
792 820 1022 1054 
3 330 1042 
14 406 729 
23 198 337 
24 116 630 
43 200 721 
71 269 861 
89 650 989 
117 214 365 
136 165 886 
138 139 229 
153 372 490 
156 785 786 
197 236 726 
202 203 1044 
209 712 934 
212 545 661 
250 515 546 
282 842 976 
299 532 1015 
312 849 908 
358 530 638 
376 525 1001 
378 699 731 
393 394 463 
452 719 866 
501 679 927 
517 518 877 
578 597 1040 
602 1070 1102 
623 686 1115 
627 683 925 
682 831 929 
725 851 950 
755 983 1009 
816 899 1013 
1017 1018 1023 
1061 1078 1090 
