7 47 48 108 125 144 159 190 224 319 323 381 414 438 471 495 507 537 541 542 572 618 669 688 694 767 798 811 822 839 843 890 947 949 953 967 1019 1074 1084 1097 1101 1150 
25 41 61 78 107 120 167 285 320 328 377 448 485 493 550 620 662 687 689 703 748 773 878 1096 1137 
10 18 32 38 79 130 168 169 181 210 305 440 445 513 631 732 741 820 833 836 1022 
11 28 39 58 131 248 297 313 420 456 520 540 576 598 757 1037 1069 1147 
16 20 27 60 85 96 154 219 223 235 344 417 437 573 697 994 1111 
166 174 234 446 533 644 832 856 910 911 955 957 1004 1008 1082 1113 1120 
19 73 121 217 222 288 318 321 353 390 392 532 622 663 842 976 
5 273 302 309 326 439 503 637 652 656 987 1039 1094 1131 1135 
30 105 366 449 556 642 671 814 853 1038 1059 1119 1127 1138 
35 523 524 535 594 645 897 995 999 1021 1066 1076 1086 1104 
303 397 418 433 454 481 601 763 781 788 924 941 958 1148 
15 51 151 158 227 332 529 578 591 597 739 935 1040 
94 143 177 391 494 521 553 696 794 818 860 960 1046 
12 101 114 378 410 425 538 672 699 731 876 945 
26 304 349 364 499 698 797 859 905 918 990 1032 
80 206 207 296 324 356 531 705 707 708 904 928 
89 90 137 184 185 306 317 436 848 891 977 1048 
91 98 99 293 379 429 803 804 868 1007 1012 1060 
113 122 145 216 396 404 487 528 536 595 596 936 
163 164 220 238 239 271 276 464 632 633 826 
171 245 469 470 619 801 821 887 896 1045 1079 
2 37 253 354 548 587 736 845 1085 1139 
4 92 149 150 213 215 281 664 704 1036 
6 29 86 115 196 242 243 373 374 498 
70 95 118 178 194 201 263 568 837 880 
75 76 198 325 336 337 386 426 625 809 
146 192 466 562 563 711 753 780 1014 1049 
209 398 399 712 758 774 777 934 944 964 
241 265 465 468 514 751 855 892 912 1117 
270 338 339 431 432 459 504 579 844 991 
346 347 361 413 609 610 616 800 808 871 
0 249 258 298 362 661 677 754 805 
83 84 132 300 733 795 879 889 1114 
104 357 502 571 574 720 728 779 962 
260 312 333 389 457 849 870 884 992 
371 472 500 506 639 745 978 1043 1072 
36 232 408 451 505 518 582 810 
123 441 442 680 883 933 952 988 
133 363 395 430 544 746 938 997 
135 148 186 187 340 341 948 1095 
255 301 307 308 479 575 647 1103 
292 314 375 674 675 919 920 1051 
567 740 756 835 846 1030 1053 1080 
57 455 489 636 713 790 951 
62 142 335 569 684 834 981 
81 199 474 857 959 969 986 
129 331 496 670 807 851 922 
182 233 275 825 907 939 1143 
189 534 706 1031 1073 1077 1141 
310 627 683 827 925 1000 1089 
509 580 581 589 730 799 972 
604 676 701 996 1033 1034 1142 
691 943 954 1035 1058 1109 1110 
1 162 280 387 547 869 
17 539 615 760 802 917 
21 261 447 903 993 1075 
31 77 611 646 1099 1149 
34 128 557 770 968 984 
49 119 218 359 554 789 
52 228 267 434 783 812 
88 651 715 737 750 1144 
124 250 268 546 1027 1151 
141 152 383 612 700 930 
147 852 1028 1047 1067 1100 
173 376 525 584 916 1001 
193 244 264 461 462 894 
240 279 322 480 488 973 
342 422 443 762 782 858 
473 592 888 1003 1011 1015 
558 564 673 874 1091 1136 
3 278 330 829 1042 
9 66 400 478 660 
42 106 350 695 1026 
53 155 221 380 1064 
56 160 272 345 561 
59 256 551 607 1145 
65 251 351 565 586 
69 543 681 749 982 
74 195 368 467 1118 
97 179 266 709 817 
112 403 423 549 1005 
127 402 419 486 940 
138 139 229 370 526 
157 299 724 792 1054 
165 428 606 650 813 
170 175 176 759 1121 
230 315 316 552 914 
237 427 626 872 946 
247 593 654 655 1146 
262 738 768 769 1065 
327 343 583 1126 1140 
382 444 775 850 908 
388 629 657 1083 1124 
415 517 796 873 877 
450 678 692 975 1152 
33 44 211 787 
40 188 508 628 
43 200 246 721 
46 334 716 766 
54 55 1078 1125 
67 109 492 624 
82 295 483 613 
87 838 932 1006 
93 405 421 710 
102 274 512 901 
191 735 854 1108 
205 257 259 893 
283 412 510 511 
291 407 617 1016 
329 772 915 1057 
352 599 600 722 
355 635 815 974 
401 742 875 913 
409 605 898 971 
411 734 963 1052 
416 588 778 1068 
460 482 923 1116 
497 634 665 1128 
527 717 718 824 
555 862 921 1024 
608 643 1055 1056 
641 653 1041 1123 
743 744 895 1050 
816 899 961 1013 
14 406 729 
22 140 727 
23 289 516 
24 116 630 
64 791 1025 
71 269 861 
111 909 998 
117 214 365 
126 458 477 
153 372 490 
156 785 786 
183 254 1071 
197 226 519 
202 203 1044 
212 290 545 
225 282 566 
277 881 1020 
286 559 823 
287 784 830 
358 530 638 
393 394 463 
424 906 989 
452 719 866 
484 648 931 
501 679 927 
515 522 614 
560 658 867 
570 668 752 
585 621 900 
590 761 863 
602 1070 1102 
603 902 1098 
623 686 1115 
649 793 1081 
666 667 771 
755 983 1009 
841 1092 1093 
1017 1018 1023 
