2 4 17 22 23 24 33 36 37 49 54 55 87 89 94 97 98 106 144 149 161 179 202 203 209 214 227 230 232 239 253 256 260 266 279 315 321 322 337 346 350 354 371 375 380 384 398 399 408 411 413 426 429 432 441 442 451 470 472 474 483 497 504 505 508 523 524 548 551 559 565 570 571 610 615 619 625 630 631 643 644 665 668 676 680 682 683 686 687 695 701 709 712 736 740 752 756 758 760 774 777 789 797 803 810 814 817 823 831 835 846 852 871 878 880 883 889 897 898 902 904 914 917 943 944 945 946 952 954 963 964 975 976 987 989 991 992 995 999 1023 1026 1028 1035 1044 1047 1051 1052 1053 1055 1056 1058 1064 1080 1083 1085 1086 1094 1104 1125 1139 1141 1145 1147 
1 10 18 19 28 30 32 38 39 42 44 46 58 59 62 65 70 71 72 73 74 75 76 79 80 105 118 119 130 131 147 148 157 162 165 168 169 174 178 181 187 193 194 197 210 218 222 225 226 246 248 249 252 262 264 275 276 278 282 286 288 291 292 297 298 299 300 301 313 318 334 340 348 349 353 378 382 386 387 390 392 395 417 420 423 456 494 496 498 499 503 506 512 513 514 520 532 539 540 566 591 622 641 642 645 661 688 720 732 734 735 739 741 751 783 790 802 825 828 830 840 854 873 896 915 935 967 990 1012 1015 1020 1041 1043 1059 1060 1069 1100 1105 1108 1114 1123 1127 1129 1138 
26 29 40 43 67 81 96 102 107 109 111 120 124 132 135 140 142 154 155 156 166 167 171 198 199 206 207 221 235 236 237 242 243 244 245 261 267 269 284 287 294 295 296 302 303 304 305 324 325 328 331 356 363 364 367 385 402 403 412 428 445 481 491 509 549 568 569 577 580 604 608 624 629 647 649 656 657 658 659 663 672 677 678 684 692 693 700 702 707 716 722 723 730 738 776 784 791 793 794 799 800 819 824 842 847 861 863 867 876 901 909 919 928 932 937 948 955 958 960 965 966 972 983 985 986 988 998 1005 1017 1022 1032 1045 1063 1065 1081 1112 1124 
12 13 35 47 48 91 92 108 112 113 122 128 145 150 159 160 182 183 190 195 213 215 216 223 224 254 281 323 329 341 345 351 365 374 381 396 404 405 425 438 460 471 487 528 536 537 542 572 585 589 595 596 618 621 664 669 694 743 744 767 772 798 811 822 829 839 890 900 936 939 947 949 953 1002 1009 1019 1029 1036 1037 1050 1071 1084 1087 1097 1101 1107 1122 1133 1134 1143 1150 
7 9 11 16 61 68 85 86 95 101 114 115 117 123 170 201 211 212 219 233 250 251 272 273 280 285 320 326 327 368 379 391 409 410 430 448 476 482 484 485 493 507 515 522 529 530 538 546 547 550 562 613 614 620 639 648 651 652 662 685 689 696 703 713 726 737 748 778 785 786 787 816 837 838 843 857 869 872 931 934 951 994 996 1011 1046 1096 1118 1137 1144 
45 50 56 57 77 90 93 127 137 163 164 172 184 185 220 238 265 271 306 316 317 336 393 394 418 419 422 435 436 440 450 452 453 463 465 468 486 489 490 541 552 561 584 598 601 603 616 623 634 635 636 637 650 670 671 699 708 710 731 749 809 813 818 826 834 848 853 891 892 893 906 912 940 956 977 1013 1048 1073 1098 1109 1110 1115 1117 1130 1152 
3 20 21 25 27 41 53 63 126 143 188 189 196 204 205 289 308 309 319 335 343 355 359 373 383 421 433 443 444 447 457 458 461 462 545 554 578 597 606 611 612 626 627 628 666 667 705 717 718 757 764 765 766 768 769 771 815 836 845 903 925 926 961 974 981 993 997 1018 1025 1067 1075 1092 1111 1116 
14 34 83 84 175 176 180 200 229 247 293 310 357 401 406 407 414 415 416 427 449 454 455 464 467 500 526 527 534 553 557 573 588 593 632 633 653 654 655 679 681 697 698 706 721 729 742 762 763 770 781 782 795 796 855 879 887 913 923 924 927 962 968 970 978 984 1000 1031 1038 1077 1142 1146 
5 31 69 78 100 129 141 152 153 177 186 240 268 314 366 369 397 469 473 475 502 521 533 576 581 583 592 599 674 675 724 725 727 747 775 788 801 820 832 850 851 860 866 885 888 918 920 929 930 941 950 957 973 982 1003 1010 1016 1027 1062 1079 1099 1126 1128 1140 1148 1151 
0 8 52 64 82 88 103 110 125 133 134 146 158 173 191 192 228 274 290 311 312 332 333 347 376 377 434 466 501 519 525 531 543 544 558 563 564 586 673 711 719 746 750 755 780 804 827 859 870 874 875 882 894 899 916 1001 1014 1030 1049 1057 1089 1091 1136 
6 15 116 121 138 139 151 208 231 234 255 263 277 307 344 358 370 388 389 437 446 479 480 488 560 587 590 594 609 617 638 715 728 754 761 779 792 808 841 849 856 881 884 895 907 908 910 911 971 1004 1006 1008 1021 1033 1034 1054 1068 1082 1088 1093 1103 1113 1120 
99 217 241 270 330 338 339 352 372 431 439 459 495 510 511 516 555 556 567 579 600 690 691 807 821 833 844 858 862 868 905 921 922 938 942 1007 1024 1039 1042 1066 1072 1076 1119 1131 1132 1135 
60 136 257 258 259 283 342 360 361 362 424 517 518 535 575 605 745 773 805 806 812 877 886 933 969 1040 1074 1095 1106 
51 66 104 400 477 478 492 582 607 640 660 733 753 759 1121 
574 602 646 714 1061 1070 1078 1090 1102 1149 
