12 24 25 30 37 44 45 56 68 69 83 102 130 131 133 139 152 169 201 202 203 233 234 245 250 279 310 314 315 321 335 340 342 363 375 378 395 409 410 411 416 427 429 430 435 439 440 452 462 467 481 489 490 491 497 508 521 533 547 548 549 551 558 561 564 565 566 573 593 599 601 615 631 635 636 637 642 654 672 673 678 679 683 684 692 699 701 719 724 732 747 768 778 785 786 792 802 813 827 830 831 832 836 866 876 885 893 901 903 909 912 937 945 947 957 966 985 996 998 1005 1033 1034 1054 1059 1060 1067 1068 1069 1072 1112 1127 1136 1145 1146 1150 
0 1 10 11 18 19 23 28 32 33 38 39 42 43 46 52 58 59 61 62 70 73 74 76 77 78 79 80 95 96 107 108 117 118 148 157 162 168 174 175 176 178 179 181 186 187 193 194 197 210 211 212 218 222 225 226 246 247 248 249 251 252 264 275 276 282 286 287 297 298 313 318 334 341 353 382 386 387 392 417 420 423 434 448 453 456 485 486 496 499 506 512 513 520 532 538 539 540 550 572 592 622 661 663 676 688 698 754 757 775 783 812 825 828 847 894 904 905 917 929 935 958 967 974 976 982 990 994 1036 1096 1101 1137 
6 7 20 21 26 29 40 41 64 85 86 103 104 115 116 126 135 142 151 154 195 196 207 208 209 221 227 242 243 258 260 261 262 263 299 311 322 357 358 366 367 368 371 372 373 374 380 389 401 412 413 437 498 500 502 543 559 560 570 571 574 586 597 608 639 648 685 697 720 721 725 728 746 766 779 849 852 867 870 881 884 899 907 948 949 1008 1023 1032 1040 1056 1082 1113 1120 
27 65 110 111 140 141 198 199 235 236 237 244 295 296 312 324 327 328 336 337 343 346 347 356 359 361 376 377 391 426 457 458 482 501 507 509 522 544 605 612 625 628 638 643 649 657 667 682 696 700 703 705 707 708 731 738 762 773 791 808 822 857 926 928 932 955 965 983 989 993 997 1009 1017 1019 1030 1046 1075 1076 1083 1095 1111 1115 
16 81 82 97 146 147 172 173 191 192 205 219 257 259 267 283 284 330 424 466 493 525 530 562 563 569 583 584 585 629 630 651 662 711 714 718 726 736 752 753 780 837 856 869 906 916 927 941 956 972 975 1014 1025 1028 1042 1049 1064 1100 1126 1140 1148 
13 47 48 87 88 138 204 223 224 230 268 344 370 469 470 516 523 524 541 542 607 609 610 624 670 715 716 737 761 801 810 811 838 839 863 871 872 946 1006 1015 1047 1086 1087 1104 1133 1141 1144 
71 72 84 105 106 153 231 269 270 291 292 293 338 339 348 390 394 428 431 432 443 449 459 460 475 504 505 579 587 588 671 674 675 717 749 820 833 844 882 920 991 995 1037 1051 1055 1085 1116 
8 9 31 51 60 63 66 67 75 109 114 158 206 265 266 332 333 355 393 400 408 444 477 478 529 546 577 578 582 591 640 660 733 739 759 769 845 861 1065 1108 
4 5 17 91 92 93 94 150 183 190 213 214 280 281 323 351 352 365 438 495 511 554 618 664 694 704 760 767 829 959 962 963 987 1010 1071 1084 
36 100 101 125 143 167 177 200 285 319 320 325 331 350 354 414 445 494 568 620 623 666 686 687 689 794 814 818 878 880 913 960 1026 1138 1147 
57 129 134 180 228 229 302 303 360 383 406 415 421 422 454 455 526 527 681 706 727 751 763 781 782 796 855 873 877 919 924 969 1128 
112 113 121 122 144 145 159 160 182 215 216 381 396 397 404 405 471 487 528 536 537 552 595 596 614 621 900 936 939 943 953 1097 1143 
119 120 127 128 149 161 165 170 171 277 278 309 316 384 385 402 403 418 419 461 492 557 613 656 860 886 934 940 951 961 1020 1092 1135 
34 53 288 289 308 575 580 611 646 695 742 823 824 841 908 918 925 968 1061 1066 1077 1093 1102 1149 
155 407 450 576 589 616 617 634 665 668 722 793 809 897 898 1016 1021 1022 1027 1074 1081 1124 1151 1152 
2 232 274 290 349 483 519 531 545 598 641 709 750 755 816 840 859 910 999 1041 1123 1139 
89 90 136 137 184 305 306 317 436 514 606 650 702 848 853 868 891 892 1048 1073 1130 
98 326 510 555 556 602 603 821 862 921 1012 1024 1045 1062 1098 1099 1119 
132 255 256 300 301 307 479 647 730 800 879 896 1103 1114 1122 
690 691 710 954 1035 1039 1058 1070 1078 1090 1109 1110 1131 1132 
49 50 253 254 388 446 447 553 594 680 789 834 914 
54 55 217 567 740 756 835 846 854 971 1053 1088 1125 
123 304 472 745 797 798 902 933 978 988 1043 
124 503 619 626 658 659 784 788 817 890 992 
163 164 220 238 239 271 463 632 633 815 826 
398 399 627 712 713 758 774 777 944 964 
345 425 476 600 693 743 744 895 1050 
240 241 465 468 515 790 1117 
534 535 735 770 858 931 984 
14 15 480 484 488 973 
22 379 653 787 970 1013 
156 581 590 776 799 819 
166 677 729 1000 1038 1063 
364 850 851 875 923 950 
473 474 887 888 1003 1004 
803 804 807 922 938 986 
185 842 843 977 1044 
362 451 517 518 915 
441 604 748 942 1142 
464 723 874 1057 1091 
35 795 889 1031 
99 329 669 772 
188 189 433 1011 
272 273 652 1094 
442 771 883 
741 1007 1080 
805 806 1106 
