1 10 18 19 28 30 32 38 39 42 44 46 58 59 62 71 72 73 74 75 76 79 80 105 118 119 130 131 147 148 157 162 165 168 169 174 178 181 186 187 193 194 197 210 218 222 225 226 246 248 249 252 262 264 275 276 278 282 286 287 288 291 292 297 298 299 300 313 318 334 340 348 349 353 378 382 386 387 390 392 395 417 420 456 494 496 498 499 503 506 512 513 514 520 532 539 540 566 622 641 642 645 661 688 720 732 734 735 739 740 741 772 783 787 790 802 825 828 830 840 854 873 935 967 990 1012 1015 1020 1041 1059 1060 1069 1100 1108 1114 1123 1127 1138 1147 
47 48 91 102 108 110 111 112 113 116 122 145 154 159 190 195 202 215 216 223 224 235 236 323 329 339 341 381 396 404 405 431 459 460 471 487 528 536 537 542 572 595 596 618 621 638 669 694 798 811 822 839 890 932 936 939 947 949 953 1006 1019 1037 1084 1097 1101 1122 1150 
7 9 11 68 86 123 201 212 233 251 272 273 280 326 327 391 476 482 484 507 522 547 562 614 639 648 652 685 816 843 1046 
114 117 211 250 379 409 430 485 515 529 538 546 651 726 737 778 785 786 837 838 857 996 1011 1137 1144 
50 90 137 184 185 265 316 317 436 465 468 552 650 834 848 853 891 892 977 1013 1048 1073 1117 
16 27 41 126 188 189 343 356 359 457 458 554 597 705 717 718 757 926 994 1067 1111 
56 177 433 435 440 450 481 489 490 561 598 603 635 636 637 749 893 912 988 1098 1152 
96 155 156 171 245 385 509 580 629 647 657 722 730 776 799 819 1022 1045 1124 
330 352 439 555 556 600 690 691 821 862 921 1024 1039 1066 1119 1131 1132 1135 
432 523 524 631 695 803 814 852 952 995 999 1028 1047 1051 1056 1064 1086 1104 
23 227 279 321 322 497 508 551 665 701 880 943 954 1035 1058 1145 
6 234 263 446 728 856 895 910 911 1004 1008 1021 1082 1113 1120 
26 29 85 198 221 242 243 364 373 374 577 649 863 1032 1063 
34 83 84 247 256 301 593 634 654 655 742 879 931 984 1146 
78 129 369 469 533 581 727 747 801 850 851 930 1079 1128 
150 183 213 254 281 351 365 438 585 664 767 829 900 1071 
0 64 88 274 290 519 531 545 750 755 859 875 899 
284 403 656 677 678 684 692 693 743 744 1005 1050 
57 163 164 220 238 271 394 463 671 813 826 
209 398 619 712 758 774 777 878 914 944 964 
36 232 239 270 408 505 810 901 946 1094 
121 388 389 437 841 849 884 908 1092 1093 
180 357 406 407 464 500 632 633 962 1038 
135 296 324 700 928 948 965 983 1009 
173 192 259 283 360 424 780 906 1049 
228 362 434 517 518 812 877 882 969 
293 427 455 504 653 887 924 970 991 
308 355 444 578 591 606 815 845 974 
5 69 314 428 674 675 920 982 
81 142 199 261 568 666 771 986 
94 149 441 442 704 883 940 959 
97 179 203 266 687 709 1023 1044 
99 241 807 868 905 922 938 1007 
106 214 350 380 571 904 976 1026 
366 521 583 725 832 885 1126 1140 
2 144 736 902 945 1085 1139 
24 630 756 835 846 916 1080 
51 66 400 477 492 660 733 
82 146 207 295 569 707 716 
93 127 418 422 710 1109 1110 
115 170 219 613 713 934 951 
338 416 449 579 588 844 1142 
454 466 467 573 762 781 782 
599 615 724 795 860 889 1031 
4 17 371 760 987 1072 
8 158 311 332 347 501 
14 534 706 770 968 1077 
20 21 335 667 768 769 
25 612 627 683 925 981 
33 161 315 384 474 557 
53 289 309 319 961 1025 
95 320 550 620 748 872 
208 231 307 479 779 1103 
229 415 526 681 763 796 
269 305 445 663 842 861 
558 673 874 1057 1091 1136 
12 13 425 1087 1133 
15 151 480 488 808 
22 204 205 230 451 
35 182 589 1016 1143 
49 472 680 789 992 
61 662 689 869 1096 
87 89 337 426 1083 
92 128 160 345 1036 
100 268 502 1027 1151 
107 120 328 659 791 
125 543 544 746 997 
138 139 370 617 715 
141 473 592 888 1003 
196 344 383 628 766 
206 367 549 604 867 
244 800 966 972 1112 
257 258 805 1040 1095 
310 697 721 729 1000 
336 708 903 993 1075 
411 643 897 898 1055 
525 827 894 1001 1089 
646 1061 1078 1090 1149 
792 820 1033 1034 1054 
31 575 576 1099 
40 140 167 794 
45 541 616 809 
103 333 377 870 
104 582 607 640 
133 134 312 804 
166 325 331 960 
172 601 623 1115 
175 176 527 978 
191 563 586 1014 
217 567 942 1053 
237 402 658 784 
302 608 672 955 
342 346 361 605 
397 788 941 1148 
399 413 470 871 
584 699 818 1042 
745 773 933 1074 
775 866 929 957 
3 443 1116 
54 55 1125 
67 109 624 
77 419 486 
101 363 696 
124 447 611 
152 153 950 
260 565 676 
285 448 703 
354 483 548 
368 530 1118 
372 516 1076 
393 670 956 
401 913 923 
410 493 797 
421 626 836 
423 751 915 
452 453 731 
475 817 918 
491 702 723 
495 510 511 
559 823 975 
570 668 752 
602 1070 1102 
609 754 907 
679 855 927 
738 919 1065 
793 876 1081 
