1 16 41 61 76 82 85 88 95 96 107 117 118 120 162 167 197 210 211 214 219 223 262 282 285 320 328 344 417 437 448 485 493 494 547 550 553 613 620 651 662 687 689 696 697 703 726 737 738 748 750 769 837 838 842 878 976 994 1065 1096 1137 1144 
7 47 48 91 108 125 143 159 190 224 280 323 381 414 438 445 471 495 507 537 541 542 572 618 638 669 688 694 767 798 811 818 822 839 843 875 890 913 949 960 967 1019 1074 1084 1097 1101 1150 
8 15 18 32 38 51 79 130 151 158 168 169 181 265 311 332 355 389 400 440 465 478 513 514 529 578 591 597 660 739 741 753 833 892 907 912 935 1040 
34 35 60 128 189 523 524 534 535 557 645 695 706 770 889 897 931 968 984 995 999 1021 1023 1031 1066 1077 1086 1104 
12 101 114 378 409 410 425 490 538 546 558 627 672 673 699 778 874 876 925 945 1057 1091 1136 
28 131 225 313 392 420 540 604 701 732 757 836 963 974 996 1033 1034 1052 1069 1147 
113 122 144 145 150 160 182 215 216 396 404 487 528 536 595 596 621 936 939 1143 
146 147 173 192 284 466 562 563 584 630 780 852 856 916 1014 1028 1047 1049 1067 1100 
166 174 232 234 446 533 644 819 832 910 911 937 955 957 1004 1008 1113 1120 
37 123 253 304 349 472 499 680 698 745 797 902 918 933 952 978 1043 
10 30 366 449 501 556 642 814 853 947 1038 1059 1119 1127 1138 
54 55 93 405 710 740 954 1035 1053 1058 1078 1109 1110 1125 1131 
105 269 270 272 345 476 504 505 671 743 744 747 882 895 1050 
5 273 302 326 439 503 652 756 835 846 987 1080 1094 1135 
121 165 292 314 375 390 428 674 675 813 919 920 1037 1051 
104 116 286 357 502 559 574 714 720 728 779 823 962 
36 163 164 220 238 239 271 370 582 607 683 826 
398 416 588 713 758 774 777 944 951 964 998 1142 
87 399 413 469 470 609 610 800 801 871 1079 
111 154 310 342 422 573 762 782 858 909 1000 
312 333 377 457 543 681 773 849 870 884 992 
338 339 431 459 460 482 579 844 923 991 1116 
90 137 184 185 306 317 848 891 977 1048 
2 172 429 587 736 845 1013 1085 1139 
26 364 520 622 859 904 905 990 1032 
64 274 519 531 545 715 755 816 899 
72 322 380 539 570 615 639 802 917 
83 132 300 654 655 733 795 879 1114 
206 207 295 296 356 705 707 928 948 
255 256 301 307 308 479 575 647 1103 
6 29 86 115 242 243 373 374 
22 57 261 293 451 455 489 653 
33 39 44 297 353 456 787 1030 
81 199 474 568 857 959 969 986 
92 149 213 281 664 704 1036 1071 
99 803 804 807 868 922 1007 1060 
171 245 619 656 821 887 896 1045 
3 20 63 140 235 443 727 
66 141 152 153 383 612 700 
68 74 178 387 506 530 985 
109 135 148 340 341 734 1095 
156 785 786 983 1009 1017 1018 
229 415 421 526 763 796 873 
260 473 592 676 888 1003 1011 
352 599 600 641 722 1041 1123 
382 444 606 775 815 908 1108 
433 481 788 941 958 988 1148 
0 249 362 661 677 754 
19 241 468 702 790 1117 
21 903 993 997 1075 1115 
27 157 193 252 663 1111 
42 106 186 350 475 1026 
45 278 367 498 616 885 
77 127 402 419 486 940 
112 403 549 678 692 1005 
133 395 430 544 746 975 
170 175 176 693 759 1121 
226 450 598 603 1098 1152 
327 343 583 869 1126 1140 
458 626 717 718 872 930 
497 634 665 929 970 1128 
4 17 227 508 760 
11 70 194 201 880 
53 155 221 841 961 
56 636 730 827 1089 
62 254 335 684 768 
67 138 204 624 670 
73 217 288 318 321 
84 247 593 742 1146 
89 325 337 401 426 
97 179 266 631 709 
100 369 379 666 667 
124 268 817 1027 1151 
139 279 336 708 809 
183 365 585 829 900 
191 567 586 735 854 
228 434 783 812 828 
257 258 259 424 805 
346 347 361 625 808 
411 608 643 1055 1056 
427 649 791 793 1081 
435 436 561 635 1130 
509 580 589 799 972 
724 792 820 1022 1054 
9 94 391 1046 
14 406 407 729 
24 25 461 462 
31 576 1016 1099 
40 188 196 628 
43 200 246 721 
46 334 716 766 
49 359 554 789 
59 551 564 1145 
65 251 351 565 
69 749 886 982 
126 237 477 946 
129 331 496 581 
142 491 569 723 
177 637 794 860 
212 222 290 566 
230 316 552 914 
233 275 685 825 
240 480 488 973 
244 264 894 1112 
248 299 532 1015 
263 289 516 1076 
283 510 511 906 
303 454 781 924 
329 484 648 772 
330 492 548 1042 
441 442 771 883 
464 500 632 633 
521 605 898 971 
555 862 921 1024 
646 1061 1090 1149 
690 691 1039 1132 
58 75 386 
78 850 851 
80 324 358 
98 276 1012 
102 512 901 
119 187 218 
136 250 515 
180 385 751 
195 368 467 
202 203 1044 
209 712 934 
277 881 1020 
287 784 830 
298 423 915 
354 483 686 
371 1025 1072 
372 527 824 
388 657 1083 
393 394 463 
397 943 953 
408 725 950 
418 601 623 
452 731 989 
517 518 877 
560 658 867 
590 761 863 
602 1070 1102 
650 1073 1141 
679 855 927 
810 1087 1133 
