1 10 18 19 28 30 32 38 39 42 44 46 58 59 62 65 71 72 73 74 75 76 79 80 89 105 118 119 130 131 147 148 157 162 165 168 169 174 178 181 187 193 194 197 210 218 222 225 226 246 248 249 252 262 264 275 278 282 286 287 288 297 298 299 300 313 318 320 334 340 348 349 353 368 378 382 386 387 390 392 395 417 420 423 426 456 485 494 496 498 499 503 506 512 513 514 520 530 532 539 540 566 622 641 642 645 661 688 689 720 732 734 735 739 740 741 751 772 783 790 802 825 828 830 835 840 846 854 873 915 935 967 990 1015 1020 1041 1043 1053 1059 1060 1069 1083 1100 1108 1114 1118 1123 1127 1137 1138 1147 
47 48 91 108 113 116 122 145 159 215 216 223 224 323 329 338 339 341 381 396 404 405 431 459 460 471 487 528 536 537 572 579 595 596 618 621 638 669 694 798 811 822 839 844 936 939 947 948 949 953 1002 1029 1037 1084 1097 1101 1122 1150 
26 29 40 85 101 102 107 110 111 135 140 154 158 167 177 186 195 198 199 207 211 221 235 236 242 243 244 261 295 324 325 328 363 364 373 374 428 569 649 678 696 700 702 707 794 800 863 919 932 960 1009 1019 1032 1112 
50 230 254 265 316 393 432 465 523 524 552 631 670 695 814 834 852 853 889 897 898 952 956 995 999 1028 1047 1051 1056 1064 1079 1086 1104 
16 20 21 27 41 53 126 188 335 343 356 359 457 458 554 578 597 628 667 705 717 718 728 757 766 926 961 994 1067 1111 
96 155 156 171 245 385 509 580 590 629 647 722 730 776 799 803 819 965 972 983 1022 1045 1124 
5 69 292 306 314 375 397 521 583 674 675 725 788 820 832 920 941 982 1126 1140 1148 
56 433 435 440 450 481 489 490 598 603 635 636 637 724 749 893 912 988 1098 1130 1152 
352 439 495 510 511 555 556 600 690 691 821 862 921 1024 1039 1072 1119 1131 1132 1135 
9 86 123 272 273 280 326 327 391 482 484 522 547 614 639 648 652 816 1046 
36 57 106 163 164 220 232 238 239 271 394 463 505 813 826 901 1094 
23 227 279 321 322 497 508 551 665 701 880 943 954 1035 1058 1145 
34 83 84 247 256 301 557 593 634 654 655 742 879 931 984 1146 
6 234 304 446 761 895 910 911 937 1004 1008 1021 1113 1120 
92 150 183 213 281 351 365 438 585 664 767 900 1036 1071 
95 114 409 538 546 550 620 651 726 778 785 786 838 872 
416 449 454 466 467 573 588 711 762 781 782 909 998 1142 
51 66 263 372 400 478 516 582 660 753 759 1076 1121 
82 146 191 192 284 562 563 586 716 780 856 1014 1042 
0 64 274 290 519 531 545 750 755 859 875 899 
7 11 68 201 212 233 250 251 507 685 843 
24 97 179 203 630 682 687 709 831 1023 1044 
81 142 277 319 331 445 568 666 771 881 986 
128 160 269 270 345 476 671 743 744 747 1050 
8 103 125 311 333 543 544 746 870 884 
99 217 241 567 807 868 905 922 938 1007 
109 291 308 355 444 591 606 815 845 974 
189 398 627 683 758 774 777 925 944 964 
2 144 515 736 902 945 1013 1085 1139 
293 427 455 504 653 887 924 970 991 
534 679 706 770 855 927 968 1031 1077 
78 129 369 533 581 727 851 1128 
87 88 138 139 370 617 715 1006 
115 170 219 542 613 713 934 951 
366 399 413 470 599 610 871 885 
602 646 1061 1070 1078 1090 1102 1149 
137 185 317 848 891 892 977 
173 259 283 360 424 906 1049 
214 350 380 571 904 976 1026 
260 473 565 592 676 888 1003 
336 337 708 903 993 997 1075 
33 120 161 384 474 940 
93 127 422 710 1109 1110 
94 149 190 441 442 883 
124 237 402 658 659 784 
206 367 549 604 867 1082 
208 231 307 479 779 1103 
229 415 526 681 763 796 
305 491 663 723 842 861 
362 517 518 812 877 969 
570 615 668 748 752 917 
3 63 143 443 1116 
4 17 371 760 987 
15 151 480 488 808 
54 55 756 1080 1125 
61 486 662 869 1096 
141 775 866 929 957 
172 418 601 623 1115 
209 619 712 878 914 
257 258 805 1040 1095 
403 684 692 693 1005 
421 461 462 626 836 
14 406 729 1038 
31 576 850 1099 
45 541 616 809 
52 464 632 633 
112 575 589 1016 
133 134 312 804 
175 176 527 978 
180 357 407 962 
268 502 1027 1151 
289 309 916 1025 
302 608 672 955 
310 697 721 1000 
330 548 942 1066 
342 346 361 605 
468 561 650 1117 
529 737 930 1144 
558 673 874 1136 
745 773 933 1074 
791 793 876 1081 
810 946 1087 1133 
12 425 928 
22 266 451 
25 612 981 
35 182 1143 
49 789 992 
60 419 535 
77 447 611 
90 184 436 
100 379 787 
104 607 640 
117 315 656 
121 849 908 
136 886 1048 
152 153 950 
166 738 1065 
196 344 383 
228 434 882 
267 296 412 
285 448 703 
332 347 501 
358 792 971 
376 377 719 
388 389 437 
401 913 923 
408 472 829 
410 493 797 
411 643 1055 
414 500 553 
430 837 1011 
452 453 731 
475 817 918 
477 492 733 
525 894 1001 
559 823 975 
577 677 1063 
584 699 818 
609 754 907 
841 1092 1093 
1033 1034 1054 
