8 9 12 24 25 30 31 37 44 45 51 57 60 63 66 67 68 69 75 83 102 109 114 129 130 131 133 152 158 169 201 202 203 206 233 234 245 250 265 266 279 302 304 310 314 315 321 332 333 335 340 342 355 363 378 383 393 395 400 408 409 410 411 416 422 427 429 430 435 439 440 444 452 462 467 477 478 481 489 490 491 497 508 521 529 533 546 547 548 549 551 558 561 564 565 566 573 577 578 582 591 593 599 601 615 631 635 636 637 640 642 654 660 672 673 678 679 683 684 692 699 701 706 724 732 733 739 747 759 768 769 778 782 785 786 792 796 802 813 827 830 831 832 836 845 861 876 877 885 893 903 909 912 919 937 945 947 966 985 996 998 1005 1033 1034 1054 1059 1060 1065 1069 1072 1108 1112 1127 1136 1145 1146 1150 
0 1 10 11 18 19 23 28 32 33 38 39 42 43 46 52 58 59 61 62 70 73 74 76 77 78 79 80 95 96 107 108 117 118 148 157 162 168 174 175 176 178 179 181 186 187 193 194 197 210 211 212 218 222 225 226 246 247 248 249 251 252 264 275 276 282 286 287 297 298 313 318 334 341 353 375 382 386 387 392 417 420 423 434 448 453 456 485 486 496 499 506 512 513 520 532 538 539 540 550 572 592 622 661 663 676 688 698 754 757 775 783 812 825 828 847 894 904 905 917 929 935 957 958 967 974 976 982 990 994 1036 1096 1101 1137 
13 27 47 48 65 87 88 110 111 138 140 141 198 199 204 223 224 230 235 236 237 244 268 295 296 312 324 327 328 336 337 343 344 356 359 361 369 370 376 377 391 457 458 470 482 507 509 516 522 523 524 541 542 544 607 609 610 612 624 638 643 649 657 667 670 682 696 700 703 705 707 708 715 716 727 731 737 738 761 762 773 791 808 810 811 822 838 839 857 863 871 872 926 928 930 932 946 955 965 981 983 989 1006 1009 1015 1017 1019 1030 1046 1067 1075 1076 1083 1086 1087 1104 1111 1115 1133 1141 1144 
6 7 20 21 26 29 40 41 64 85 86 103 104 115 116 126 135 142 151 154 195 196 207 208 209 221 227 242 243 258 260 263 311 357 358 368 371 372 373 374 389 401 437 498 500 502 543 559 560 571 574 597 608 639 648 685 720 728 746 766 779 849 852 870 884 899 907 948 949 1008 1023 1032 1040 1056 1113 1120 
16 81 82 97 146 147 172 173 191 192 205 219 257 259 267 283 284 330 424 466 493 525 530 562 563 569 583 584 585 620 629 630 651 662 711 714 718 726 736 752 753 780 837 856 869 906 916 927 941 956 972 975 1001 1014 1025 1028 1042 1049 1064 1100 1118 1126 1140 1148 
71 72 84 105 106 153 231 269 270 291 292 293 294 305 338 339 348 362 390 394 428 431 432 443 449 459 460 475 504 505 579 587 588 671 674 675 717 749 790 820 833 844 882 920 991 995 1037 1051 1055 1085 1116 1121 
36 100 101 125 143 166 167 177 200 261 285 319 320 325 331 350 354 414 445 494 568 586 623 666 677 686 687 689 729 794 814 818 878 880 881 901 913 960 1000 1026 1038 1063 1138 1147 
4 5 17 91 92 93 94 150 183 190 213 214 280 281 323 351 352 365 438 495 511 554 618 664 694 704 760 767 829 959 962 963 987 1010 1071 
112 113 121 122 144 145 159 160 182 215 216 381 396 397 404 405 471 487 528 536 537 552 595 596 614 621 900 936 939 943 953 1084 1097 1143 
119 120 127 128 149 161 165 170 171 277 278 309 316 384 385 402 403 418 419 461 492 557 613 656 860 886 934 940 951 961 1020 1047 1092 1135 
34 35 53 288 289 308 575 580 695 742 817 823 824 841 908 918 925 968 1031 1066 1077 1093 
98 272 273 326 510 555 556 602 603 652 821 862 921 1012 1024 1045 1062 1070 1094 1098 1099 1119 
134 139 180 228 229 303 360 406 415 421 454 455 526 527 681 751 763 781 855 873 924 1068 
2 232 274 290 349 483 519 531 545 598 641 709 750 755 816 859 910 999 1041 1123 1139 
89 90 136 137 184 306 317 436 514 606 650 702 848 853 868 891 892 1048 1073 1130 
124 503 611 619 626 646 658 659 784 788 795 879 889 890 992 1061 1102 1149 
155 450 589 616 668 722 793 809 897 898 1021 1022 1027 1074 1081 1151 1152 
54 55 217 567 740 741 756 835 846 854 971 1007 1053 1080 1088 1125 
262 299 322 366 367 380 412 413 570 697 721 725 867 1082 
49 50 253 254 388 446 447 553 594 680 789 834 914 
132 255 256 300 301 307 479 647 840 896 1103 1114 1122 
690 691 710 954 1035 1039 1058 1078 1090 1109 1110 1131 1132 
163 164 220 238 239 271 463 632 633 815 826 
346 347 426 469 501 605 625 801 993 997 1079 
398 399 627 712 713 758 774 777 944 964 
379 604 653 748 787 942 970 1043 1142 
156 581 590 730 776 799 800 819 
123 472 745 797 798 933 978 
185 464 465 842 843 977 1044 
14 15 480 484 488 973 
364 850 851 875 923 950 
441 442 534 771 883 988 
473 474 887 888 1003 1004 
476 693 743 744 895 1050 
535 735 770 858 931 984 
634 655 665 1089 1124 1128 
803 804 807 922 938 986 
240 241 468 515 1117 
56 345 425 600 
99 669 772 969 
188 189 433 1011 
407 576 617 1016 
723 874 1057 1091 
22 902 1013 
329 719 866 
805 806 1106 
