1 10 18 19 28 30 32 38 39 42 44 46 58 59 62 71 72 73 74 75 76 79 80 119 130 131 147 148 162 165 168 169 181 187 193 194 197 210 218 222 225 226 246 248 249 252 262 264 275 278 282 286 291 297 300 313 318 334 340 348 353 378 382 386 387 390 392 395 417 420 456 496 498 503 506 512 513 514 520 532 540 566 622 641 642 661 716 720 739 741 747 783 787 790 825 828 840 904 935 967 990 1015 1020 1041 1059 1069 1100 1114 1123 1127 1138 1147 
7 9 11 16 68 86 95 100 114 117 118 123 201 212 233 250 251 272 273 280 320 326 327 368 379 391 409 410 430 482 484 485 493 494 507 515 522 530 538 545 546 547 548 550 562 568 614 620 648 651 652 703 726 748 778 785 786 816 837 838 843 857 872 931 994 1011 1046 1118 1137 
26 29 40 82 85 101 102 107 120 135 140 154 158 167 198 206 207 211 235 236 237 242 243 244 261 295 296 324 325 328 337 356 363 428 491 529 604 649 659 678 696 700 702 707 727 737 754 794 797 842 863 919 928 932 948 960 965 966 996 1032 1112 1144 
47 48 108 159 223 224 323 341 381 460 471 537 542 572 618 694 798 811 822 839 947 949 953 1019 1029 1037 1084 1097 1101 1122 1150 
5 69 177 270 292 314 366 397 504 521 583 599 671 674 675 724 725 749 788 820 885 920 941 982 991 1022 1126 1140 1148 
27 41 126 188 189 343 359 457 458 554 597 627 705 717 718 757 925 926 1067 1111 
8 110 121 133 134 311 312 333 377 543 544 681 746 804 849 870 884 
6 174 234 446 688 832 856 869 895 910 911 1004 1008 1021 1113 1120 
96 156 171 245 509 580 629 647 657 722 730 776 799 819 1045 1124 
65 315 321 322 380 414 472 553 570 571 615 639 680 1043 1082 
150 183 213 254 281 351 365 438 585 621 664 767 829 900 1071 
113 122 145 215 216 396 404 487 528 536 595 596 936 939 
523 524 803 814 889 897 898 952 995 999 1028 1051 1086 1104 
129 369 469 533 581 801 807 851 868 922 930 1079 1128 
34 83 247 557 593 654 655 742 795 879 984 1146 
0 64 88 274 290 519 531 750 755 859 899 
36 232 505 603 683 810 901 902 946 1094 1098 
50 241 265 465 468 561 834 853 892 1013 1117 
440 450 489 490 598 635 636 637 912 1074 1152 
20 21 53 155 221 335 373 374 667 961 
33 115 161 170 219 384 613 713 934 951 
90 137 184 185 317 436 848 891 977 1048 
14 180 357 406 407 500 729 962 1038 
23 227 256 279 508 551 701 880 1145 
87 413 426 470 609 610 871 1083 1141 
105 178 288 304 349 499 645 732 873 
439 495 510 511 556 1039 1119 1131 1135 
534 679 706 770 855 927 968 1031 1077 
43 132 200 310 697 698 721 1000 
61 285 375 448 662 689 917 1096 
91 99 329 669 772 905 1007 1060 
208 231 301 307 479 728 779 1103 
284 403 549 656 684 692 693 1005 
308 355 444 591 606 815 845 908 
2 144 408 736 945 1085 1139 
146 191 192 563 586 780 1014 
454 466 467 573 762 781 782 
77 127 402 419 486 940 
94 149 190 441 442 883 
97 179 631 687 709 817 
98 429 943 954 1035 1058 
106 214 350 695 976 1026 
125 364 401 875 913 923 
138 139 370 617 715 1006 
163 164 220 238 271 826 
257 258 259 424 1040 1095 
283 342 360 361 575 605 
338 339 431 459 579 844 
362 517 518 663 877 969 
398 758 774 777 944 964 
12 56 160 345 425 
13 112 195 589 1002 
15 151 480 488 808 
17 371 760 987 1072 
54 55 740 1053 1125 
67 109 294 624 847 
196 344 383 628 766 
209 399 619 712 1023 
229 415 526 763 796 
239 464 632 633 723 
260 565 644 676 686 
263 372 516 938 1076 
427 791 793 876 1081 
555 821 862 921 1024 
584 699 818 906 1042 
735 833 854 858 1108 
903 993 997 1075 1115 
3 63 443 1116 
31 576 1016 1099 
35 182 907 1143 
51 66 400 660 
57 394 463 813 
81 199 474 986 
104 582 607 640 
111 331 909 998 
116 358 638 971 
157 299 734 792 
175 176 527 978 
228 434 812 882 
268 502 1027 1151 
269 305 445 861 
287 784 830 890 
293 653 924 970 
298 423 751 915 
302 608 672 955 
346 541 616 809 
388 389 437 841 
411 643 1055 1056 
416 449 588 1142 
432 852 1047 1064 
461 462 1092 1093 
558 673 874 1136 
574 646 714 1149 
775 866 929 957 
983 1009 1017 1018 
4 704 959 
22 266 451 
24 630 846 
25 612 981 
49 789 992 
52 711 1049 
89 625 989 
92 128 1036 
93 405 710 
124 447 611 
141 473 592 
152 153 950 
166 738 1065 
172 601 623 
186 475 918 
202 203 1044 
204 205 893 
217 567 942 
230 316 552 
306 435 1130 
332 347 501 
336 578 708 
385 418 422 
393 670 956 
433 481 988 
452 453 731 
477 492 733 
497 634 665 
525 894 1001 
559 823 975 
577 677 1063 
602 1070 1102 
682 831 937 
690 691 1132 
743 744 1050 
745 773 933 
756 835 1080 
805 806 1106 
1033 1034 1054 
1061 1078 1090 
