7 14 26 29 34 40 43 47 48 55 61 81 82 85 87 88 96 98 100 101 102 107 108 110 111 116 135 140 142 146 154 155 156 158 166 167 185 191 192 195 198 199 204 205 207 211 221 223 230 235 236 237 241 242 243 244 245 247 261 267 269 290 294 295 296 302 303 305 319 323 324 325 328 329 331 341 355 363 364 370 373 374 385 401 402 412 428 445 448 491 498 509 518 563 568 569 572 577 580 586 590 593 608 618 624 629 638 647 649 654 657 658 659 666 669 672 677 678 680 694 696 700 702 703 716 722 723 730 738 742 761 776 780 781 784 794 798 799 800 811 819 822 824 830 839 842 847 854 861 863 890 901 913 919 923 932 937 943 947 948 949 954 955 958 960 965 966 972 983 986 1009 1014 1019 1022 1032 1035 1037 1045 1058 1063 1084 1096 1097 1101 1122 1124 1125 1146 
2 4 17 23 24 36 37 49 50 65 90 97 106 137 144 179 184 203 214 224 227 228 239 240 253 256 260 265 270 279 285 301 315 316 317 321 322 346 350 354 371 380 410 411 413 432 465 468 470 472 483 493 497 504 505 508 515 523 524 525 541 551 552 559 565 570 571 599 610 615 616 622 630 631 643 644 655 665 676 686 687 695 701 709 736 760 770 789 795 797 803 809 810 814 823 827 831 834 846 848 852 853 860 871 874 879 880 882 889 891 892 894 897 898 902 916 917 945 946 952 963 968 975 976 977 987 995 999 1006 1013 1017 1018 1023 1026 1027 1028 1031 1043 1044 1047 1048 1051 1052 1055 1056 1057 1064 1065 1071 1073 1077 1085 1086 1089 1091 1094 1103 1104 1107 1117 1134 1139 1141 1145 1151 
1 10 18 19 30 32 38 39 42 44 46 52 58 62 70 71 72 73 74 76 79 80 89 105 118 130 131 132 147 148 157 162 165 168 169 174 178 181 193 194 197 218 222 225 226 246 249 252 262 264 275 276 278 282 286 287 288 297 298 300 313 318 320 334 340 348 349 353 368 378 382 386 387 390 392 395 417 420 426 456 464 473 485 494 496 499 503 506 512 513 514 519 520 530 532 539 540 558 566 592 606 632 633 642 645 661 673 688 689 720 732 734 739 741 772 783 787 790 802 825 828 840 873 896 935 967 973 985 990 1001 1012 1015 1059 1060 1067 1069 1083 1100 1105 1112 1114 1118 1127 1129 1136 1137 1138 1147 
9 11 16 68 86 95 114 117 119 123 124 136 183 187 201 210 212 233 248 250 251 254 272 273 280 284 299 326 327 358 391 403 409 430 482 484 507 522 538 546 547 550 562 620 621 639 641 648 651 652 656 684 685 692 693 726 778 785 786 792 816 837 838 843 857 872 876 931 971 994 996 1005 1011 1020 1033 1034 1041 1046 1049 1054 1123 1150 
0 31 54 64 77 93 125 127 133 134 139 172 173 274 311 312 333 336 337 422 429 452 453 486 531 543 544 578 584 601 623 662 682 699 707 708 710 715 731 740 746 750 755 764 765 791 804 818 859 875 899 903 906 961 993 997 1042 1053 1075 1078 1099 1109 1110 1115 
5 69 83 84 109 138 177 186 213 259 268 281 291 292 306 308 314 351 365 366 375 393 408 438 444 475 476 502 521 574 583 585 591 617 664 670 671 674 675 714 725 735 747 767 817 820 832 841 885 900 908 918 920 941 956 982 1092 1093 1108 1126 1140 1148 
12 13 35 92 112 113 121 122 128 145 150 159 160 182 215 216 345 381 388 389 396 397 404 405 425 437 471 487 528 536 537 589 595 596 614 743 744 849 870 884 928 936 939 953 1016 1036 1050 1143 
6 15 151 152 208 231 232 234 307 332 338 339 347 431 446 459 460 479 480 488 501 564 579 587 588 594 779 808 844 856 869 895 910 911 950 1004 1008 1021 1030 1068 1088 1113 1120 
25 27 41 59 126 188 189 255 343 356 359 398 421 447 457 458 461 462 554 560 597 611 612 626 627 705 717 718 757 758 774 777 812 836 925 926 944 964 974 981 1111 
129 141 163 164 196 238 271 344 369 383 469 533 576 581 663 668 727 775 801 815 826 845 851 866 929 930 957 992 1010 1062 1079 1087 1128 1133 
22 153 180 200 293 310 357 379 406 407 414 416 449 451 500 553 653 683 697 698 711 721 729 752 924 959 962 970 991 1000 1038 1142 
45 56 57 220 376 377 394 433 435 436 440 450 463 481 489 490 561 598 603 635 636 637 650 719 724 749 813 893 912 1098 1130 1152 
8 51 66 67 75 103 104 263 266 372 400 477 478 492 516 582 607 640 660 728 733 753 759 1076 1121 
330 352 439 495 510 511 555 556 600 690 691 821 829 862 921 942 1024 1039 1066 1072 1119 1131 1132 1135 
33 115 120 161 170 171 219 384 418 419 423 474 542 557 613 713 751 915 934 940 951 
91 99 217 567 756 807 833 835 858 868 904 905 922 938 984 1007 1080 
175 176 229 362 415 434 454 517 526 527 681 763 796 877 969 978 
20 21 53 60 289 309 335 535 545 628 667 766 768 769 1025 
257 258 360 424 625 745 773 805 806 933 989 1040 1074 1095 1106 
94 149 190 441 442 455 534 704 771 883 887 888 988 1003 
202 466 467 573 679 706 762 782 855 927 
28 367 548 549 604 748 867 1082 
3 63 143 277 443 881 1116 
304 427 634 793 909 998 1081 
602 646 1061 1070 1090 1102 1149 
209 399 619 712 878 914 
283 342 361 575 605 886 
529 609 737 754 907 1144 
78 206 788 850 
