7 26 29 40 43 47 48 61 81 82 85 91 96 98 102 107 108 109 110 111 113 116 122 124 135 140 145 146 154 155 156 158 159 167 183 185 191 192 195 198 199 206 207 215 216 221 223 235 236 237 242 243 245 247 261 267 284 295 296 302 303 305 323 324 325 328 329 332 347 355 363 364 373 374 381 385 396 401 402 404 405 412 428 445 448 471 487 501 509 528 536 537 562 563 568 569 572 577 580 586 590 595 596 608 618 620 621 629 638 647 649 658 659 666 669 672 677 678 694 696 700 707 716 722 730 738 776 780 784 788 794 798 799 803 811 819 822 839 842 861 863 901 913 919 923 932 936 939 947 948 949 953 955 958 960 965 966 983 986 1002 1009 1014 1019 1022 1029 1032 1037 1045 1049 1063 1084 1096 1097 1101 1122 1124 1150 
1 8 10 18 30 32 38 39 42 44 46 58 62 65 70 71 74 75 76 79 80 89 101 105 118 130 131 132 147 148 157 162 168 169 174 178 181 186 193 194 197 218 222 225 226 246 249 252 262 264 275 276 278 286 287 288 297 298 300 313 318 320 334 340 341 348 349 353 378 382 386 387 392 395 417 420 423 426 456 494 496 498 499 506 512 513 514 520 530 539 540 566 578 591 603 642 645 661 688 720 732 734 739 741 751 772 783 787 802 825 828 830 873 896 915 935 967 985 990 1012 1015 1020 1043 1059 1060 1067 1069 1083 1098 1100 1105 1114 1127 1129 1138 1147 
14 22 52 94 149 166 175 176 180 190 200 202 229 230 231 293 310 338 339 357 398 406 407 414 415 416 427 431 441 442 449 451 454 455 459 460 464 466 467 500 526 527 532 534 553 573 579 632 633 653 681 697 698 704 711 713 721 729 752 758 762 763 771 777 781 782 796 844 883 887 888 890 909 924 944 951 959 962 964 970 978 988 991 998 1000 1003 1038 1142 
9 11 16 68 86 95 100 114 117 119 123 136 187 201 210 211 212 233 244 248 250 251 272 273 280 282 299 326 327 368 379 390 391 409 430 482 484 485 503 507 522 525 538 546 547 550 614 639 648 651 652 679 685 703 706 726 778 785 786 800 816 827 837 838 843 846 855 857 872 894 927 972 982 994 996 1001 1011 1046 1112 1118 1137 
50 90 137 184 240 254 260 265 316 317 380 393 399 411 413 432 465 468 470 473 515 523 524 541 552 559 565 592 599 610 615 616 641 643 644 670 676 686 695 795 809 814 823 834 848 852 853 860 889 891 892 897 898 917 952 956 963 975 977 995 999 1013 1028 1031 1041 1047 1048 1051 1052 1055 1056 1064 1086 1104 1117 1123 
2 23 24 36 37 49 97 106 144 179 203 224 227 232 239 253 266 279 285 321 322 410 472 493 497 504 505 508 551 558 570 630 631 657 665 673 680 682 683 687 701 709 736 789 797 810 831 880 902 937 943 945 946 954 992 1017 1018 1023 1035 1044 1058 1073 1077 1085 1094 1136 1139 1141 1145 
6 12 13 87 88 92 121 128 150 160 204 205 213 234 263 281 345 351 354 365 370 388 389 425 437 438 446 483 585 587 588 594 609 664 754 761 767 829 841 849 856 871 884 895 900 907 908 910 911 928 968 1004 1008 1021 1036 1068 1071 1087 1088 1092 1093 1107 1113 1120 1133 1134 
5 69 83 138 139 177 268 269 270 291 292 306 308 314 366 375 397 408 444 475 476 486 502 521 583 584 606 617 650 662 671 674 675 699 715 725 735 743 744 747 792 817 818 820 832 869 885 906 918 920 941 971 1006 1027 1033 1034 1042 1050 1054 1065 1108 1126 1140 1148 1151 
51 54 66 99 104 217 241 330 352 372 400 439 477 478 492 495 510 511 516 555 556 567 582 600 607 640 660 690 691 733 740 753 756 759 770 807 821 833 835 858 862 868 905 921 922 931 938 942 984 1007 1024 1039 1053 1066 1076 1080 1119 1121 1131 1132 1135 
0 55 64 77 93 103 125 127 133 134 172 274 290 311 312 333 336 337 377 418 422 429 433 452 453 481 519 531 543 544 545 601 623 625 654 708 710 731 746 750 755 764 765 804 854 859 870 875 899 903 989 993 997 1075 1109 1110 1115 1125 
4 17 21 25 27 28 41 53 59 126 173 188 189 196 255 289 309 319 343 344 356 359 371 383 421 457 458 461 462 554 560 597 612 626 627 628 689 705 717 718 728 757 760 766 774 812 836 840 916 925 926 961 974 981 987 1025 1072 1111 
31 78 129 141 152 153 163 164 238 271 362 369 434 469 517 518 529 533 564 576 581 663 668 719 727 737 775 801 815 826 845 850 851 866 877 929 930 950 957 969 973 1010 1030 1062 1079 1099 1128 1144 
15 19 33 72 73 115 120 142 151 161 165 170 171 208 219 277 307 315 331 358 384 403 419 474 479 480 488 542 557 571 613 656 684 692 693 779 790 808 881 934 940 1005 
34 60 84 256 257 258 259 283 301 342 346 360 361 424 447 535 575 593 605 611 655 742 745 773 805 806 879 886 933 1040 1074 1089 1095 1103 1106 1146 
67 214 228 294 350 367 491 548 549 604 622 624 702 723 748 824 847 867 874 882 904 976 1026 1057 1082 1091 
45 56 57 220 376 394 435 436 440 450 463 489 490 561 598 635 636 637 724 749 813 893 912 1130 1152 
3 20 63 143 335 443 667 768 769 1116 
574 602 646 714 1061 1070 1078 1090 1102 1149 
35 112 182 589 1016 1143 
304 634 791 793 876 1081 
209 619 712 878 914 
