26 29 40 47 48 55 61 67 81 82 85 91 96 98 102 107 108 113 116 120 122 135 140 142 145 146 154 155 156 158 159 166 167 171 185 186 191 192 195 198 199 206 207 211 215 216 221 223 224 236 237 242 243 244 245 247 261 267 277 284 295 296 303 305 323 324 325 328 329 341 355 363 364 367 381 385 396 401 402 404 405 412 428 429 433 445 466 471 473 481 487 491 501 509 514 528 529 536 537 549 562 563 568 569 572 577 580 586 590 592 595 596 604 618 621 624 629 638 647 649 654 658 659 666 669 677 678 694 696 700 702 707 716 722 723 730 737 738 771 776 780 784 788 794 798 799 800 803 811 819 822 823 824 835 839 842 854 856 861 863 867 869 881 913 919 923 936 939 947 948 949 953 958 965 972 974 983 985 986 988 1009 1014 1017 1018 1019 1022 1032 1037 1045 1063 1082 1084 1096 1097 1101 1112 1122 1124 1125 1144 1150 
1 10 16 18 19 28 30 32 38 39 42 43 44 46 58 59 62 65 70 71 72 73 74 75 76 79 80 89 101 105 118 130 131 132 147 148 157 162 165 168 169 174 178 181 193 194 197 210 218 222 225 226 246 249 252 262 264 275 276 278 282 286 287 288 297 298 300 313 318 320 334 340 348 349 353 368 378 382 386 387 392 395 417 420 423 426 456 485 494 496 498 499 503 506 512 513 520 530 539 540 566 641 642 645 661 688 689 720 732 734 739 741 751 772 783 787 790 802 825 828 830 840 846 873 896 915 935 967 990 994 1012 1015 1020 1041 1043 1049 1059 1060 1067 1069 1083 1100 1105 1114 1118 1123 1127 1129 1137 1138 1147 
2 24 37 45 50 90 97 137 144 179 184 203 228 253 254 260 265 266 285 316 317 346 354 371 380 393 399 413 432 434 465 469 470 483 515 523 524 541 552 559 565 571 599 610 615 616 630 631 643 644 670 676 682 686 687 695 709 736 748 795 801 809 814 831 834 845 848 852 853 860 871 878 882 889 891 892 897 898 902 916 917 930 945 952 956 975 977 995 999 1013 1023 1028 1031 1044 1047 1048 1051 1055 1056 1064 1079 1085 1086 1104 1139 
5 12 69 92 109 110 124 128 150 160 163 164 177 213 220 235 238 268 269 270 271 281 291 292 302 306 308 314 345 351 358 365 366 375 397 408 425 438 444 472 475 476 502 521 583 585 591 606 608 657 664 671 672 674 675 680 725 735 743 744 747 767 792 815 817 820 826 829 832 885 900 918 920 928 932 941 955 971 982 1027 1033 1034 1036 1050 1054 1065 1071 1107 1108 1126 1134 1140 1148 1151 
7 9 11 68 86 95 100 114 119 123 136 183 187 201 212 233 248 250 251 272 273 280 299 326 327 379 390 391 409 430 482 484 507 522 532 538 546 547 550 614 620 639 648 651 652 685 703 726 778 785 786 816 837 838 843 857 872 996 1011 1046 
14 22 52 175 176 180 200 229 293 310 338 339 357 406 407 414 415 416 427 431 449 451 455 459 460 464 500 526 527 553 579 588 632 633 653 681 697 698 711 721 729 763 796 844 887 888 924 959 960 962 970 978 998 1000 1003 1038 1142 
54 99 214 217 241 330 350 352 439 495 510 511 548 555 556 567 600 622 690 691 740 756 807 821 833 858 862 868 904 905 921 922 938 942 976 1007 1024 1026 1039 1042 1053 1066 1072 1080 1119 1131 1132 1135 
21 25 27 41 53 126 188 189 255 289 309 319 343 356 359 373 398 421 457 458 461 462 554 560 578 597 612 626 627 683 705 717 718 757 758 766 774 777 836 925 926 944 961 964 981 1025 1111 
6 202 204 205 234 263 446 454 467 534 573 587 594 609 679 706 728 754 761 762 770 781 782 855 890 895 907 910 911 927 968 1004 1008 1021 1068 1077 1088 1113 1120 
4 17 23 94 149 190 227 279 304 321 322 374 411 441 442 497 508 551 570 634 665 701 704 760 791 793 880 883 937 943 954 963 987 1035 1052 1058 1081 1145 
31 78 129 141 152 153 240 332 347 369 533 564 575 576 581 663 727 775 850 851 866 929 950 957 973 1010 1030 1062 1099 1128 
34 60 83 84 256 257 258 259 301 419 424 448 535 557 593 655 742 745 773 805 806 879 931 933 984 1040 1074 1095 1106 1146 
0 8 64 103 125 133 134 274 290 311 312 333 337 377 519 531 543 544 545 746 750 755 804 859 870 875 884 899 997 
77 93 111 127 172 331 336 418 422 447 452 453 601 611 623 625 708 710 731 764 765 903 909 989 993 1075 1109 1110 1115 
33 35 112 115 117 161 170 182 219 315 384 403 474 542 589 613 656 684 692 693 713 934 940 951 1005 1016 1143 
56 57 394 435 436 440 450 463 468 489 490 561 598 603 635 636 637 650 724 749 813 893 912 1098 1117 1130 1152 
36 49 106 232 239 410 493 504 505 668 752 789 797 810 901 946 991 992 1073 1094 1141 
51 66 104 294 372 400 477 478 492 516 582 607 640 660 733 753 759 847 1076 1121 
87 88 138 139 173 344 370 486 584 617 662 699 715 818 906 1006 
3 20 63 143 196 335 383 443 628 667 768 769 1116 
13 121 388 389 437 841 849 908 966 1087 1092 1093 1133 
362 517 518 558 673 812 874 876 877 969 1057 1091 1136 
15 151 208 231 307 479 480 488 779 808 1103 
574 602 646 714 1061 1070 1078 1090 1102 1149 
376 525 719 827 894 1001 1089 
283 342 360 361 605 886 
209 230 619 712 914 
