1 16 41 61 76 82 85 95 96 100 107 117 118 120 162 167 197 210 211 214 219 223 262 282 285 320 328 344 369 379 417 437 448 485 493 494 547 550 553 613 620 651 662 687 689 696 697 703 726 737 748 750 837 838 842 872 878 930 976 994 1096 1137 1144 
7 47 48 91 108 125 143 159 190 224 323 381 414 445 471 495 507 537 541 542 572 618 638 669 688 694 798 811 818 822 839 843 881 890 949 960 967 1074 1084 1097 1101 1150 
110 111 134 154 180 189 310 331 342 385 421 422 534 573 706 762 782 858 909 931 932 984 1000 1006 
12 101 114 345 378 409 410 425 490 538 546 672 673 699 743 744 778 874 876 895 945 1050 1136 
113 122 144 145 150 160 182 215 216 396 404 487 528 536 595 596 621 907 936 939 1143 
28 38 39 131 132 168 225 297 313 353 392 420 456 513 540 576 757 1037 1069 1147 
31 78 135 148 206 207 295 296 356 441 604 700 705 707 850 928 948 996 1095 1099 
69 90 121 136 165 250 292 314 375 390 428 674 675 813 886 919 920 977 982 1051 
8 10 15 18 51 151 158 169 311 332 400 478 558 591 642 660 739 753 935 
35 254 388 523 524 535 645 657 695 897 995 999 1017 1018 1021 1023 1083 1086 1104 
54 55 93 405 690 691 710 740 954 1035 1039 1053 1058 1078 1109 1110 1125 1131 1132 
166 174 232 234 370 446 533 832 910 911 955 957 1004 1008 1077 1113 1120 
5 273 302 309 319 439 503 623 637 652 656 940 987 1072 1094 1135 
26 27 157 193 252 364 520 622 663 859 904 905 990 1032 1111 
123 304 349 472 499 639 680 698 745 797 918 933 952 978 1043 
64 312 333 377 389 457 543 715 755 773 849 870 884 992 
30 261 366 449 556 814 853 947 1038 1059 1119 1127 1138 
83 84 247 300 593 654 655 733 795 879 889 1114 1146 
104 116 286 357 502 559 574 714 720 728 779 823 962 
2 172 429 587 736 756 835 845 846 1080 1085 1139 
6 29 40 86 115 188 196 242 243 373 374 628 
105 269 270 338 476 504 505 671 747 749 882 991 
183 213 280 281 365 438 585 664 767 829 900 1071 
398 416 588 713 758 774 777 944 951 964 998 1142 
22 97 129 179 266 496 581 631 709 817 851 
171 245 501 515 522 614 619 821 887 896 1045 
229 303 415 454 526 681 763 781 796 873 924 
32 130 181 440 529 578 597 741 833 1040 
87 399 413 469 470 609 800 801 871 1079 
19 72 241 244 264 702 790 894 1112 
81 199 474 568 857 937 959 969 986 
255 256 301 307 308 479 575 647 1103 
322 380 539 570 615 668 752 802 917 
339 431 459 460 482 579 844 923 1116 
355 382 444 606 775 815 908 974 1108 
99 803 804 807 868 922 1007 1060 
137 184 185 306 317 848 891 1048 
146 192 284 466 562 780 856 1014 
226 450 598 603 678 975 1098 1152 
3 20 63 140 204 443 727 
36 106 239 326 451 582 902 
66 141 152 153 279 383 612 
67 138 268 624 670 1027 1151 
68 74 178 387 506 530 985 
79 147 852 1028 1047 1067 1100 
228 267 434 751 783 812 828 
260 473 592 676 888 1003 1011 
265 465 468 514 892 912 1117 
352 599 600 641 722 1041 1123 
433 481 788 941 958 988 1148 
0 249 362 661 677 754 
21 903 993 997 1075 1115 
126 237 458 477 659 946 
163 164 220 238 271 826 
170 175 176 693 759 1121 
257 258 259 424 805 906 
327 343 583 869 1126 1140 
497 634 665 929 970 1128 
9 94 391 983 1046 
11 70 194 201 880 
13 810 966 1087 1133 
24 25 461 462 626 
34 60 128 557 1066 
42 186 350 475 1026 
57 360 455 489 636 
59 551 564 607 1145 
62 335 684 834 981 
73 217 288 318 321 
77 127 402 419 486 
112 403 549 692 1005 
142 491 569 723 1091 
212 222 290 545 566 
240 480 488 808 973 
274 519 531 816 899 
277 278 498 885 1020 
363 430 544 746 938 
372 527 717 718 824 
411 701 1033 1034 1054 
427 649 791 793 1081 
435 436 561 635 1130 
508 509 580 589 972 
627 683 827 925 1089 
4 17 227 760 
14 406 407 729 
33 44 787 1030 
43 200 246 721 
46 334 716 766 
49 359 554 789 
53 155 221 961 
65 251 351 565 
89 325 337 426 
92 149 704 1036 
109 291 617 1016 
139 336 708 809 
156 785 786 841 
173 584 630 916 
191 567 735 854 
230 316 552 914 
233 275 685 825 
236 305 1009 1019 
248 299 532 1015 
263 289 516 1076 
283 412 510 511 
298 423 915 1057 
329 484 648 772 
330 492 548 1042 
346 347 361 625 
401 742 875 913 
464 500 632 633 
521 605 898 971 
555 862 921 1024 
608 643 1055 1056 
610 650 1073 1141 
646 1061 1090 1149 
724 792 820 1022 
738 768 769 1065 
23 198 863 
45 367 616 
50 776 1013 
52 711 1049 
58 75 386 
80 324 358 
88 590 761 
98 276 1012 
102 512 901 
119 187 218 
124 447 611 
133 395 836 
177 794 860 
195 368 467 
202 203 1044 
209 712 934 
235 293 653 
287 784 830 
393 394 463 
397 943 953 
408 725 950 
442 771 883 
452 731 989 
517 518 877 
560 658 867 
577 732 1063 
602 1070 1102 
679 855 927 
730 799 819 
734 963 1052 
770 968 1031 
