7 47 48 108 125 144 159 190 224 319 323 381 414 438 471 495 507 537 541 542 572 618 669 688 694 767 798 811 822 839 843 890 947 949 953 967 1019 1074 1084 1097 1101 1150 
10 18 19 32 38 73 79 121 168 169 181 210 222 247 282 297 305 313 353 382 386 390 392 445 499 513 520 532 558 566 622 663 842 976 
25 41 61 78 95 107 120 130 167 219 223 285 303 320 328 377 448 485 493 550 620 662 687 689 703 748 773 781 820 833 924 1022 1096 1137 
5 273 302 309 439 503 637 652 656 673 874 877 987 1039 1094 1131 1135 1136 
15 104 151 158 357 389 502 529 571 574 578 597 720 728 779 962 1040 
30 105 270 291 366 440 449 504 556 642 671 814 853 1059 1119 1127 1138 
174 232 234 446 533 644 832 856 910 911 955 957 1004 1008 1082 1113 1120 
35 406 523 524 535 594 645 729 897 995 999 1021 1066 1076 1086 1104 
11 28 39 58 131 248 420 540 576 598 741 757 1037 1069 1147 
12 68 101 114 378 410 538 627 672 699 731 876 925 945 
22 63 109 129 138 204 266 492 496 624 670 807 851 922 
94 143 177 391 494 521 553 696 794 818 860 878 960 1046 
98 429 690 691 943 954 1035 1058 1061 1070 1090 1109 1110 1132 
36 326 408 451 505 518 582 602 603 810 902 1098 1102 
113 122 145 216 396 404 487 528 536 595 596 936 
4 92 149 150 213 215 281 664 704 883 1036 
20 27 40 140 154 188 235 573 628 727 1111 
71 124 180 268 342 385 422 443 762 782 858 
83 84 132 300 654 655 733 795 879 889 1114 
90 136 165 292 348 384 428 606 813 886 977 
146 173 192 466 584 711 753 780 916 1014 1049 
163 164 220 238 239 271 276 464 632 633 826 
338 339 416 431 432 459 579 588 778 844 1068 
0 249 257 258 298 362 661 677 754 805 
6 29 86 115 196 242 243 373 374 498 
14 189 534 706 770 968 1031 1073 1077 1141 
209 398 399 712 758 774 777 934 944 964 
241 265 465 468 514 751 855 892 912 1117 
91 99 293 803 804 868 1007 1012 1060 
207 295 296 356 705 707 708 928 948 
8 51 311 332 347 591 739 935 
21 261 447 682 903 993 1075 1115 
70 194 201 277 568 880 881 1020 
72 539 615 639 802 917 1043 1072 
77 127 161 402 418 419 486 940 
81 199 474 517 857 959 969 986 
123 304 472 506 680 745 797 952 
137 184 185 306 317 848 891 1048 
187 212 290 545 641 653 1041 1123 
255 301 307 308 479 575 647 1103 
397 433 481 788 941 958 988 1148 
407 450 617 678 692 975 1016 1152 
441 604 676 701 996 1033 1034 1142 
1 162 280 387 547 562 869 
2 500 587 736 845 1085 1139 
24 567 756 835 846 1030 1080 
26 193 364 859 905 990 1032 
52 228 267 434 783 812 894 
135 148 186 340 341 734 1095 
141 473 592 888 1003 1011 1015 
156 388 657 785 786 841 1083 
171 245 619 821 887 896 1045 
182 233 275 825 907 939 1143 
217 288 318 321 613 713 951 
314 375 674 675 919 920 1051 
9 66 67 400 478 660 
16 96 437 697 994 1038 
33 44 211 335 456 787 
37 253 310 354 548 1000 
65 251 351 563 565 586 
93 405 421 710 740 1053 
133 395 430 544 746 997 
139 229 370 415 526 763 
147 852 1028 1047 1067 1100 
166 262 738 768 769 1065 
244 264 461 462 593 1146 
260 312 333 849 870 884 
34 128 236 557 984 
53 155 221 380 1064 
59 256 551 607 1145 
60 85 344 1087 1133 
62 183 254 684 726 
69 543 681 749 982 
88 651 737 750 1144 
89 424 650 906 989 
97 179 631 709 817 
106 350 695 991 1026 
112 403 423 549 1005 
157 299 564 792 1054 
170 175 176 759 1121 
250 515 522 546 614 
327 343 583 1126 1140 
349 623 686 698 918 
352 599 600 722 724 
413 609 610 800 871 
425 743 744 895 1050 
435 436 561 635 1130 
442 458 666 667 771 
497 634 665 970 1128 
527 717 718 824 985 
611 612 646 930 1149 
17 227 279 760 
31 629 1099 1124 
46 334 716 766 
49 359 554 789 
54 55 1078 1125 
57 455 489 790 
64 715 791 1025 
75 809 1027 1151 
82 483 531 1042 
87 838 932 1006 
102 274 512 901 
111 331 909 998 
117 214 365 1071 
152 383 700 933 
191 735 854 1108 
225 417 840 1122 
237 626 872 946 
246 287 784 830 
283 412 510 511 
346 371 616 625 
376 525 719 1001 
409 605 898 971 
427 649 793 1081 
460 482 923 1116 
469 470 801 1079 
484 491 648 931 
555 862 921 1024 
577 732 836 1063 
608 643 1055 1056 
816 899 961 1013 
3 330 829 
23 198 337 
42 475 714 
43 200 721 
56 272 636 
74 368 1118 
76 325 426 
80 324 904 
118 178 837 
126 336 477 
160 345 490 
172 278 885 
197 226 519 
202 203 1044 
205 259 893 
263 289 516 
286 559 823 
315 316 552 
322 488 973 
329 772 915 
355 815 974 
358 530 638 
393 394 463 
411 963 1052 
444 775 908 
501 679 927 
509 589 799 
560 658 867 
570 668 752 
585 621 900 
590 761 863 
723 1057 1091 
755 983 1009 
1017 1018 1023 
