7 14 26 29 34 40 47 48 61 64 65 81 82 85 96 100 101 102 107 108 109 111 135 140 142 146 154 155 156 158 166 167 191 192 195 198 199 207 211 221 223 235 236 237 242 243 244 245 261 267 290 295 296 302 303 319 323 324 325 328 336 337 341 355 363 373 374 385 402 412 428 447 448 460 470 483 498 509 518 563 569 572 577 578 580 581 586 590 593 598 608 618 629 647 649 654 657 658 659 666 672 677 678 680 682 694 696 702 703 707 708 716 722 730 731 738 742 764 765 776 780 784 791 794 798 799 800 808 811 819 822 839 854 890 901 903 913 919 932 937 948 949 955 958 960 965 966 972 983 986 993 1009 1014 1019 1022 1032 1043 1045 1049 1063 1068 1075 1084 1096 1097 1101 1122 1146 
1 10 11 18 19 30 32 38 39 42 44 46 52 58 62 70 71 72 73 74 76 79 80 105 118 130 131 132 147 148 157 162 165 168 169 174 178 181 186 193 194 197 210 218 220 222 225 226 239 246 248 249 252 262 264 274 275 276 278 282 286 287 288 297 298 300 313 318 320 334 340 348 349 353 368 378 382 386 387 390 392 395 417 420 456 464 473 485 494 496 499 503 506 512 513 514 519 520 530 532 539 540 558 566 592 606 632 633 642 645 661 669 673 688 689 720 732 734 739 741 772 783 787 790 802 825 828 830 840 873 896 935 947 967 973 985 990 1012 1015 1037 1059 1060 1067 1069 1100 1105 1112 1114 1127 1129 1136 1137 1138 1147 
2 22 23 36 37 49 87 97 106 119 138 139 144 179 203 204 205 206 214 224 227 228 230 232 253 256 279 285 294 301 308 322 350 354 367 370 380 408 410 444 451 472 491 493 497 504 505 508 525 548 549 551 571 603 604 617 622 624 665 686 687 692 695 701 709 715 723 735 736 748 752 761 788 789 797 810 817 824 827 831 838 847 850 863 867 874 880 882 894 902 904 945 946 968 976 991 1001 1006 1017 1018 1023 1026 1044 1057 1077 1085 1089 1091 1094 1098 1108 1118 1139 1145 
8 9 17 50 51 63 66 67 75 90 103 104 137 143 184 240 241 260 265 266 316 317 333 346 371 377 393 400 411 413 426 465 468 477 478 492 515 523 524 541 542 552 559 565 582 591 599 607 610 615 616 631 640 643 644 660 670 676 733 753 759 760 795 803 809 814 834 848 852 853 860 870 871 891 892 897 898 917 952 956 963 975 977 987 995 999 1027 1028 1031 1047 1048 1051 1052 1055 1056 1064 1066 1072 1083 1086 1104 1117 1121 1151 
3 5 45 56 57 69 83 84 110 124 125 133 134 172 177 259 268 292 306 311 312 314 351 364 366 375 376 394 401 425 429 433 435 436 440 450 452 453 463 475 481 489 490 502 521 543 544 561 574 583 585 601 623 635 636 637 671 674 675 681 714 719 724 725 746 747 749 804 813 820 832 875 885 893 900 912 918 920 923 941 982 997 1115 1126 1130 1140 1148 1152 
12 13 175 176 180 200 229 231 270 291 293 310 338 339 357 406 407 414 415 416 421 427 431 432 449 459 500 526 527 553 579 626 683 697 698 711 721 729 763 766 836 844 872 889 909 924 928 962 970 974 978 998 1000 1038 1142 
16 20 21 25 27 41 43 53 59 60 126 188 189 255 289 309 335 343 356 359 457 458 461 462 531 545 554 560 573 597 611 612 627 628 667 705 717 718 728 745 757 768 769 773 812 823 925 926 933 981 994 1025 1074 1111 
4 33 94 115 120 149 161 170 171 190 213 219 281 321 329 384 418 419 438 441 442 455 474 534 557 570 613 664 700 704 713 751 755 767 771 855 879 883 887 888 915 927 934 940 951 959 988 1003 1065 1071 1082 1107 1134 
28 68 86 95 123 187 201 212 233 247 250 251 272 273 280 299 326 327 391 482 484 507 522 538 546 547 562 568 639 641 648 652 653 706 778 816 843 931 1020 1041 1046 1073 1123 1141 1150 
35 92 112 113 121 122 128 145 150 159 160 182 215 216 277 345 381 388 389 396 397 404 437 471 487 528 536 537 589 595 596 614 841 849 881 884 908 936 939 953 1016 1036 1092 1093 1143 
54 93 98 173 217 330 352 379 439 495 510 511 555 556 567 600 690 691 710 740 756 821 829 835 862 916 921 942 943 954 1024 1035 1039 1053 1058 1078 1109 1110 1119 1131 1132 1135 
114 116 117 183 254 263 284 315 358 365 403 409 423 430 620 621 630 638 651 656 684 693 726 743 744 785 786 792 837 857 971 996 1005 1011 1033 1034 1050 1054 
6 24 55 152 202 234 332 347 405 446 454 466 467 501 564 587 588 594 679 762 781 782 846 856 869 895 910 911 950 1004 1008 1021 1030 1088 1113 1120 1125 
78 129 196 331 344 369 383 469 533 576 668 727 801 807 851 922 930 992 1079 1087 1128 1133 
185 257 258 269 305 362 434 445 517 550 663 796 805 806 842 861 877 969 1040 1095 1106 
89 136 283 342 360 361 424 535 575 605 625 650 655 886 989 
91 99 153 372 516 770 833 858 868 905 938 984 1007 1076 1080 
0 31 77 88 127 422 443 750 859 899 961 1013 1099 1116 
141 163 164 238 271 775 815 826 845 866 929 957 1010 1062 
209 398 399 619 712 758 774 777 878 914 944 964 
15 151 208 307 476 479 480 488 685 779 1103 
486 584 662 699 818 906 1042 
602 646 1061 1070 1090 1102 1149 
304 634 793 876 1081 1124 
529 609 737 754 907 1144 
