0 1 2 3 4 5 6 7 8 9 10 11 12 13 14 15 16 17 18 19 20 21 22 23 24 25 26 27 28 29 30 31 32 33 34 35 36 37 38 39 40 41 42 43 44 45 46 47 48 49 50 51 52 53 54 55 56 57 58 59 60 61 62 63 64 65 66 67 68 69 70 71 72 73 74 75 76 77 78 79 80 81 82 83 84 85 86 87 88 89 90 91 92 93 94 95 96 97 98 99 100 101 102 103 104 105 106 107 108 109 110 111 112 113 114 115 116 117 118 119 120 121 122 123 124 125 126 127 128 129 130 131 132 133 134 135 136 137 138 139 140 141 142 143 144 145 146 147 148 149 150 151 152 153 154 155 156 157 158 159 160 161 162 163 164 165 166 167 168 169 170 171 172 173 174 175 176 177 178 179 180 181 182 183 184 185 186 187 188 189 190 191 192 193 194 195 196 197 198 199 200 201 202 203 204 205 206 207 208 209 210 211 212 213 214 215 216 217 218 219 220 221 222 223 224 225 226 227 228 229 230 231 232 233 234 235 236 237 238 239 240 241 242 243 244 245 246 247 248 249 250 251 252 253 254 255 256 257 258 259 260 261 262 263 264 265 266 267 268 269 270 271 272 273 274 275 276 277 278 279 280 281 282 283 284 285 286 287 288 289 290 291 292 293 294 295 296 297 298 299 300 301 302 303 304 305 306 307 308 309 310 311 312 313 314 315 316 317 318 319 320 321 322 323 324 325 326 327 328 329 330 331 332 333 334 335 336 337 338 339 340 341 342 343 344 345 346 347 348 349 350 351 352 353 354 355 356 357 358 359 360 361 362 363 364 365 366 367 368 369 370 371 372 373 374 375 376 377 378 379 380 381 382 383 384 385 386 387 388 389 390 391 392 393 394 395 396 397 398 399 400 401 402 403 404 405 406 407 408 409 410 411 412 413 414 415 416 417 418 419 420 421 422 423 424 425 426 427 428 429 430 431 432 433 434 435 436 437 438 439 440 441 442 443 444 445 446 447 448 449 450 451 452 453 454 455 456 457 458 459 460 461 462 463 464 465 466 467 468 469 470 471 472 473 474 475 476 477 478 479 480 481 482 483 484 485 486 487 488 489 490 491 492 493 494 495 496 497 498 499 500 501 502 503 504 505 506 507 508 509 510 511 512 513 514 515 516 517 518 519 520 521 522 523 524 525 526 527 528 529 530 531 532 533 534 535 536 537 538 539 540 541 542 543 544 545 546 547 548 549 550 551 552 553 554 555 556 557 558 559 560 561 562 563 564 565 566 567 568 569 570 571 572 573 574 575 576 577 578 579 580 581 582 583 584 585 586 587 588 589 590 591 592 593 594 595 596 597 598 599 600 601 602 603 604 605 606 607 608 609 610 611 612 613 614 615 616 617 618 619 620 621 622 623 624 625 626 627 628 629 630 631 632 633 634 635 636 637 638 639 640 641 642 643 644 645 646 647 648 649 650 651 652 653 654 655 656 657 658 659 660 661 662 663 664 665 666 667 668 669 670 671 672 673 674 675 676 677 678 679 680 681 682 683 684 685 686 687 688 689 690 691 692 693 694 695 696 697 698 699 700 701 702 703 704 705 706 707 708 709 710 711 712 713 714 715 716 717 718 719 720 721 722 723 724 725 726 727 728 729 730 731 732 733 734 735 736 737 738 739 740 741 742 743 744 745 746 747 748 749 750 751 752 753 754 755 756 757 758 759 760 761 762 763 764 765 766 767 768 769 770 771 772 773 774 775 776 777 778 779 780 781 782 783 784 785 786 787 788 789 790 791 792 793 794 795 796 797 798 799 800 801 802 803 804 805 806 807 808 809 810 811 812 813 814 815 816 817 818 819 820 821 822 823 824 825 826 827 828 829 830 831 832 833 834 835 836 837 838 839 840 841 842 843 844 845 846 847 848 849 850 851 852 853 854 855 856 857 858 859 860 861 862 863 864 865 866 867 868 869 870 871 872 873 874 875 876 877 878 879 880 881 882 883 884 885 886 887 888 889 890 891 892 893 894 895 896 897 898 899 900 901 902 903 904 905 906 907 908 909 910 911 912 913 914 915 916 917 918 919 920 921 922 923 924 925 926 927 928 929 930 931 932 933 934 935 936 937 938 939 940 941 942 943 944 945 946 947 948 949 950 951 952 953 954 955 956 957 958 959 960 961 962 963 964 965 966 967 968 969 970 971 972 973 974 975 976 977 978 979 980 981 982 983 984 985 986 987 988 989 990 991 992 993 994 995 996 997 998 999 1000 1001 1002 1003 1004 1005 1006 1007 1008 1009 1010 1011 1012 1013 1014 1015 1016 1017 1018 1019 1020 1021 1022 1023 1024 1025 1026 1027 1028 1029 1030 1031 1032 1033 1034 1035 1036 1037 1038 1039 1040 1041 1042 1043 1044 1045 1046 1047 1048 1049 1050 1051 1052 1053 1054 1055 1056 1057 1058 1059 1060 1061 1062 1063 1064 1065 1066 1067 1068 1069 1070 1071 1072 1073 1074 1075 1076 1077 1078 1079 1080 1081 1082 1083 1084 
406 432 459 508 622 623 749 838 942 979 1052 
37 65 78 83 160 163 166 179 293 354 355 383 384 403 405 504 553 579 595 615 627 657 658 676 690 711 721 724 726 866 894 936 954 977 1006 1063 
18 64 79 188 550 551 692 771 781 917 935 1034 1064 
63 94 98 103 117 181 198 202 211 228 252 263 267 328 353 392 492 582 601 720 750 776 800 801 802 804 805 806 807 839 882 887 899 968 997 1020 1037 1081 
468 473 739 741 743 744 745 746 793 797 858 859 860 861 862 863 
1016 1017 1018 1019 1020 1062 1063 1064 1081 1082 1083 1084 
359 360 361 362 653 654 655 659 660 661 662 663 664 666 675 677 679 680 686 1024 
13 26 33 34 201 218 298 331 353 354 357 485 574 636 652 663 765 768 793 795 801 
47 49 110 288 396 413 443 444 511 583 643 644 698 799 821 834 859 875 876 950 
107 108 113 158 159 244 258 259 280 340 457 458 487 531 532 556 557 566 567 587 648 653 686 700 701 744 788 789 824 853 863 873 893 1048 
100 118 129 197 275 276 360 361 428 431 481 610 635 671 676 893 955 956 987 988 1072 1078 
581 719 720 721 722 723 724 746 780 794 
511 614 615 616 617 618 619 620 621 622 623 624 625 626 627 628 629 630 837 839 840 841 842 843 844 845 
675 739 742 744 746 747 748 750 755 780 790 791 792 794 795 796 797 
17 18 180 181 183 184 185 186 187 188 189 190 191 192 194 195 196 197 199 200 201 202 203 204 205 505 512 513 802 805 1033 1036 1038 1039 1047 
206 507 508 758 782 785 786 910 985 1035 
65 70 85 90 140 141 142 143 144 145 146 147 148 149 150 151 152 153 154 155 156 157 158 159 160 161 162 163 164 165 166 167 168 169 170 171 172 173 174 222 234 288 289 290 291 292 293 294 295 326 327 328 329 330 331 332 333 360 380 381 382 419 431 489 490 491 492 493 494 495 496 554 555 556 601 604 606 608 672 673 674 676 677 678 679 681 682 683 685 694 696 697 762 763 881 882 1044 
171 172 287 359 360 361 362 363 364 365 366 367 368 369 370 371 372 373 374 375 376 377 378 379 380 381 382 417 827 875 992 
26 27 30 31 253 254 255 256 257 258 259 260 261 262 263 264 265 266 267 268 269 270 271 272 273 274 275 276 277 278 279 280 281 282 283 284 285 286 287 378 416 417 418 422 423 427 432 824 874 909 
6 12 13 17 18 19 22 265 522 709 710 712 714 819 
588 589 591 592 593 595 596 597 598 599 600 601 602 605 682 683 684 813 1021 
57 155 208 248 249 351 352 370 371 472 577 583 724 725 726 727 728 729 857 
179 180 182 183 185 195 392 471 472 532 533 534 535 536 650 651 652 653 727 728 
283 529 530 664 694 695 839 859 930 999 1035 
921 922 923 945 946 
450 452 453 460 464 465 466 467 469 471 473 475 480 482 
211 219 626 627 628 629 630 631 632 633 634 635 636 637 638 639 640 641 642 643 644 645 646 
324 325 439 440 441 442 443 444 445 694 695 696 697 721 722 751 862 863 
450 451 455 456 457 458 459 461 470 472 474 475 478 481 
103 104 105 106 107 108 109 110 111 112 113 114 115 116 117 118 119 120 121 122 123 124 125 242 260 338 339 340 341 342 343 344 345 346 347 348 349 350 351 423 424 425 426 427 428 429 430 431 432 648 649 650 651 652 797 798 843 900 
126 127 128 129 130 131 132 133 134 135 136 137 138 139 140 141 142 143 144 145 146 147 148 149 150 151 152 153 154 155 156 157 158 159 160 161 162 163 164 165 166 167 168 169 170 171 172 173 174 175 176 177 178 179 180 231 233 234 235 236 238 240 241 242 243 245 246 247 248 249 251 252 254 258 259 297 331 332 333 334 336 337 490 491 573 574 575 585 586 587 588 589 647 661 662 664 665 698 732 736 795 831 851 
90 91 94 95 326 329 520 521 522 523 524 525 526 527 556 557 558 559 560 561 562 563 564 565 579 580 581 582 583 584 
408 409 470 491 536 579 774 855 886 1010 
86 87 166 200 207 324 522 
214 215 230 252 269 405 421 453 593 800 
79 80 96 99 183 320 321 339 345 598 685 713 872 912 918 947 948 1049 1070 
55 56 83 100 101 128 138 141 144 145 146 154 155 156 167 177 182 193 204 244 245 246 247 262 280 281 326 327 375 376 398 402 403 419 452 475 476 482 483 506 530 559 563 565 566 609 699 702 708 752 760 771 786 792 801 804 873 911 914 927 985 994 1014 1023 1071 
107 108 127 253 254 276 277 282 455 456 573 646 1021 
179 180 199 224 364 520 809 810 890 901 958 1026 
71 92 377 378 436 448 521 550 590 660 862 
340 341 437 525 543 544 596 620 779 838 959 
291 292 361 368 468 669 681 748 765 910 1008 
561 562 627 628 811 858 997 
3 6 7 8 9 11 12 15 55 56 59 60 61 62 64 65 66 93 94 120 121 122 123 124 129 130 131 132 133 271 284 366 401 426 462 463 547 583 584 585 695 820 821 
56 57 435 436 481 489 490 561 635 636 637 724 813 893 912 
36 64 100 101 125 142 143 167 177 261 285 319 320 325 331 354 414 445 494 568 666 687 689 696 794 814 818 878 880 881 913 960 
54 55 98 99 217 272 273 326 439 503 510 555 556 567 602 603 652 690 691 710 740 741 756 821 835 846 854 862 921 954 971 1007 1012 1024 1039 1053 1060 1070 1078 1080 
69 71 72 99 105 106 231 269 270 291 292 293 314 338 339 348 394 428 431 432 443 449 459 460 475 504 505 521 579 587 588 606 671 674 675 717 747 749 790 803 804 807 820 833 844 868 882 919 920 922 938 991 995 1051 
59 60 61 62 63 64 65 66 67 68 69 70 71 72 73 74 75 76 77 78 79 80 81 82 83 84 85 86 87 88 89 90 91 92 93 94 95 96 97 98 99 100 101 102 103 104 105 106 107 108 109 110 111 112 113 159 161 162 163 164 166 167 168 169 170 171 172 173 174 175 176 177 178 179 180 183 184 225 254 255 256 257 258 260 261 334 335 374 375 438 439 440 441 442 476 478 492 493 494 495 496 519 547 552 590 622 623 657 
101 102 186 187 222 231 232 278 
294 295 353 372 403 435 584 656 681 774 875 
141 142 182 473 474 500 605 715 959 
27 28 37 80 94 95 285 624 851 1001 
84 85 91 220 309 339 340 619 620 706 750 754 1012 
267 322 323 484 613 614 692 802 847 848 
179 180 181 182 183 184 185 186 187 188 189 190 191 192 193 194 269 270 271 335 337 364 387 388 389 391 499 500 514 538 550 590 635 650 
329 330 349 350 446 464 465 475 480 481 483 488 489 493 494 500 503 509 524 526 531 533 542 551 554 569 570 574 577 578 582 585 586 588 599 602 603 606 612 613 614 616 617 618 621 622 624 625 626 629 630 637 638 644 651 652 653 661 674 679 680 682 687 689 690 692 693 698 700 703 706 707 711 715 716 719 722 723 731 739 743 744 745 747 749 754 759 762 764 773 785 808 816 817 822 828 832 836 845 846 852 860 861 867 868 869 887 903 905 906 909 913 916 917 919 922 924 927 932 933 937 950 965 968 972 974 976 977 1001 1015 1017 1022 1024 1028 1037 1039 1055 1056 1065 1080 
302 404 467 468 505 506 780 
36 111 123 135 140 198 201 223 233 235 236 237 244 245 272 273 296 324 326 327 328 336 359 370 379 390 391 482 503 507 509 522 547 556 603 608 639 643 648 649 652 667 696 700 703 706 716 738 810 811 816 965 1012 1019 1046 
260 311 312 337 389 426 437 543 544 682 746 849 870 884 907 993 997 
55 56 64 218 219 348 363 364 369 374 375 382 393 397 400 406 415 427 428 431 433 434 438 439 447 450 451 454 459 460 461 462 463 464 467 469 470 471 472 476 485 486 492 493 494 501 505 508 509 510 515 517 519 521 522 527 528 531 532 534 537 551 554 555 558 559 561 568 573 575 582 595 612 617 618 622 628 633 636 646 647 651 659 660 665 668 669 682 693 697 698 701 707 709 712 719 720 725 733 747 748 755 756 765 779 785 787 790 814 815 823 843 849 878 911 
68 69 108 109 114 115 116 127 131 215 216 234 235 289 290 298 304 337 338 359 360 365 380 388 421 429 482 506 535 579 585 596 634 637 703 704 729 763 777 778 899 
73 131 188 189 258 259 266 283 296 303 313 319 330 345 354 361 376 386 396 402 404 442 445 468 481 490 491 520 524 544 581 597 604 638 662 678 685 711 723 730 783 795 822 827 835 884 983 
334 335 377 424 425 448 449 489 615 616 663 681 734 768 782 808 837 840 892 
159 171 172 224 309 310 342 377 436 437 549 623 629 706 780 813 877 1026 
649 650 673 674 714 792 798 872 
