0 1 12 13 22 23 32 36 37 42 43 44 48 53 54 55 59 63 64 65 66 75 79 86 87 88 93 94 95 96 108 111 112 149 155 174 189 195 200 204 205 208 212 218 219 220 234 235 242 245 250 255 256 257 259 269 272 277 278 296 303 304 305 306 308 309 321 322 327 339 340 341 349 353 355 360 361 374 379 381 388 403 415 416 421 443 467 468 473 475 490 502 503 504 508 526 563 573 578 579 588 594 599 608 619 625 626 627 656 681 724 728 736 751 770 786 798 803 812 866 890 899 926 936 952 953 980 997 1029 1061 1070 1071 1106 1114 1138 1146 1147 1159 1160 1167 1168 1187 1213 1234 1247 1248 1270 1306 1310 1325 
6 7 25 34 35 40 58 67 73 74 76 80 81 84 85 123 132 142 148 168 169 177 190 291 314 315 328 329 346 398 401 402 408 412 424 464 466 484 515 516 519 545 546 547 584 585 607 629 649 663 667 668 686 700 745 758 775 792 807 832 844 865 867 875 900 942 948 994 1024 1032 1058 1085 1094 1102 1111 1124 1125 1137 1149 1162 1193 1202 1252 1260 1271 1273 1294 1332 1333 
8 9 20 101 102 124 146 187 188 202 203 211 216 217 221 229 230 246 247 252 262 263 276 319 320 332 333 334 345 354 357 365 399 431 435 440 441 476 491 492 505 550 551 558 560 561 592 622 632 635 698 733 735 753 754 756 766 783 823 852 860 862 870 935 975 981 987 995 1036 1038 1067 1087 1121 1129 1281 
10 31 56 57 69 70 120 125 126 131 135 158 172 173 236 237 248 268 288 294 352 428 429 430 434 461 539 595 636 638 648 737 742 841 851 861 863 897 933 941 951 969 976 996 1008 1020 1064 1073 1103 1141 1177 1194 1195 1206 1210 1223 1233 1243 1289 1300 
27 46 68 82 107 121 122 134 140 141 166 179 194 253 284 289 290 324 400 413 423 426 427 451 452 494 520 572 590 628 637 639 652 655 658 669 704 744 778 795 835 845 856 931 957 1007 1044 1045 1211 1212 1231 1348 
2 3 21 105 106 109 110 176 224 233 260 261 347 348 393 419 420 437 512 571 597 634 715 771 809 819 901 915 974 1142 1143 1183 1208 1275 1290 
4 5 26 30 33 45 97 98 133 152 161 180 243 244 254 271 279 301 302 453 454 498 577 598 687 693 802 818 910 932 944 985 1175 
127 128 136 137 170 171 191 192 223 264 265 460 477 478 486 487 542 564 616 623 624 691 692 710 721 1068 1107 1108 1112 1135 1241 1302 1347 
11 118 119 167 207 391 392 395 447 448 485 499 500 570 589 615 714 726 797 800 804 889 946 947 1042 1079 
258 293 318 338 350 356 367 383 548 549 557 582 583 604 609 696 869 893 940 978 1039 1178 
71 72 160 238 239 446 496 497 501 534 552 605 653 672 748 785 801 892 979 991 
103 104 156 196 197 251 472 541 676 703 705 706 727 904 905 922 982 1031 1060 1170 
77 144 145 175 201 209 210 281 282 569 591 898 914 1046 1051 1052 1063 1075 1105 
47 99 100 275 295 358 359 394 425 462 471 523 665 757 794 927 943 1021 
60 181 182 185 186 479 666 683 782 822 849 964 965 1054 1161 1199 
61 62 266 651 876 877 896 990 1001 1011 1100 1203 1259 1286 1318 1330 
206 249 342 514 643 644 732 811 848 857 1122 1145 1182 1189 1198 1349 
312 313 469 521 522 554 633 690 789 855 1014 1016 1055 1128 1163 
14 15 115 326 396 513 565 596 743 913 1004 1050 1236 1242 
28 29 139 370 444 465 532 659 671 699 764 810 937 1019 
153 154 225 226 369 386 387 600 903 1003 1056 1057 1169 1258 
162 163 389 390 417 418 538 707 708 763 820 945 1093 1186 
91 92 213 214 336 397 474 556 581 610 1040 1328 1329 
147 364 411 614 731 808 864 879 880 1065 1082 1083 1235 
555 567 568 739 740 741 854 956 1013 1059 1078 1152 1157 
646 647 805 806 826 868 1134 1158 1263 1276 1326 1335 1336 
215 310 311 325 362 438 439 459 562 654 882 1028 
164 165 414 576 580 630 631 814 816 878 1012 
193 323 376 470 511 821 925 972 1030 1049 1072 
351 422 784 902 954 988 993 1076 1077 1091 1240 
482 483 641 642 734 829 830 924 928 1084 1144 
38 50 404 405 919 1017 1062 1099 1278 1280 
41 524 675 774 961 1166 1229 1232 1350 1351 
117 316 317 372 373 445 755 1005 1034 1066 
157 593 612 613 791 873 911 1092 1109 1197 
198 199 270 297 298 335 533 958 959 973 
432 673 674 701 722 723 921 938 1043 1196 
51 52 227 228 442 992 1022 1023 1048 
183 184 337 611 709 759 1069 1130 1204 
283 529 530 664 694 695 930 999 1035 
299 300 537 601 749 750 1264 1319 1346 
16 457 488 489 779 780 1041 1118 
24 684 685 729 1172 1215 1279 1298 
78 493 661 662 970 989 1101 1136 
116 480 730 831 949 950 1015 1228 
368 506 702 765 781 817 1307 1308 
535 536 871 872 1037 1148 1265 1301 
650 725 796 824 912 1119 1120 1201 
679 680 1155 1164 1165 1288 1305 1331 
768 769 939 1179 1190 1274 1284 1316 
138 657 881 923 934 967 1171 
292 574 575 767 1113 1133 1345 
330 331 517 518 920 1018 1184 
378 746 747 752 773 815 1173 
382 384 531 843 883 1088 1089 
738 772 833 834 1150 1151 1257 
18 19 553 559 566 787 
83 285 307 375 688 1315 
89 90 222 1110 1140 1311 
129 130 606 891 1238 1239 
178 788 1080 1098 1237 1295 
240 241 273 274 385 929 
267 968 1025 1090 1230 1303 
280 846 847 888 1097 1192 
286 287 682 858 908 1249 
406 407 617 618 1205 1272 
409 527 528 718 840 1096 
463 495 640 697 971 1117 
543 544 916 1053 1123 1200 
713 1115 1254 1299 1343 1344 
1009 1010 1185 1191 1296 1297 
113 458 760 1139 1222 
371 983 984 1104 1342 
433 525 602 603 1081 
436 689 894 895 1006 
450 1086 1116 1156 1255 
587 1074 1217 1256 1293 
645 884 885 977 1277 
677 678 776 777 828 
711 712 842 1026 1027 
17 410 850 1291 
49 761 762 793 
231 232 507 1209 
455 456 670 1214 
586 837 838 1283 
620 621 716 717 
827 998 1154 1321 
853 1033 1262 1292 
874 886 887 1131 
962 963 1047 1269 
39 1224 1225 
114 813 909 
150 151 377 
159 1000 1176 
343 344 481 
363 380 966 
366 836 986 
449 1227 1320 
509 510 799 
540 1226 1285 
660 1216 1354 
790 1095 1180 
839 859 1317 
906 907 1246 
917 918 1304 
955 1327 1338 
960 1132 1282 
1002 1188 1324 
1126 1127 1174 
1153 1340 1341 
1218 1219 1312 
1220 1221 1287 
1244 1245 1261 
1253 1267 1268 
1266 1309 1334 
