0 1 2 3 4 5 11 21 44 45 46 47 48 49 50 52 53 54 75 102 123 146 148 150 158 159 160 161 162 164 166 169 178 208 209 211 220 221 222 225 227 258 272 279 280 309 344 345 347 352 354 355 356 357 358 359 361 365 420 423 426 456 471 472 476 477 478 479 488 491 493 498 499 504 520 540 598 599 600 618 625 657 672 673 720 753 772 773 779 786 793 802 804 805 819 822 835 848 849 908 
6 7 8 9 10 12 14 24 31 32 61 62 63 66 80 82 85 89 90 94 95 112 121 122 125 126 134 143 149 154 157 234 271 278 341 346 380 462 537 541 543 549 560 561 563 564 567 576 577 583 585 591 612 619 621 622 624 654 655 661 662 706 708 717 718 794 808 815 820 841 844 845 846 856 864 897 898 
72 96 97 98 99 128 175 176 415 428 507 508 509 510 511 512 513 557 558 570 572 573 574 575 578 586 587 637 688 699 791 865 
29 30 326 328 329 330 331 333 334 335 336 337 338 339 340 372 374 375 376 377 404 516 545 592 689 690 840 877 878 
51 56 60 65 93 141 163 165 444 463 506 529 538 544 601 611 719 746 747 749 752 765 780 803 812 813 814 836 
105 113 115 213 314 315 362 389 390 446 547 553 555 584 790 821 847 899 900 901 902 
310 405 620 641 642 643 644 645 646 647 648 649 658 659 660 667 816 817 818 
103 104 106 107 108 109 110 111 114 212 214 218 311 312 313 363 554 892 
136 246 247 248 251 252 254 256 259 261 562 566 640 759 833 862 870 
186 189 190 191 192 193 194 198 201 203 206 393 447 636 696 707 736 
187 188 196 200 205 348 351 406 407 408 409 410 412 776 903 909 
288 289 291 292 294 295 296 297 298 299 300 301 303 480 593 863 
17 23 204 223 224 226 579 580 806 807 825 
135 139 140 142 144 145 494 495 500 851 852 
172 173 174 177 360 464 465 694 710 754 755 
35 36 37 38 207 528 635 686 687 881 
249 250 253 257 260 304 306 714 731 867 
16 18 19 20 232 233 235 539 542 
81 83 84 86 87 88 116 548 550 
138 369 397 398 399 401 402 403 466 
210 371 473 474 475 609 610 697 698 
305 307 308 489 490 492 850 866 893 
147 273 274 275 364 448 449 843 
25 332 353 373 391 597 809 
71 73 127 496 559 571 796 
74 181 184 424 425 427 886 
76 137 457 458 459 460 461 
167 168 170 171 481 482 842 
197 342 343 787 789 837 838 
674 675 678 740 741 853 854 
129 130 131 132 133 695 
195 532 533 534 535 536 
236 237 238 240 241 242 
243 245 440 442 617 885 
266 267 268 269 270 839 
290 418 419 451 452 711 
384 385 386 483 484 525 
421 422 453 454 455 781 
15 59 400 748 751 
151 152 153 281 282 
228 229 230 485 486 
514 515 517 526 527 
521 703 704 705 797 
613 712 729 882 883 
623 626 627 628 629 
33 34 55 58 
67 68 231 761 
120 156 262 546 
180 182 183 185 
276 277 668 669 
318 320 321 322 
366 367 368 370 
439 441 443 834 
450 700 701 702 
676 677 770 771 
750 762 763 764 
22 349 869 
57 199 392 
64 124 244 
77 887 888 
155 283 284 
179 589 896 
202 350 497 
239 788 889 
255 565 713 
293 709 739 
319 588 590 
323 324 325 
327 760 871 
381 382 383 
394 395 396 
429 430 431 
434 435 445 
502 503 829 
522 523 524 
556 638 639 
650 651 652 
653 727 728 
722 723 724 
774 775 798 
777 778 792 
799 800 801 
826 827 828 
868 872 873 
874 875 876 
879 894 907 
