3 11 21 42 44 45 46 47 48 49 50 52 53 54 74 75 102 123 129 130 131 132 133 146 147 148 149 150 164 208 209 211 218 219 220 221 222 223 224 225 226 227 258 278 279 280 309 352 354 355 356 358 361 362 363 364 365 420 421 422 423 424 425 426 427 439 440 441 442 443 444 448 449 453 454 471 472 476 477 478 479 488 491 493 504 520 540 577 598 599 600 619 657 672 673 695 712 720 729 753 772 779 786 802 804 805 819 822 834 835 843 848 849 882 883 
6 7 8 9 10 12 14 24 32 61 62 63 66 80 82 83 85 89 90 94 95 112 116 121 122 125 126 134 143 154 157 158 159 160 161 162 166 234 341 346 357 359 456 462 537 541 543 549 560 561 563 564 567 583 585 591 612 618 621 622 624 654 655 661 662 706 708 717 718 773 794 808 815 820 841 844 845 846 856 864 897 898 
103 104 105 106 107 108 109 110 111 113 114 115 212 213 214 311 312 313 314 315 389 390 547 553 554 555 847 892 
51 56 60 64 65 93 141 163 165 210 244 463 529 544 601 611 719 746 747 749 752 765 803 812 813 814 836 
81 84 86 87 88 186 188 189 190 191 192 193 194 195 198 200 201 202 203 206 393 548 550 636 696 707 736 
30 236 237 238 240 241 242 326 327 328 330 334 335 336 337 338 339 374 516 545 760 871 
290 329 331 333 340 372 373 375 376 377 404 418 419 450 451 452 592 689 690 711 877 878 
288 289 291 292 294 295 296 297 298 299 300 301 302 303 480 593 675 740 853 854 863 
76 136 246 247 248 252 254 256 259 261 457 458 459 460 461 562 566 640 833 862 
71 73 99 127 128 176 494 495 496 500 558 559 570 571 573 586 637 688 796 
187 196 205 348 351 405 406 407 408 409 410 411 412 648 776 903 909 
135 139 142 144 145 249 250 253 257 260 304 306 714 731 867 
155 266 267 268 269 270 283 284 502 503 617 829 839 885 
43 72 97 172 173 174 175 177 360 415 464 465 694 
447 620 641 642 643 644 645 646 647 649 658 659 660 
17 23 204 579 580 674 678 741 806 807 825 
16 18 19 20 232 233 235 538 539 542 
138 369 397 398 399 400 401 403 466 
305 307 308 489 490 492 850 866 893 
96 98 557 572 578 614 615 699 
0 1 2 4 5 169 178 
25 26 332 353 391 597 809 
167 168 170 171 481 482 842 
228 229 230 485 486 487 795 
532 533 534 535 653 727 728 
574 575 587 613 874 875 876 
37 635 899 900 901 902 
120 156 262 455 546 781 
271 272 273 274 275 702 
310 667 799 800 801 816 
342 344 345 347 838 908 
384 385 386 483 484 525 
151 152 153 281 282 
197 343 787 789 837 
366 367 368 370 791 
473 474 475 697 698 
514 515 517 526 527 
623 626 627 628 629 
15 59 748 751 
33 34 55 58 
35 38 687 881 
67 68 231 761 
140 402 851 852 
179 182 589 896 
276 277 668 669 
318 320 321 322 
380 381 382 383 
428 507 513 865 
446 584 790 821 
676 677 770 771 
750 762 763 764 
22 349 869 
29 31 840 
36 207 528 
57 199 392 
77 887 888 
124 243 245 
137 499 625 
181 184 886 
239 788 889 
251 759 870 
255 565 713 
293 709 739 
319 588 590 
323 324 325 
371 609 610 
394 395 396 
434 435 445 
498 576 793 
505 506 780 
522 523 524 
556 638 639 
650 651 652 
703 704 705 
710 754 755 
722 723 724 
774 775 798 
777 778 792 
826 827 828 
868 872 873 
879 894 907 
