0 1 2 3 4 5 11 21 44 45 46 47 48 49 50 52 53 54 102 123 129 130 131 132 133 146 148 150 158 159 160 161 162 164 166 169 178 208 209 211 220 222 225 227 258 272 274 275 279 280 309 344 345 347 352 354 355 356 358 359 361 362 363 364 365 420 423 426 439 440 441 442 443 456 471 472 476 477 478 479 488 491 493 504 520 540 577 598 599 600 619 657 695 712 729 753 772 773 779 786 802 804 805 819 822 834 835 849 882 883 908 
6 7 8 9 10 12 14 24 27 28 61 62 63 66 80 82 83 84 85 89 90 94 95 112 116 121 122 125 126 134 143 149 154 157 234 271 278 341 346 357 462 537 541 543 549 560 561 563 564 567 583 585 591 612 618 621 622 624 661 662 708 717 718 794 808 815 820 844 845 846 856 864 897 898 
29 30 326 327 328 329 330 331 333 334 335 336 337 338 339 340 372 374 375 376 377 516 545 592 689 690 760 840 871 877 878 
57 81 86 87 88 186 188 189 190 191 192 193 194 195 198 199 200 201 202 203 206 392 393 548 550 636 696 707 736 
71 72 73 96 97 98 99 127 128 175 176 415 496 557 558 559 570 571 572 573 574 575 578 586 587 637 688 699 796 
51 56 60 64 65 93 141 163 165 210 244 444 463 505 506 529 544 546 601 719 765 780 812 813 814 836 
288 289 291 292 294 295 296 297 298 299 300 301 302 303 480 593 675 678 740 741 853 854 863 
37 105 113 115 314 315 389 390 446 547 553 555 584 635 686 790 821 847 899 900 901 902 
103 104 106 107 108 109 110 111 114 212 213 214 218 311 312 313 554 892 
136 246 247 248 249 251 252 254 256 259 261 562 566 640 759 833 862 870 
412 447 620 641 642 643 644 645 646 647 649 658 659 660 
187 205 351 405 406 407 408 409 648 776 903 909 
42 43 172 173 174 177 360 464 465 694 848 
290 373 404 418 419 450 451 452 467 468 711 
16 18 19 20 232 233 235 538 539 542 
611 746 747 749 750 752 762 763 764 803 
204 223 224 226 579 580 674 806 807 
250 253 257 260 304 306 714 731 867 
305 307 308 489 490 492 850 866 893 
428 507 508 509 510 511 512 513 865 
138 369 397 398 399 401 403 466 
266 268 269 270 502 503 829 839 
25 26 332 353 391 597 809 
35 36 38 207 528 687 881 
74 181 184 424 425 427 886 
167 168 170 171 481 482 842 
196 219 221 410 411 672 673 
197 342 343 787 789 837 838 
31 32 654 655 706 841 
76 457 458 459 460 461 
135 139 142 144 145 500 
147 273 448 449 702 843 
236 237 238 240 241 242 
310 667 799 800 801 816 
384 385 386 483 484 525 
421 422 453 454 455 781 
613 614 615 874 875 876 
15 59 400 748 751 
75 124 243 245 720 
151 152 153 281 282 
228 229 230 485 486 
318 319 320 321 322 
366 367 368 370 791 
473 474 475 697 698 
514 515 517 526 527 
623 626 627 628 629 
33 34 55 58 
67 68 231 761 
140 402 851 852 
179 182 589 896 
276 277 668 669 
380 381 382 383 
532 533 534 535 
676 677 770 771 
17 23 825 
22 349 869 
77 887 888 
120 156 262 
137 499 625 
155 283 284 
239 788 889 
255 565 713 
267 617 885 
293 709 739 
323 324 325 
348 350 497 
371 609 610 
394 395 396 
434 435 445 
498 576 793 
522 523 524 
556 638 639 
650 651 652 
653 727 728 
703 704 705 
710 754 755 
722 723 724 
774 775 798 
777 778 792 
826 827 828 
868 872 873 
879 894 907 
