3 21 44 102 103 110 130 131 132 133 246 247 248 249 250 252 253 255 256 257 258 259 260 261 266 272 276 277 295 352 354 358 361 423 439 440 441 442 443 472 478 489 490 491 492 493 494 495 496 498 513 561 562 563 564 565 567 576 593 616 640 668 669 714 753 754 755 760 779 793 796 804 805 815 822 833 834 835 849 866 
8 12 13 14 16 60 61 65 66 93 94 95 105 106 108 109 112 114 125 126 149 160 212 214 271 296 318 323 325 345 380 456 463 554 555 558 560 611 621 622 624 655 706 708 719 746 747 748 749 751 752 836 856 892 897 908 
0 1 2 4 5 178 288 289 290 294 297 298 299 301 326 327 328 329 330 331 332 333 334 335 337 338 339 340 372 373 374 375 376 377 404 730 871 877 878 
50 51 52 53 54 123 134 141 146 148 150 192 208 209 219 227 273 278 279 280 364 444 448 449 504 588 598 599 600 601 702 707 750 802 803 813 814 843 
87 186 187 188 194 195 196 197 200 201 202 203 205 206 348 350 351 405 406 407 408 409 410 411 447 497 648 696 736 776 837 903 909 
17 18 19 20 22 56 64 129 220 234 244 319 320 321 366 368 369 370 399 401 403 589 695 825 
107 122 151 152 154 155 156 157 281 282 363 420 421 422 453 454 455 488 781 845 846 
62 90 169 232 283 284 362 365 424 425 426 427 446 577 584 585 790 794 820 821 
72 97 127 128 175 176 357 415 557 570 572 573 574 575 578 586 587 739 791 819 
37 113 115 121 314 315 389 390 612 635 686 847 899 900 901 902 
6 7 9 10 11 15 228 229 292 485 486 487 808 844 864 
304 305 306 307 308 309 310 667 713 731 799 800 801 867 893 
179 181 182 184 392 418 419 450 451 452 471 711 886 896 
33 34 233 235 291 537 538 539 540 541 542 543 591 
63 236 237 238 239 240 241 242 324 545 717 718 889 
211 341 583 613 661 662 765 787 789 874 875 876 898 
80 81 82 84 85 86 88 89 548 549 550 904 
42 43 172 173 174 177 360 464 465 694 710 
100 101 436 437 438 631 632 633 634 850 880 
147 221 222 223 224 225 226 579 580 672 673 
158 159 161 162 163 164 165 166 359 544 773 
412 620 641 643 644 645 646 649 658 659 660 
189 190 191 193 198 199 204 393 806 807 
300 303 674 675 678 740 741 853 854 863 
45 46 47 48 49 476 477 657 848 
355 428 507 508 509 510 511 512 865 
35 36 38 207 528 687 881 
76 136 457 458 459 460 461 
473 474 475 609 610 697 698 
24 25 26 27 28 391 
71 73 99 500 559 571 
96 98 516 614 615 699 
153 342 344 346 347 480 
180 532 533 534 535 536 
302 467 468 505 506 780 
322 553 712 729 882 883 
384 385 386 483 484 525 
29 31 32 654 841 
59 462 762 763 764 
104 213 262 619 642 
124 243 245 689 690 
143 144 269 270 839 
167 168 170 171 842 
210 371 529 597 809 
514 515 517 526 527 
521 703 704 705 797 
623 626 627 628 629 
647 812 816 817 818 
67 68 231 761 
117 118 119 501 
135 139 142 145 
251 479 870 884 
293 590 618 709 
397 398 402 466 
592 868 872 873 
676 677 770 771 
732 733 734 735 
23 343 786 
55 57 58 
74 75 720 
77 887 888 
83 116 656 
120 546 547 
137 499 625 
140 851 852 
254 759 862 
267 617 885 
311 312 313 
336 349 869 
367 520 838 
381 382 383 
394 395 396 
429 430 431 
434 435 445 
502 503 829 
522 523 524 
556 638 639 
636 637 688 
650 651 652 
653 727 728 
722 723 724 
774 775 798 
777 778 792 
826 827 828 
879 894 907 
