3 21 44 102 103 104 108 110 130 131 132 133 246 247 248 249 250 251 252 253 255 256 257 258 259 260 261 266 271 272 274 275 276 277 352 354 358 361 423 439 440 441 442 443 472 478 489 490 491 492 493 494 495 496 498 513 561 562 563 564 565 566 567 576 616 640 668 669 714 753 755 760 772 779 792 793 796 804 805 815 822 833 834 835 849 866 
8 12 13 14 16 60 61 62 65 66 90 93 94 95 105 106 109 112 114 125 126 149 160 212 214 232 283 296 319 323 325 345 380 456 463 554 555 558 560 577 585 609 610 611 621 622 624 655 706 708 719 746 747 748 749 751 752 794 820 825 836 856 892 897 908 
288 289 290 294 297 298 299 301 302 326 327 328 329 330 331 333 334 335 337 338 339 340 373 374 375 376 377 404 467 468 593 730 871 877 878 
87 186 187 188 194 195 196 197 200 201 202 203 205 206 351 405 406 407 408 409 410 411 412 447 644 648 696 736 776 837 903 909 
6 7 9 10 11 15 189 190 191 193 198 199 204 228 229 292 393 485 486 487 674 806 807 808 844 864 
72 97 127 128 175 176 357 415 557 570 572 573 574 575 578 586 587 613 614 615 739 791 819 
50 51 52 53 54 123 134 141 192 208 209 444 504 588 598 599 601 707 750 813 814 
107 122 151 154 155 156 157 363 420 421 422 453 454 455 488 781 845 846 
63 121 236 237 238 239 240 241 242 324 503 545 612 717 718 829 889 
33 34 233 235 291 537 538 539 540 541 542 543 591 
80 81 82 84 85 86 88 89 548 549 550 904 
147 219 221 222 223 224 225 226 579 580 672 673 
179 181 182 184 418 419 450 451 452 711 886 896 
211 341 583 661 662 765 787 789 874 875 876 898 
304 305 306 307 308 309 310 667 713 731 867 893 
100 101 436 437 438 631 632 633 634 850 880 
113 115 314 315 389 390 847 899 900 901 902 
158 159 161 162 163 164 165 166 359 544 773 
17 18 19 20 22 234 318 320 321 589 
35 36 37 38 207 528 635 686 687 881 
56 64 129 220 244 399 401 403 695 
146 148 150 227 278 279 280 449 843 
0 1 2 4 5 178 332 372 
45 46 47 48 49 476 477 657 
172 173 174 177 360 464 465 694 
210 366 369 370 371 529 597 809 
355 507 508 509 510 511 512 865 
641 643 645 646 649 658 659 660 
167 168 170 171 481 482 842 
284 424 425 426 427 584 821 
303 675 678 740 741 853 863 
24 25 26 27 28 391 
71 73 99 500 559 571 
76 457 458 459 460 461 
153 342 344 346 347 480 
180 532 533 534 535 536 
322 553 712 729 882 883 
384 385 386 483 484 525 
29 31 32 654 841 
59 462 762 763 764 
124 243 245 689 690 
140 397 398 402 466 
169 362 365 446 790 
267 269 617 839 885 
293 590 618 620 709 
473 474 475 697 698 
514 515 517 526 527 
521 703 704 705 797 
623 626 627 628 629 
647 812 816 817 818 
67 68 231 761 
96 98 516 699 
117 118 119 501 
135 139 142 145 
136 254 759 862 
213 262 619 642 
273 364 448 702 
336 348 349 869 
428 429 430 431 
592 868 872 873 
676 677 770 771 
732 733 734 735 
23 343 786 
42 43 848 
55 57 58 
74 75 720 
77 887 888 
83 116 656 
120 546 547 
137 499 625 
143 144 270 
152 281 282 
268 400 502 
295 710 754 
311 312 313 
367 520 838 
368 851 852 
381 382 383 
394 395 396 
434 435 445 
479 870 884 
505 506 780 
522 523 524 
556 638 639 
600 802 803 
636 637 688 
650 651 652 
653 727 728 
722 723 724 
774 775 798 
799 800 801 
826 827 828 
879 894 907 
