3 21 44 64 67 68 102 124 129 130 131 132 133 231 244 246 247 248 249 250 251 252 253 255 256 257 258 259 260 261 266 272 293 331 352 354 356 357 358 361 423 472 478 489 490 491 492 493 494 495 496 498 520 561 562 563 564 565 566 567 590 592 618 620 640 689 690 695 709 714 720 722 723 724 730 753 761 768 769 772 779 793 804 805 815 819 822 833 835 849 866 868 872 873 
8 12 13 14 16 17 18 19 33 34 60 61 65 93 94 95 112 125 126 149 160 233 235 291 296 318 319 320 321 323 324 325 345 456 463 537 538 539 540 541 542 543 560 591 611 621 622 623 624 626 627 628 629 655 706 708 719 746 747 748 749 750 751 752 757 758 825 836 856 897 908 
23 187 188 194 196 197 202 203 205 206 343 348 351 405 406 407 408 409 410 412 447 576 641 643 644 645 646 648 649 658 659 660 676 677 696 736 770 771 776 786 837 903 909 
0 1 2 4 5 137 178 288 290 301 302 326 327 328 330 332 333 334 335 337 338 339 340 353 372 373 374 375 376 377 404 467 468 499 505 596 597 625 760 809 855 871 
59 107 122 151 152 154 155 156 157 210 268 281 282 363 366 368 369 370 371 420 421 422 453 454 455 462 488 529 581 582 762 763 764 781 845 846 851 852 
63 96 98 236 237 238 239 240 241 242 362 364 365 367 446 502 503 514 515 516 517 526 527 545 614 615 699 717 718 774 775 790 791 798 829 838 889 
50 51 52 53 54 123 141 192 208 209 271 273 274 275 448 504 506 588 598 599 600 601 707 780 802 803 813 814 826 827 828 890 891 899 900 901 
71 72 73 97 99 127 128 172 173 174 175 176 177 360 413 414 415 464 465 556 557 558 559 570 571 572 573 574 575 578 586 638 639 694 710 739 
153 158 159 161 162 163 164 165 166 211 329 341 342 359 394 395 396 544 583 619 661 662 765 773 787 789 874 875 876 877 878 879 894 898 902 907 
76 77 134 135 136 138 139 140 142 145 254 384 385 386 397 398 399 401 402 403 457 458 459 460 461 466 483 484 525 759 788 862 887 888 
103 104 105 106 108 109 110 114 120 212 213 214 262 311 312 313 322 434 435 445 546 547 553 554 555 587 613 616 642 712 729 882 883 892 
62 66 74 75 90 113 115 121 232 314 315 389 390 400 424 425 426 427 473 474 475 577 584 585 609 610 612 697 698 794 820 821 847 
78 79 143 144 267 269 270 283 284 304 305 306 307 308 309 310 344 346 347 480 500 667 713 731 799 800 801 839 867 893 
6 7 9 10 11 15 20 56 204 220 228 229 230 234 292 485 486 487 579 580 589 674 795 806 807 808 844 864 
55 57 58 87 186 189 190 191 193 195 198 199 200 201 393 532 533 534 535 536 650 651 652 653 727 728 
80 81 82 83 84 85 86 88 89 116 117 118 119 501 548 549 550 656 732 733 734 735 904 
111 146 147 148 150 218 219 221 222 223 224 225 226 227 278 279 280 411 444 449 672 673 843 
289 294 295 297 298 299 300 303 476 593 675 678 740 741 754 755 853 854 863 
355 428 429 430 431 507 508 509 510 511 512 513 865 
22 29 30 31 32 336 349 654 840 841 869 
100 101 436 437 438 631 632 633 634 850 880 
179 180 181 182 183 184 185 392 471 886 896 
35 36 37 38 207 528 635 686 687 881 
42 43 45 46 47 48 49 477 657 848 
243 245 439 440 441 442 443 617 834 885 
418 419 450 451 452 700 701 702 711 
521 522 523 524 703 704 705 796 797 
167 168 169 170 171 481 482 842 
24 25 26 27 28 391 
647 812 816 817 818 
276 277 668 669 
380 381 382 383 
479 870 884 
636 637 688 
777 778 792 
