246 247 248 249 250 251 252 253 254 255 256 257 258 259 260 261 561 562 563 564 565 566 567 640 713 714 731 759 772 815 833 870 
290 326 327 328 329 330 331 332 333 334 335 336 337 338 339 340 372 373 374 375 376 377 391 545 689 690 871 877 878 
102 103 104 105 106 107 108 109 110 111 112 113 114 115 212 213 214 262 311 312 313 547 553 554 555 847 892 
146 147 148 149 150 218 219 220 221 222 223 224 225 226 227 278 279 280 444 448 449 504 579 580 672 673 843 
43 96 97 98 99 128 172 173 174 175 176 177 360 415 464 465 558 688 694 699 710 791 
188 194 196 197 202 203 205 206 348 349 350 447 696 736 837 869 909 
57 186 189 190 191 192 193 198 199 200 201 204 393 707 806 807 
80 81 82 83 84 85 86 87 88 89 90 548 549 550 656 904 
288 289 291 292 294 295 296 297 298 299 300 301 303 480 593 863 
304 305 306 307 308 309 310 667 799 800 801 816 817 818 867 893 
8 9 56 59 61 121 126 366 367 370 462 808 820 821 844 
42 44 45 46 47 48 49 211 476 477 478 479 577 657 848 
153 341 342 343 344 346 347 516 559 576 787 789 838 898 
94 95 233 235 537 538 539 540 541 542 543 544 591 
3 439 440 441 442 443 456 760 793 834 835 849 
158 159 160 161 162 163 164 165 166 359 765 773 
187 351 405 406 407 408 409 410 411 412 776 903 
641 642 643 644 645 646 647 648 649 658 659 660 
100 101 436 437 438 631 632 633 634 850 880 
13 345 622 746 747 749 751 752 884 908 
17 20 23 318 319 320 321 322 589 825 
35 36 37 38 207 528 635 686 687 881 
420 421 422 423 453 454 455 488 779 781 
62 66 155 283 284 583 584 585 794 
63 141 529 546 717 718 812 813 814 
120 123 129 130 131 132 133 695 750 
125 352 353 354 356 357 358 819 897 
134 135 139 140 142 143 144 145 560 
355 507 508 509 510 511 512 513 865 
369 397 398 399 400 401 402 403 466 
6 7 10 11 12 14 15 748 
16 18 19 21 22 232 234 426 
50 51 52 53 54 208 209 210 
76 136 137 457 458 459 460 461 
127 557 570 572 573 575 586 587 
167 168 169 170 171 481 482 842 
179 180 182 183 184 185 886 896 
228 229 230 485 486 487 795 864 
236 237 238 239 240 241 242 889 
384 385 386 483 484 525 856 862 
598 599 600 601 611 802 803 822 
621 623 624 625 626 627 628 629 
266 267 268 269 270 502 839 
302 404 467 468 505 506 780 
494 495 496 497 498 499 500 
674 675 678 740 741 853 854 
0 1 2 4 5 178 
60 65 93 463 719 836 
71 72 73 571 574 578 
122 151 154 157 845 846 
156 361 362 363 364 365 
181 418 419 451 452 711 
195 532 533 534 535 536 
489 490 491 492 493 866 
616 712 729 730 882 883 
24 25 26 27 28 
29 30 32 840 841 
116 117 118 119 501 
271 272 273 274 275 
293 588 590 709 739 
387 388 606 607 608 
446 774 775 790 798 
473 474 475 697 698 
514 515 517 526 527 
520 521 522 523 524 
676 677 770 771 786 
681 682 683 737 738 
703 704 705 796 797 
33 34 55 58 
39 40 41 721 
67 68 231 761 
243 245 617 885 
276 277 668 669 
314 315 389 390 
323 324 325 708 
371 609 610 612 
380 381 382 383 
428 429 430 431 
450 700 701 702 
551 552 715 716 
592 868 872 873 
664 665 666 784 
670 671 742 743 
732 733 734 735 
64 124 244 
69 70 630 
74 75 720 
77 887 888 
152 281 282 
215 216 217 
263 264 265 
285 286 287 
368 851 852 
378 379 602 
392 471 472 
394 395 396 
424 425 427 
434 435 445 
469 470 785 
556 638 639 
568 569 663 
603 604 605 
613 614 615 
618 619 620 
650 651 652 
653 727 728 
661 662 902 
679 680 861 
691 692 693 
722 723 724 
725 726 895 
744 745 756 
753 754 755 
762 763 764 
777 778 792 
826 827 828 
830 831 832 
874 875 876 
879 894 907 
899 900 901 
