0 3 11 15 266 269 276 277 331 342 344 346 347 439 440 441 442 443 456 480 520 521 522 523 524 592 613 616 618 620 668 669 712 720 729 730 760 777 778 786 792 793 834 835 838 839 849 868 882 883 884 
8 9 55 56 59 60 61 65 93 120 121 122 123 126 129 130 131 132 133 151 154 157 270 296 318 366 369 370 401 462 463 695 719 808 820 821 825 836 844 845 846 
246 247 248 249 250 251 252 253 254 255 256 257 258 259 260 261 561 562 563 564 565 566 567 640 713 714 731 759 772 815 833 870 
102 103 104 105 106 107 108 109 110 111 112 113 114 115 212 213 214 262 311 312 313 553 554 555 847 892 
146 147 219 220 221 222 223 224 225 226 227 279 280 351 410 411 412 448 504 672 673 843 903 
304 305 306 307 308 309 310 489 490 491 492 493 667 799 800 801 816 817 818 850 866 867 893 
290 301 326 327 328 330 332 333 334 335 337 338 339 340 372 373 374 375 376 377 391 871 
96 97 99 125 128 175 176 352 353 354 356 357 358 558 688 709 739 791 819 897 
24 27 28 76 134 135 136 137 139 142 143 144 145 457 458 459 460 461 560 
57 186 189 190 191 192 193 198 199 200 201 204 206 393 636 637 707 806 807 
63 141 503 505 506 529 546 579 580 717 718 780 812 813 814 829 899 900 901 
80 81 82 83 84 85 86 87 88 89 90 548 549 550 656 904 
329 341 343 516 559 689 690 787 789 874 875 876 877 878 898 
42 44 45 46 47 48 49 476 477 478 479 577 657 848 
153 619 641 642 643 644 645 646 647 649 658 659 660 
13 345 622 746 747 748 749 750 751 752 908 
20 94 95 537 538 540 541 542 543 544 591 
43 172 173 174 177 360 415 464 465 694 710 
74 75 181 418 419 424 425 427 451 452 711 
155 159 164 165 394 395 396 762 763 764 765 
188 196 202 203 348 349 350 447 696 736 869 
35 36 37 38 207 528 635 686 687 881 
100 101 436 437 438 631 632 633 634 880 
187 205 405 406 407 408 409 648 776 909 
236 237 238 240 241 242 367 446 545 790 
371 474 475 597 609 610 612 697 698 809 
50 51 52 53 54 208 209 210 211 
314 315 389 390 455 473 588 601 781 
29 31 32 654 655 706 840 841 
158 160 161 162 163 166 359 773 
179 182 184 621 624 625 886 896 
228 229 230 485 486 487 795 864 
289 291 294 297 298 299 539 593 
355 428 507 508 509 510 511 512 
420 421 422 423 453 454 488 779 
17 23 319 320 321 322 589 
71 72 73 571 574 575 578 
148 149 150 218 278 444 449 
180 195 532 533 534 535 536 
300 303 674 678 740 741 863 
494 495 496 497 498 499 500 
62 283 284 400 547 794 
127 557 570 572 573 586 
156 361 362 363 364 365 
271 272 273 274 275 702 
384 385 386 483 484 525 
6 7 10 12 14 
16 18 21 22 426 
19 232 233 234 235 
64 124 243 244 245 
116 117 118 119 501 
140 368 402 851 852 
239 324 804 805 889 
387 388 606 607 608 
397 398 399 403 466 
514 515 517 526 527 
598 599 802 803 822 
623 626 627 628 629 
681 682 683 737 738 
703 704 705 796 797 
2 167 169 178 
39 40 41 721 
66 583 584 585 
67 68 231 761 
98 614 615 699 
168 170 171 842 
194 197 576 837 
292 675 853 854 
302 404 467 468 
380 381 382 383 
551 552 715 716 
664 665 666 784 
670 671 742 743 
676 677 770 771 
732 733 734 735 
1 4 5 
30 336 587 
33 34 58 
69 70 630 
77 887 888 
152 281 282 
215 216 217 
263 264 265 
267 617 885 
285 286 287 
288 293 590 
323 325 708 
378 379 602 
392 471 472 
429 430 431 
434 435 445 
450 700 701 
469 470 785 
556 638 639 
568 569 663 
603 604 605 
650 651 652 
653 727 728 
661 662 902 
679 680 861 
691 692 693 
722 723 724 
725 726 895 
744 745 756 
774 775 798 
826 827 828 
830 831 832 
879 894 907 
