8 12 13 14 16 31 32 60 61 65 66 93 94 95 105 106 109 112 114 125 126 149 160 212 214 271 296 311 312 313 345 380 399 401 403 456 463 554 555 558 609 610 611 621 622 624 654 655 706 719 746 747 748 749 751 752 825 836 841 856 892 897 908 
3 21 44 102 103 108 110 130 131 132 133 266 272 276 277 295 352 354 358 361 423 439 440 441 442 443 472 478 489 490 491 492 493 494 495 496 498 513 576 616 668 669 753 754 755 760 779 793 796 804 805 822 834 835 849 866 
50 51 52 53 54 123 134 141 146 147 148 150 192 208 209 219 221 222 225 227 273 278 279 280 364 444 448 449 504 588 598 599 601 672 673 702 707 750 813 814 843 
0 1 2 4 5 178 288 289 290 294 297 298 299 301 326 327 328 329 330 331 332 333 334 335 337 338 339 340 372 373 374 375 376 377 404 593 730 871 877 878 
87 186 187 188 194 195 196 197 200 201 202 203 205 206 348 350 351 405 406 407 408 409 410 411 447 497 648 696 736 776 837 903 909 
35 36 37 38 113 115 121 207 314 315 389 390 473 474 475 528 612 635 686 687 697 698 847 881 899 900 901 902 
17 57 179 182 189 190 191 193 198 199 204 318 319 320 321 392 393 471 589 806 807 896 
246 247 251 252 253 254 255 256 259 260 261 561 562 564 565 566 567 640 759 815 833 
72 97 127 175 176 357 557 570 572 573 574 575 578 586 587 739 791 819 
18 19 20 22 55 56 58 64 129 220 234 244 366 368 369 370 695 
107 122 151 152 154 155 156 157 281 282 363 453 454 455 781 845 846 
6 7 9 10 11 15 228 229 292 485 486 487 808 844 864 
62 90 232 283 284 424 425 426 427 577 584 585 794 820 821 
42 43 128 172 173 174 177 360 415 464 465 694 710 848 
33 34 233 235 291 537 538 539 540 541 542 543 591 
63 236 237 238 239 240 241 242 324 545 717 718 889 
211 341 583 613 661 662 765 787 789 874 875 876 898 
80 81 82 84 85 86 88 89 548 549 550 904 
100 101 436 437 438 631 632 633 634 850 880 
158 159 161 162 163 164 165 166 359 544 773 
181 184 418 419 450 451 452 700 701 711 886 
300 303 674 675 678 740 741 853 854 863 
355 428 507 508 509 510 511 512 865 
45 46 47 48 49 476 477 657 
305 307 308 310 799 800 801 893 
641 643 645 646 649 658 659 660 
76 136 457 458 459 460 461 
140 397 398 402 466 851 852 
167 168 170 171 481 482 842 
248 249 250 257 258 563 772 
384 385 386 483 484 525 862 
24 25 26 27 28 391 
29 30 336 349 840 869 
71 73 99 500 559 571 
96 98 516 614 615 699 
153 342 344 346 347 480 
180 532 533 534 535 536 
302 467 468 505 506 780 
322 553 712 729 882 883 
59 462 762 763 764 
104 213 262 619 642 
124 243 245 689 690 
169 362 365 446 790 
210 371 529 597 809 
223 224 226 579 580 
267 269 617 839 885 
304 713 714 731 867 
514 515 517 526 527 
521 703 704 705 797 
623 626 627 628 629 
647 812 816 817 818 
67 68 231 761 
117 118 119 501 
135 139 142 145 
143 144 270 560 
293 590 618 709 
420 421 422 488 
592 868 872 873 
676 677 770 771 
732 733 734 735 
23 343 786 
74 75 720 
77 887 888 
83 116 656 
120 546 547 
137 499 625 
306 309 667 
323 325 708 
367 520 838 
381 382 383 
394 395 396 
412 620 644 
429 430 431 
434 435 445 
479 870 884 
502 503 829 
522 523 524 
556 638 639 
600 802 803 
636 637 688 
650 651 652 
653 727 728 
722 723 724 
774 775 798 
777 778 792 
826 827 828 
879 894 907 
