3 21 44 102 103 108 110 130 131 132 133 246 247 248 249 250 251 252 253 255 256 257 258 259 260 261 266 272 276 277 352 354 358 361 423 439 440 441 442 443 472 478 489 490 491 492 493 494 495 496 498 513 561 562 563 564 565 566 567 576 616 640 668 669 714 753 755 760 772 777 778 779 792 793 796 804 805 815 822 833 834 835 849 866 
8 12 13 14 16 60 61 65 93 94 95 105 106 109 112 114 125 126 149 160 212 214 296 311 312 313 319 323 325 345 380 399 401 403 456 463 554 555 558 560 609 610 611 621 622 624 655 706 708 719 746 747 748 749 751 752 825 836 856 892 897 908 
0 1 2 4 5 178 288 289 290 294 297 298 299 301 302 326 327 328 329 330 331 332 333 334 335 337 338 339 340 353 356 372 373 374 375 376 377 404 467 468 597 730 809 871 877 878 
6 7 9 10 11 15 189 190 191 193 198 204 228 229 292 393 485 486 487 674 806 807 808 844 864 
50 51 52 53 54 123 141 192 208 209 273 364 444 448 504 588 598 599 601 702 707 750 813 814 
72 97 127 128 175 176 357 415 557 570 572 574 575 578 586 587 613 614 615 739 819 
113 115 121 314 315 389 390 473 474 475 612 697 698 847 899 900 901 902 
17 18 19 20 22 56 64 129 220 234 244 318 320 321 589 695 
62 66 90 232 283 284 424 425 426 427 577 584 585 794 820 821 
194 202 205 206 641 643 645 646 647 648 649 658 659 660 696 909 
63 236 237 238 239 240 241 242 324 503 545 717 718 829 889 
87 186 187 195 196 200 351 405 406 407 408 409 411 776 903 
304 305 306 307 308 309 310 667 713 731 799 800 801 867 893 
111 146 148 150 218 219 227 278 279 280 449 579 580 843 
158 159 161 162 163 164 165 166 359 394 395 396 544 773 
179 181 184 199 392 418 419 450 451 452 471 711 886 896 
33 34 233 235 291 537 538 539 540 541 542 543 591 
107 122 151 152 154 155 156 157 281 282 363 845 846 
80 81 82 84 85 86 88 89 548 549 550 904 
211 341 583 661 662 765 787 789 874 875 876 898 
268 367 400 502 520 521 522 523 524 791 797 838 
100 101 436 437 438 631 632 633 634 850 880 
35 36 37 38 207 528 635 686 687 881 
42 43 45 46 47 48 49 477 657 848 
134 135 136 139 140 142 145 254 759 862 
188 197 201 203 350 410 447 497 736 837 
76 137 457 458 459 460 461 499 625 
147 221 222 223 224 225 226 672 673 
172 173 174 177 360 464 465 694 
303 593 675 678 740 741 853 863 
355 507 508 509 510 511 512 865 
420 421 422 453 454 455 488 781 
167 168 169 362 365 446 790 
24 25 26 27 28 391 
71 73 99 559 571 573 
210 366 369 370 371 529 
322 553 712 729 882 883 
384 385 386 483 484 525 
29 31 32 654 841 
59 462 762 763 764 
104 213 262 619 642 
124 243 245 689 690 
143 144 270 346 500 
267 269 617 839 885 
293 590 618 620 709 
514 515 517 526 527 
532 533 534 535 536 
623 626 627 628 629 
67 68 231 761 
96 98 516 699 
117 118 119 501 
180 182 183 185 
336 348 349 869 
397 398 402 466 
428 429 430 431 
592 868 872 873 
676 677 770 771 
732 733 734 735 
812 816 817 818 
23 343 786 
55 57 58 
74 75 720 
77 887 888 
83 116 656 
120 546 547 
153 342 344 
170 171 842 
271 274 275 
295 710 754 
300 476 854 
368 851 852 
381 382 383 
434 435 445 
479 870 884 
505 506 780 
556 638 639 
600 802 803 
636 637 688 
650 651 652 
653 727 728 
703 704 705 
722 723 724 
774 775 798 
826 827 828 
879 894 907 
