3 21 44 67 68 97 102 129 130 131 132 133 175 231 246 247 248 249 250 251 252 253 255 256 257 258 259 260 261 266 268 272 276 277 331 352 354 356 357 358 361 423 472 478 489 490 491 492 493 494 495 496 497 498 513 520 561 562 563 564 565 566 567 581 582 618 620 640 668 669 695 714 722 723 724 730 753 761 768 769 772 777 778 779 792 793 804 805 815 819 822 833 835 849 866 
87 186 187 188 189 190 191 193 194 195 196 197 198 200 201 202 203 205 206 350 351 393 405 406 407 408 409 410 412 447 532 533 534 535 536 576 641 643 644 645 646 648 649 650 651 652 653 658 659 660 696 727 728 736 776 837 903 909 
8 12 13 14 16 60 61 65 93 94 112 125 126 149 160 293 296 318 319 323 324 325 345 456 463 560 590 611 621 622 623 624 626 627 628 629 655 706 708 709 719 746 747 748 749 750 751 752 757 758 836 856 897 908 
50 51 52 53 54 123 134 135 136 138 139 141 142 145 192 208 209 254 273 384 385 386 397 398 399 400 401 403 448 466 483 484 504 506 525 588 598 599 600 601 707 759 780 788 802 803 813 814 826 827 828 862 890 891 
71 72 73 99 127 128 153 172 173 174 176 177 211 329 341 342 360 413 414 415 464 465 556 557 558 559 570 571 572 573 574 575 578 583 586 619 638 639 661 662 694 739 765 787 789 874 875 876 877 878 879 894 898 907 
0 1 2 4 5 76 77 137 178 288 290 301 326 327 328 330 332 333 334 335 337 338 339 340 353 372 373 374 375 376 377 457 458 459 460 461 499 596 625 760 855 871 887 888 
6 7 9 10 11 15 17 18 19 20 56 146 148 150 204 220 227 228 229 230 234 278 279 280 292 320 321 444 449 485 486 487 579 580 589 795 806 807 808 825 843 844 864 
45 46 62 66 90 113 115 121 232 271 274 275 314 315 389 390 424 425 426 427 473 474 475 577 584 585 609 610 612 697 698 794 820 821 847 899 900 901 902 
103 104 105 106 108 109 110 114 120 212 213 214 262 311 312 313 322 434 435 445 546 547 553 554 555 613 616 642 712 729 882 883 892 
78 79 143 144 267 269 270 283 284 304 305 306 307 308 309 310 344 346 347 480 500 667 713 731 799 800 801 839 867 893 
63 96 98 236 237 238 239 240 241 242 367 502 503 514 515 516 517 526 527 545 614 615 699 717 718 791 829 838 889 
33 34 58 289 291 294 295 297 298 299 300 303 476 593 674 675 678 710 740 741 754 755 853 854 863 
80 81 82 83 84 85 86 88 89 116 117 118 119 501 548 549 550 656 732 733 734 735 904 
107 122 151 152 154 155 156 157 281 282 363 364 420 421 422 453 454 455 488 781 845 846 
59 210 366 368 369 370 371 462 529 597 762 763 764 809 851 852 
167 168 169 170 171 362 365 446 481 482 774 775 790 798 842 
158 159 161 162 163 164 165 166 359 394 395 396 544 773 
22 29 30 31 32 336 348 349 587 654 840 841 869 
111 147 218 219 221 222 223 224 225 226 411 672 673 
181 184 418 419 450 451 452 700 701 702 711 886 
355 428 429 430 431 507 508 509 510 511 512 865 
55 57 179 180 182 183 185 199 392 471 896 
95 233 235 537 538 539 540 541 542 543 591 
100 101 436 437 438 631 632 633 634 850 880 
35 36 37 38 207 528 635 686 687 881 
243 245 439 440 441 442 443 617 834 885 
521 522 523 524 703 704 705 796 797 
42 43 47 48 49 477 657 848 
64 74 75 124 244 689 690 720 
23 343 676 677 770 771 786 
24 25 26 27 28 391 
302 404 467 468 505 
647 812 816 817 818 
380 381 382 383 
592 868 872 873 
479 870 884 
636 637 688 
