3 21 44 97 102 103 105 108 110 114 130 131 132 133 175 248 258 266 272 331 352 353 354 356 357 358 361 423 472 478 489 490 491 492 493 495 496 498 513 561 563 564 565 567 618 620 730 753 760 779 793 804 805 815 819 822 835 849 866 
8 12 13 14 16 60 61 65 93 94 106 112 125 126 149 160 212 214 296 319 323 325 345 456 463 554 555 558 560 611 621 622 624 655 706 708 719 746 747 748 749 750 751 752 825 836 856 892 897 908 
45 46 62 66 90 113 115 121 232 271 274 275 283 284 314 315 389 390 577 584 585 609 610 612 794 820 821 847 899 900 901 902 
63 98 236 237 238 239 240 241 242 324 367 502 503 514 515 516 517 520 526 527 545 614 699 717 718 791 829 838 889 
50 51 52 53 54 123 134 138 139 141 192 208 209 273 444 448 504 506 588 598 599 601 707 780 788 813 814 
0 1 2 4 5 178 288 290 326 327 328 330 332 333 335 337 338 339 340 372 373 374 375 376 377 871 
17 18 19 20 22 56 129 220 234 318 320 321 397 398 399 401 402 403 466 589 695 
187 205 206 351 405 406 407 408 409 641 643 645 646 648 649 658 659 660 776 903 909 
71 72 73 96 99 127 128 176 415 557 559 570 571 572 573 574 575 578 586 739 
6 7 9 10 11 15 189 190 191 193 198 204 292 393 806 807 808 844 864 
246 247 249 250 251 252 253 255 256 257 259 260 261 562 566 640 714 772 833 
153 211 329 341 342 583 619 661 662 765 787 789 874 875 876 877 878 898 
289 294 295 297 298 299 300 303 476 593 674 675 678 740 741 853 854 863 
87 188 194 196 197 200 201 202 203 410 412 447 576 644 696 736 837 
179 180 181 182 183 184 185 199 392 418 419 451 452 471 711 886 896 
33 34 95 233 235 291 537 538 539 540 541 542 543 591 
151 152 155 156 281 282 420 421 422 453 454 455 488 781 
304 305 307 308 309 310 713 731 799 800 801 867 893 
80 81 82 84 85 86 88 89 548 549 550 904 
100 101 436 437 438 631 632 633 634 850 880 
143 144 267 269 270 344 346 347 480 500 839 
147 221 222 223 224 225 226 579 580 672 673 
158 159 161 162 163 164 165 166 359 544 773 
210 366 368 369 370 371 529 597 809 851 852 
35 36 37 38 207 528 635 686 687 881 
76 137 457 458 459 460 461 499 625 
146 148 150 227 278 279 280 449 843 
355 428 507 508 509 510 511 512 865 
172 173 174 177 360 464 465 694 
532 533 534 535 536 653 727 728 
104 109 120 213 262 546 547 
167 168 170 171 481 482 842 
228 229 230 485 486 487 795 
24 25 26 27 28 391 
64 124 244 689 690 720 
169 362 364 365 446 790 
243 245 440 442 617 885 
322 553 712 729 882 883 
384 385 386 483 484 525 
29 30 32 840 841 
47 48 49 477 657 
59 462 762 763 764 
122 154 157 845 846 
302 404 467 468 505 
336 348 349 587 869 
473 474 475 697 698 
623 626 627 628 629 
647 812 816 817 818 
67 68 231 761 
117 118 119 501 
135 140 142 145 
136 254 759 862 
276 277 668 669 
380 381 382 383 
424 425 426 427 
439 441 443 834 
450 700 701 702 
592 868 872 873 
613 615 616 642 
676 677 770 771 
703 704 705 796 
732 733 734 735 
23 343 786 
42 43 848 
55 57 58 
77 887 888 
83 116 656 
293 590 709 
311 312 313 
350 494 497 
394 395 396 
429 430 431 
434 435 445 
479 870 884 
522 523 524 
556 638 639 
600 802 803 
636 637 688 
650 651 652 
710 754 755 
722 723 724 
774 775 798 
777 778 792 
826 827 828 
879 894 907 
