3 21 44 97 102 103 108 110 128 130 131 132 133 175 176 247 248 256 258 266 272 276 277 331 352 353 354 356 357 358 361 415 423 472 478 489 490 491 492 493 495 496 498 513 561 562 564 565 567 618 620 640 668 669 730 739 753 755 760 779 792 793 804 805 815 819 822 835 849 866 
8 12 13 14 16 60 61 65 93 94 95 105 106 109 112 114 125 126 149 160 212 214 296 311 312 313 319 345 380 397 398 399 401 402 403 456 463 466 554 555 558 560 611 621 622 624 655 706 719 746 747 748 749 751 752 825 836 856 892 897 908 
0 1 2 4 5 178 288 290 326 327 328 330 332 333 335 337 338 339 340 372 373 374 375 376 377 499 625 871 
50 51 52 53 54 123 141 192 208 209 273 444 448 504 506 588 598 599 600 601 707 750 780 802 803 813 814 827 
6 7 9 10 11 15 189 190 191 193 198 204 228 229 292 393 485 486 487 806 807 808 844 864 
113 115 121 314 315 389 390 473 474 475 609 610 612 697 698 847 899 900 901 902 
71 72 73 99 127 153 557 559 570 571 572 573 574 575 578 586 619 
289 294 295 297 298 299 300 303 593 674 675 678 740 741 853 854 863 
59 210 366 368 369 370 371 462 529 597 762 763 764 809 851 852 
62 66 90 232 283 284 424 425 426 427 577 584 585 794 820 821 
211 329 341 342 583 661 662 765 787 789 874 875 876 877 878 898 
246 249 250 251 252 253 255 257 259 260 261 563 566 714 772 833 
188 194 196 197 201 202 203 410 412 447 576 644 696 736 837 
304 305 306 307 308 309 310 667 713 731 799 800 801 867 893 
17 18 19 20 22 56 129 220 234 318 320 321 589 695 
33 34 233 235 291 537 538 539 540 541 542 543 591 
63 367 503 520 521 522 523 524 545 717 718 791 829 
187 205 206 351 405 406 407 408 409 648 776 903 909 
80 81 82 84 85 86 88 89 548 549 550 904 
96 98 514 515 516 517 526 527 614 615 699 
100 101 436 437 438 631 632 633 634 850 880 
104 213 262 587 613 616 642 712 729 882 883 
122 151 152 154 155 156 157 281 282 845 846 
134 135 136 137 139 140 142 145 254 759 862 
143 144 267 269 270 344 346 347 480 500 839 
158 159 161 162 163 164 165 166 359 544 773 
35 36 37 38 207 528 635 686 687 881 
45 46 47 48 49 476 477 657 848 
146 148 150 227 278 279 280 449 843 
179 180 182 183 185 199 392 471 896 
236 237 238 239 240 241 242 324 889 
355 428 507 508 509 510 511 512 865 
64 74 75 124 244 689 690 720 
172 173 174 177 360 464 465 694 
181 184 418 419 451 452 711 886 
420 421 422 453 454 455 488 781 
641 643 645 646 649 658 659 660 
167 168 170 171 481 482 842 
24 25 26 27 28 391 
76 457 458 459 460 461 
147 221 222 225 672 673 
169 362 364 365 446 790 
243 245 440 442 617 885 
384 385 386 483 484 525 
223 224 226 579 580 
302 404 467 468 505 
532 533 534 535 536 
623 626 627 628 629 
647 812 816 817 818 
703 704 705 796 797 
67 68 231 761 
117 118 119 501 
336 348 349 869 
439 441 443 834 
450 700 701 702 
592 868 872 873 
676 677 770 771 
732 733 734 735 
23 343 786 
29 32 841 
55 57 58 
77 887 888 
83 116 656 
120 546 547 
271 274 275 
293 590 709 
323 325 708 
350 494 497 
381 382 383 
394 395 396 
429 430 431 
434 435 445 
479 870 884 
556 638 639 
636 637 688 
650 651 652 
653 727 728 
722 723 724 
774 775 798 
879 894 907 
