3 21 44 67 68 102 103 108 110 130 131 132 133 231 266 272 276 277 295 306 309 352 353 354 356 358 361 423 439 440 441 442 443 472 478 479 489 490 491 492 493 494 495 496 498 513 576 593 616 667 668 669 722 723 724 753 754 755 760 761 777 778 779 792 793 796 804 805 822 834 835 849 866 870 884 
8 12 13 14 16 60 61 65 66 93 94 95 105 106 109 112 114 125 126 149 160 212 214 271 296 311 312 313 323 325 345 380 381 382 383 456 463 554 555 558 609 610 611 621 622 623 624 626 627 628 629 655 706 708 719 746 747 748 749 751 752 757 758 836 856 892 897 908 
42 43 45 46 47 48 49 71 72 73 97 99 127 128 172 173 174 175 176 177 357 360 413 414 415 464 465 476 477 500 556 557 559 570 571 572 573 574 575 578 586 587 638 639 657 694 710 739 791 819 848 
0 1 2 4 5 178 288 289 290 294 297 298 299 301 302 326 327 328 329 330 331 332 333 334 335 337 338 339 340 372 373 374 375 376 377 404 467 468 505 506 596 730 780 855 871 877 878 879 894 907 
6 7 9 10 11 15 55 56 58 64 129 140 220 228 229 244 292 300 303 366 368 369 370 397 398 399 401 402 403 466 485 486 487 674 675 678 695 740 741 808 844 851 852 853 854 863 864 
50 51 52 53 54 123 134 138 141 146 148 150 192 208 209 219 227 273 274 275 278 279 280 364 444 448 449 504 588 598 599 600 601 702 707 750 788 802 803 813 814 826 827 828 843 890 891 
87 186 187 188 194 195 196 197 200 201 202 203 205 206 348 350 351 405 406 407 408 409 410 411 412 447 497 620 641 643 644 645 646 648 649 658 659 660 696 736 776 837 903 909 
35 36 37 38 63 113 115 121 207 236 237 238 239 240 241 242 314 315 324 389 390 473 474 475 528 545 612 635 686 687 697 698 717 718 847 881 889 899 900 901 902 
246 247 248 249 250 251 252 253 254 255 256 257 258 259 260 261 384 385 386 483 484 525 561 562 563 564 565 566 567 640 759 768 769 772 815 833 862 
62 90 167 168 169 170 171 232 283 284 362 365 424 425 426 427 446 481 482 577 584 585 774 775 790 794 798 820 821 842 
96 98 153 211 341 342 344 346 347 480 514 515 516 517 526 527 583 613 614 615 661 662 699 765 787 789 874 875 876 898 
179 180 181 182 183 184 185 392 418 419 450 451 452 471 532 533 534 535 536 650 651 652 653 700 701 711 727 728 886 896 
78 79 135 139 142 143 144 145 267 269 270 304 305 307 308 310 560 617 713 714 731 799 800 801 839 867 885 893 
17 18 19 20 22 57 189 190 191 193 198 199 204 234 318 319 320 321 393 589 806 807 825 
80 81 82 83 84 85 86 88 89 116 117 118 119 501 548 549 550 656 732 733 734 735 904 
107 122 151 152 154 155 156 157 281 282 363 420 421 422 453 454 455 488 781 845 846 
104 120 213 262 322 434 435 445 546 547 553 619 642 712 729 882 883 
158 159 161 162 163 164 165 166 359 394 395 396 544 773 
33 34 233 235 291 537 538 539 540 541 542 543 591 
76 77 136 137 457 458 459 460 461 499 625 887 888 
111 147 218 221 222 223 224 225 226 579 580 672 673 
355 428 429 430 431 507 508 509 510 511 512 865 
100 101 436 437 438 631 632 633 634 850 880 
367 520 521 522 523 524 703 704 705 797 838 
59 210 371 462 529 597 762 763 764 809 
74 75 124 243 245 689 690 720 
23 343 676 677 770 771 786 
29 30 31 32 654 840 841 
268 400 502 503 581 582 829 
24 25 26 27 28 391 
647 812 816 817 818 
293 590 618 709 
592 868 872 873 
336 349 869 
636 637 688 
