0 3 9 11 21 42 44 45 46 47 48 49 50 52 53 54 61 67 68 78 79 94 95 102 120 122 123 124 125 126 129 130 131 132 133 137 155 156 158 159 160 161 162 164 166 208 209 211 220 221 222 223 224 226 228 229 230 231 243 245 258 262 276 277 309 310 352 354 355 357 358 359 361 362 363 364 365 394 395 396 420 421 422 423 426 434 435 439 440 441 442 443 445 447 453 454 456 471 472 476 477 478 479 485 486 487 488 491 493 499 540 546 598 599 600 616 619 620 625 641 642 643 644 645 646 647 649 657 658 659 660 667 668 669 672 673 676 677 695 712 720 722 723 724 729 730 753 755 761 770 771 772 773 777 778 779 786 792 795 799 800 801 802 804 805 808 816 819 820 822 834 835 844 846 848 849 864 882 883 897 
43 71 72 73 96 97 98 99 127 128 135 139 142 144 145 172 173 174 175 176 177 197 249 250 253 255 257 260 304 305 306 307 308 342 343 344 345 347 360 413 414 415 428 464 465 489 490 492 494 495 496 500 507 513 556 557 558 559 565 570 571 572 573 574 575 578 586 587 613 614 615 637 638 639 688 694 699 710 713 714 731 754 768 769 787 789 796 837 838 850 865 866 867 874 875 876 893 908 
6 7 8 10 12 13 14 24 29 31 32 62 63 66 74 75 80 82 85 89 90 112 121 134 138 143 157 181 184 234 283 341 346 366 367 368 370 380 381 382 383 424 425 427 516 520 521 522 523 524 537 539 541 543 549 560 561 564 567 577 583 585 591 612 618 621 622 623 624 626 627 628 629 654 655 661 662 703 704 705 706 708 717 718 757 758 791 794 797 840 841 856 884 886 898 
25 30 236 237 238 239 240 241 242 290 326 327 328 329 330 331 332 333 334 335 336 337 338 339 340 353 356 372 373 374 375 376 377 391 404 418 419 450 451 452 467 468 545 592 596 597 689 690 711 760 788 809 855 868 871 872 873 877 878 879 889 894 907 
57 81 83 84 86 87 88 116 186 187 188 189 190 191 192 193 194 195 196 198 199 200 201 202 203 205 206 348 350 351 392 393 405 406 407 408 409 410 411 412 497 548 550 636 648 696 707 736 776 903 909 
37 103 104 105 106 107 108 109 110 111 113 114 115 210 212 213 214 311 312 313 314 315 371 389 390 455 473 474 475 547 553 554 555 609 610 686 697 698 781 847 892 899 900 901 902 
33 34 51 55 56 58 60 64 65 93 141 163 165 244 462 463 505 506 529 538 544 601 611 719 746 747 749 750 752 762 763 764 765 780 803 812 813 814 836 890 891 
76 77 136 246 247 248 251 252 254 256 259 261 384 385 386 457 458 459 460 461 483 484 525 562 563 566 640 759 815 833 862 870 887 888 
146 147 148 149 150 218 219 225 227 271 272 273 274 275 278 279 280 444 448 449 504 700 701 702 826 827 828 843 
16 17 18 19 20 22 23 204 232 233 235 318 319 320 321 322 349 542 579 580 588 590 674 806 807 825 869 
288 289 291 292 294 295 296 297 298 299 300 301 302 303 480 593 675 678 740 741 853 854 863 
15 59 140 369 397 398 399 400 401 402 403 466 748 751 851 852 
180 183 185 532 533 534 535 536 650 651 652 653 727 728 
266 267 268 269 270 284 502 503 581 582 617 829 839 885 
1 2 4 5 167 168 169 170 171 178 481 482 842 
151 152 153 154 281 282 845 
446 584 774 775 790 798 821 
514 515 517 526 527 
179 182 589 896 
293 709 739 
323 324 325 
498 576 793 
