3 11 21 44 45 46 47 48 49 50 52 53 54 75 102 123 125 129 130 131 132 133 146 148 150 158 159 160 161 162 164 166 208 209 211 220 221 222 225 227 258 272 279 280 309 344 345 347 352 354 355 356 357 358 359 361 362 363 364 365 420 423 426 439 440 441 442 443 456 471 472 476 477 478 479 488 491 493 504 520 540 577 598 599 600 619 657 672 673 695 712 720 729 753 772 773 779 786 802 804 805 819 822 834 835 848 849 882 883 897 908 
6 7 8 10 12 14 24 27 62 63 66 80 82 83 84 85 89 90 94 95 112 116 134 143 149 157 234 271 278 341 346 380 462 537 541 543 549 560 561 563 564 567 583 585 591 618 621 622 624 661 662 708 717 718 794 815 856 898 
71 72 73 96 97 98 99 127 128 172 173 174 175 176 177 360 415 428 464 465 496 507 508 509 510 511 512 513 557 558 559 570 571 572 573 574 575 578 586 587 637 688 694 699 791 796 865 
37 103 104 105 106 107 108 109 110 111 113 114 115 212 213 214 218 311 312 313 314 315 389 390 446 547 553 554 555 584 635 686 790 821 847 892 899 900 901 902 
51 56 60 61 64 65 93 124 126 141 163 165 244 444 463 505 506 529 544 546 601 611 719 746 747 749 752 765 780 803 812 813 814 836 
57 81 86 87 88 186 188 189 190 191 192 193 194 195 198 199 200 201 202 203 206 392 393 548 550 636 696 707 736 
76 136 246 247 248 249 251 252 254 256 259 261 457 458 459 460 461 562 566 640 759 833 862 870 
288 289 291 292 294 295 296 297 298 299 300 301 302 303 480 593 674 675 678 740 741 853 854 863 
187 196 205 219 348 350 351 405 406 407 408 409 410 411 412 497 648 776 903 909 
447 620 641 642 643 644 645 646 647 649 658 659 660 
17 23 204 223 224 226 579 580 806 807 825 
29 30 331 333 336 340 372 376 377 592 840 
135 139 140 142 144 145 494 495 500 851 852 
326 328 330 334 335 337 338 339 374 516 545 
0 1 2 4 5 137 169 178 499 625 
16 18 19 20 232 233 235 538 539 542 
138 369 397 398 399 401 402 403 466 
250 253 257 260 304 306 714 731 867 
290 373 375 418 419 450 451 452 711 
305 307 308 489 490 492 850 866 893 
147 273 274 275 448 449 702 843 
266 268 269 270 502 503 829 839 
25 26 332 353 391 597 809 
35 36 38 207 528 687 881 
74 181 184 424 425 427 886 
167 168 170 171 481 482 842 
197 342 343 787 789 837 838 
9 122 808 844 846 864 
31 32 654 655 706 841 
236 237 238 240 241 242 
310 667 799 800 801 816 
327 404 467 468 760 871 
384 385 386 483 484 525 
421 422 453 454 455 781 
613 614 615 874 875 876 
15 59 400 748 751 
151 152 153 281 282 
228 229 230 485 486 
243 245 267 617 885 
318 319 320 321 322 
329 689 690 877 878 
473 474 475 697 698 
514 515 517 526 527 
521 703 704 705 797 
623 626 627 628 629 
33 34 55 58 
67 68 231 761 
179 182 589 896 
210 371 609 610 
276 277 668 669 
366 367 368 370 
532 533 534 535 
676 677 770 771 
750 762 763 764 
22 349 869 
77 887 888 
120 156 262 
121 612 820 
155 283 284 
239 788 889 
255 565 713 
293 709 739 
323 324 325 
381 382 383 
394 395 396 
429 430 431 
434 435 445 
498 576 793 
522 523 524 
556 638 639 
650 651 652 
653 727 728 
710 754 755 
722 723 724 
774 775 798 
777 778 792 
826 827 828 
868 872 873 
879 894 907 
