0 3 6 7 10 11 12 13 14 15 29 31 32 67 68 151 152 153 231 266 267 269 276 277 281 282 289 323 325 342 344 345 346 347 372 434 435 439 440 441 442 443 445 456 480 502 520 521 522 523 524 616 617 622 654 655 668 669 676 677 706 708 712 720 722 723 724 729 730 746 747 748 749 750 751 752 760 761 770 771 777 778 786 792 834 835 838 839 840 841 849 882 883 884 885 908 
30 43 71 72 73 96 97 99 125 127 128 172 173 174 175 176 177 327 336 352 353 354 355 356 357 358 360 413 414 415 428 429 430 431 464 465 507 508 509 510 511 512 513 556 557 558 570 571 572 573 574 575 578 586 587 638 639 688 694 709 710 739 791 819 865 871 897 
98 188 194 197 202 203 290 301 302 326 328 329 330 331 332 333 334 335 337 338 339 340 341 343 373 374 375 376 377 391 404 447 467 468 514 515 516 517 526 527 559 576 592 593 596 613 614 615 689 690 699 736 787 789 793 837 855 868 874 875 876 877 878 879 894 898 907 
8 9 33 34 55 56 58 59 60 61 64 65 93 120 121 122 123 124 126 129 130 131 132 133 154 157 243 244 245 270 291 292 296 318 366 369 370 401 462 463 539 675 678 695 719 740 741 757 758 808 820 821 825 836 844 845 846 853 854 
35 36 37 38 63 74 75 141 181 207 418 419 424 425 427 451 452 503 505 506 528 529 546 579 580 635 686 687 711 717 718 780 812 813 814 829 881 890 891 899 900 901 
57 186 187 189 190 191 192 193 196 198 199 200 201 204 205 206 348 349 350 351 393 405 406 407 408 409 410 411 412 636 637 674 696 707 776 806 807 869 903 909 
62 66 156 268 271 272 273 274 275 283 284 361 362 363 364 365 397 398 399 400 403 450 466 547 581 582 583 584 585 700 701 702 794 826 827 828 
78 79 100 101 304 305 306 307 308 309 310 436 437 438 489 490 491 492 493 631 632 633 634 667 799 800 801 816 817 818 850 866 867 880 893 
246 247 248 249 250 251 252 253 254 255 256 257 258 259 260 261 561 562 563 564 565 566 567 640 713 714 731 759 768 769 772 815 833 870 
24 25 26 27 28 76 77 134 135 136 137 138 139 140 142 143 144 145 368 402 457 458 459 460 461 560 788 851 852 887 888 
102 103 104 105 106 107 108 109 110 111 112 113 114 115 212 213 214 262 311 312 313 553 554 555 847 892 
314 315 371 389 390 455 473 474 475 588 597 598 599 600 601 609 610 611 612 697 698 781 802 803 809 822 
146 147 148 149 150 218 219 220 221 222 223 224 225 226 227 278 279 280 444 448 449 504 672 673 843 
42 44 45 46 47 48 49 50 51 52 53 54 208 209 210 211 300 476 477 478 479 577 657 848 
288 293 294 297 298 299 303 590 618 619 620 641 642 643 644 645 646 647 648 649 658 659 660 863 
80 81 82 83 84 85 86 87 88 89 90 548 549 550 656 732 733 734 735 904 
155 158 159 160 161 162 163 164 165 166 359 394 395 396 762 763 764 765 773 
236 237 238 239 240 241 242 324 367 446 545 774 775 790 798 804 805 889 
16 17 18 19 21 22 23 232 233 234 235 319 320 321 322 426 589 
179 182 183 184 185 621 623 624 625 626 627 628 629 886 896 
1 2 4 5 167 168 169 170 171 178 481 482 842 
180 195 532 533 534 535 536 650 651 652 653 727 728 
20 94 95 537 538 540 541 542 543 544 591 
228 229 230 485 486 487 795 864 
384 385 386 483 484 525 856 862 
420 421 422 423 453 454 488 779 
387 388 416 417 606 607 608 
494 495 496 497 498 499 500 
116 117 118 119 501 
681 682 683 737 738 
703 704 705 796 797 
39 40 41 721 
295 753 754 755 
380 381 382 383 
551 552 715 716 
664 665 666 784 
670 671 742 743 
69 70 630 
215 216 217 
263 264 265 
285 286 287 
378 379 602 
392 471 472 
469 470 785 
568 569 663 
603 604 605 
661 662 902 
679 680 861 
691 692 693 
725 726 895 
744 745 756 
830 831 832 
