3 21 44 97 102 103 104 105 108 110 114 128 130 131 132 133 175 176 246 247 248 249 250 251 252 253 255 256 257 258 259 260 261 266 272 276 277 331 352 353 354 356 357 358 361 423 472 478 489 490 491 492 493 494 495 496 498 513 561 562 564 565 567 618 620 640 657 668 669 703 704 705 710 714 730 739 753 754 755 760 779 792 793 796 804 805 815 819 822 833 835 848 849 866 
8 12 13 14 16 60 61 65 93 94 95 106 109 112 125 126 149 160 212 214 293 296 319 323 325 345 380 399 401 403 456 463 554 555 558 560 590 611 621 622 624 655 706 708 709 719 746 747 748 749 751 752 825 836 856 892 897 908 
301 326 327 328 329 330 332 333 334 335 336 337 338 339 340 348 349 372 373 374 375 376 377 597 809 869 871 877 878 879 894 907 
50 51 52 53 54 123 141 192 208 209 273 444 448 504 506 588 598 599 601 707 750 780 813 814 
17 18 19 20 22 56 129 189 190 191 193 198 204 220 234 318 320 321 393 589 695 806 807 
111 146 147 148 150 218 221 222 223 224 225 226 227 278 279 280 449 579 580 672 673 843 
113 115 121 314 315 389 390 473 474 475 609 610 612 697 698 847 899 900 901 902 
122 151 152 154 155 156 157 281 282 420 421 422 453 454 455 488 781 845 846 
211 341 342 344 514 515 516 517 526 527 583 661 662 765 787 789 898 
289 294 295 297 298 299 300 303 593 674 675 678 740 741 853 854 863 
62 66 90 232 283 284 424 425 426 427 577 584 585 794 820 821 
6 7 9 10 11 15 228 229 292 485 486 487 808 844 864 
63 236 237 238 239 240 241 242 324 503 545 717 718 829 889 
72 96 98 99 415 557 570 572 573 575 578 586 614 615 699 
188 194 196 197 201 202 203 410 412 447 576 644 696 736 837 
158 159 161 162 163 164 165 166 359 394 395 396 544 773 
33 34 233 235 291 537 538 539 540 541 542 543 591 
187 205 206 351 405 406 407 408 409 648 776 903 909 
80 81 82 84 85 86 88 89 548 549 550 904 
59 210 366 369 370 371 462 529 762 763 764 
100 101 436 437 438 631 632 633 634 850 880 
179 181 182 184 418 419 451 452 711 886 896 
304 306 308 310 713 731 799 800 801 867 893 
35 36 37 38 207 528 635 686 687 881 
134 135 136 139 140 142 145 254 759 862 
213 262 587 613 616 642 712 729 882 883 
243 245 439 440 441 442 443 617 834 885 
0 1 2 4 5 137 178 499 625 
42 43 45 46 47 48 49 476 477 
355 428 507 508 509 510 511 512 865 
172 173 174 177 360 464 465 694 
641 643 645 646 649 658 659 660 
71 73 127 500 559 571 574 
143 144 267 269 270 346 839 
76 457 458 459 460 461 
384 385 386 483 484 525 
29 31 32 654 841 
64 124 244 689 690 
302 404 467 468 505 
362 364 365 446 790 
532 533 534 535 536 
623 626 627 628 629 
647 812 816 817 818 
24 26 27 28 
67 68 231 761 
117 118 119 501 
168 170 171 842 
305 307 309 667 
397 398 402 466 
450 700 701 702 
592 868 872 873 
676 677 770 771 
732 733 734 735 
23 343 786 
55 57 58 
74 75 720 
77 887 888 
83 116 656 
120 546 547 
180 183 185 
199 392 471 
271 274 275 
311 312 313 
367 520 791 
368 851 852 
381 382 383 
429 430 431 
434 435 445 
479 870 884 
522 523 524 
556 638 639 
563 566 772 
600 802 803 
636 637 688 
650 651 652 
653 727 728 
722 723 724 
774 775 798 
826 827 828 
874 875 876 
