3 6 10 12 14 15 31 32 75 266 267 269 323 325 331 344 404 439 440 441 442 443 456 592 617 654 655 706 708 720 760 786 793 834 835 839 841 849 885 
102 103 104 105 106 107 108 109 110 111 112 113 114 115 212 213 214 262 311 312 313 553 554 555 847 892 
72 97 128 175 176 352 353 354 355 356 357 358 415 507 508 509 510 511 512 513 709 739 791 819 865 
246 247 248 250 252 253 255 256 257 258 259 260 261 561 562 563 564 565 567 640 713 714 731 815 833 
42 44 45 46 47 48 49 50 51 52 53 54 208 209 210 211 300 476 477 478 479 577 657 848 
37 63 141 223 224 226 444 503 529 546 579 580 635 686 717 718 812 813 814 829 899 900 901 
8 9 60 65 93 122 129 154 157 296 318 380 401 462 463 719 808 825 836 844 845 846 
146 147 148 149 150 218 219 220 221 222 225 227 278 279 280 448 449 504 672 673 843 
326 327 328 329 330 333 335 336 337 338 339 340 374 375 376 377 689 690 871 877 878 
57 186 189 190 191 192 193 198 199 200 201 204 206 393 636 637 696 707 806 807 
33 34 55 58 61 64 120 121 123 124 126 131 151 243 244 245 750 821 
71 73 96 98 99 127 557 570 571 572 573 574 575 578 586 587 699 
80 81 82 83 84 85 86 87 88 89 90 548 549 550 656 904 
304 305 306 307 308 309 310 667 799 800 801 816 817 818 867 893 
7 11 341 343 559 576 613 614 615 787 789 874 875 876 898 
62 66 155 271 272 273 274 275 283 284 547 702 794 
153 345 346 347 480 622 746 747 748 749 751 752 908 
188 194 196 197 202 203 205 410 447 736 837 909 
494 495 496 497 498 499 500 703 704 705 796 797 
641 642 643 644 645 646 647 648 649 658 659 660 
20 94 95 537 538 540 541 542 543 544 591 
24 27 28 134 135 139 140 142 143 144 560 
187 351 405 406 407 408 409 411 412 776 903 
0 332 372 373 391 520 521 522 523 524 
43 172 173 174 177 360 464 465 694 710 
56 59 130 133 366 367 369 370 695 820 
74 181 418 419 424 425 427 451 452 711 
100 101 436 437 438 631 632 633 634 880 
292 303 674 675 678 740 741 853 854 863 
420 421 422 423 453 454 455 488 779 781 
76 136 137 145 457 458 459 460 461 
179 183 184 185 621 624 625 886 896 
342 502 514 515 516 517 526 527 838 
158 160 161 162 163 166 359 773 
195 532 533 534 535 653 727 728 
228 229 230 485 486 487 795 864 
289 294 297 298 299 301 334 593 
17 23 319 320 321 322 589 
35 36 38 207 528 687 881 
159 164 165 762 763 764 765 
167 168 170 171 481 482 842 
249 251 254 566 759 772 870 
288 290 293 590 618 619 620 
489 490 491 492 493 850 866 
13 712 729 882 883 884 
156 361 362 363 364 365 
236 237 238 240 241 242 
314 315 389 390 588 601 
384 385 386 483 484 525 
397 398 399 402 403 466 
16 18 21 22 426 
19 232 233 234 235 
116 117 118 119 501 
239 324 804 805 889 
387 388 606 607 608 
473 474 475 697 698 
598 599 802 803 822 
623 626 627 628 629 
681 682 683 737 738 
39 40 41 721 
67 68 231 761 
125 558 688 897 
276 277 668 669 
295 753 754 755 
348 349 350 869 
371 597 612 809 
428 429 430 431 
551 552 715 716 
600 609 610 611 
664 665 666 784 
670 671 742 743 
676 677 770 771 
732 733 734 735 
1 4 5 
2 169 178 
29 30 840 
69 70 630 
77 887 888 
152 281 282 
180 182 536 
215 216 217 
263 264 265 
285 286 287 
302 467 468 
368 851 852 
378 379 602 
381 382 383 
392 471 472 
394 395 396 
434 435 445 
446 545 790 
450 700 701 
469 470 785 
505 506 780 
556 638 639 
568 569 663 
583 584 585 
603 604 605 
650 651 652 
661 662 902 
679 680 861 
691 692 693 
722 723 724 
725 726 895 
744 745 756 
774 775 798 
777 778 792 
826 827 828 
830 831 832 
868 872 873 
879 894 907 
