0 3 11 15 266 269 276 277 331 342 344 346 347 439 440 441 442 443 456 480 520 592 616 668 669 712 720 729 730 760 777 778 786 792 793 834 835 838 839 849 868 882 883 
246 247 248 249 250 251 252 253 254 255 256 257 258 259 260 261 561 562 563 564 565 566 567 640 713 714 731 759 772 815 833 870 
98 329 341 343 514 515 516 517 526 527 559 613 614 615 689 690 699 787 789 874 875 876 877 878 898 
146 147 148 149 150 218 219 220 221 222 223 224 225 226 227 278 279 280 444 448 449 504 672 673 843 
42 44 45 46 47 48 49 50 51 52 53 54 208 209 210 211 476 477 478 479 577 657 848 
37 63 141 503 505 506 529 546 579 580 635 686 717 718 780 812 813 814 829 899 900 901 
290 326 327 328 330 332 333 334 335 337 338 339 340 372 373 374 375 376 377 391 404 871 
24 25 26 27 28 76 134 135 136 137 139 142 143 144 145 457 458 459 460 461 560 
57 186 189 190 191 192 193 198 199 200 201 204 206 393 636 637 696 707 806 807 
8 55 60 65 93 122 151 154 157 296 318 463 539 719 821 825 836 845 846 
9 56 59 64 120 129 130 131 132 133 270 366 369 370 401 462 695 808 844 
188 194 196 197 202 203 205 348 349 350 410 447 576 736 837 869 909 
30 71 72 73 127 336 557 570 571 572 573 574 575 578 586 587 
80 81 82 83 84 85 86 87 88 89 90 548 549 550 656 904 
96 97 99 128 176 354 358 415 513 558 688 709 739 819 865 
103 107 110 111 112 113 212 213 262 313 553 554 555 847 892 
310 489 490 491 492 493 799 800 801 816 817 818 850 866 893 
618 619 620 641 642 643 644 645 646 647 648 649 658 659 660 
74 75 181 418 419 424 425 427 451 452 711 
102 104 105 106 108 109 114 115 214 311 312 
153 345 622 746 747 748 749 750 751 752 908 
187 351 405 406 407 408 409 411 412 776 903 
43 172 173 174 177 360 464 465 694 710 
61 121 123 124 126 243 244 245 291 820 
100 101 436 437 438 631 632 633 634 880 
236 237 238 240 241 242 367 446 545 790 
271 272 273 274 275 450 700 701 702 
29 31 32 654 655 706 840 841 
62 268 283 284 400 502 547 794 
125 175 352 353 356 357 791 897 
155 159 164 165 762 763 764 765 
158 160 161 162 163 166 359 773 
179 182 184 621 624 625 886 896 
195 532 533 534 535 653 727 728 
228 229 230 485 486 487 795 864 
304 305 306 307 308 309 667 867 
355 428 507 508 509 510 511 512 
420 421 422 423 453 454 488 779 
17 23 319 320 321 322 589 
35 36 38 207 528 687 881 
289 294 297 298 299 301 593 
292 675 678 740 741 853 854 
494 495 496 497 498 499 500 
20 94 95 540 543 591 
156 361 362 363 364 365 
314 315 389 390 588 601 
371 455 597 612 781 809 
384 385 386 483 484 525 
6 7 10 12 14 
16 18 21 22 426 
19 232 233 234 235 
116 117 118 119 501 
239 324 804 805 889 
387 388 606 607 608 
397 398 399 403 466 
473 474 475 697 698 
537 538 541 542 544 
598 599 802 803 822 
623 626 627 628 629 
681 682 683 737 738 
703 704 705 796 797 
2 167 169 178 
39 40 41 721 
66 583 584 585 
67 68 231 761 
168 170 171 842 
295 753 754 755 
300 303 674 863 
380 381 382 383 
521 522 523 524 
551 552 715 716 
600 609 610 611 
664 665 666 784 
670 671 742 743 
676 677 770 771 
732 733 734 735 
1 4 5 
33 34 58 
69 70 630 
77 887 888 
152 281 282 
215 216 217 
263 264 265 
267 617 885 
285 286 287 
288 293 590 
302 467 468 
323 325 708 
368 851 852 
378 379 602 
392 471 472 
394 395 396 
429 430 431 
434 435 445 
469 470 785 
556 638 639 
568 569 663 
603 604 605 
650 651 652 
661 662 902 
679 680 861 
691 692 693 
722 723 724 
725 726 895 
744 745 756 
774 775 798 
826 827 828 
830 831 832 
879 894 907 
