3 11 21 44 45 46 47 48 49 50 52 53 54 74 75 102 123 129 130 131 132 133 158 159 160 161 162 164 166 181 184 208 209 211 220 221 222 223 224 226 258 272 309 344 345 352 354 355 356 357 358 359 361 365 420 423 424 425 426 427 456 471 472 477 478 479 488 491 493 498 520 540 598 599 600 618 657 672 673 695 720 753 772 773 779 786 793 802 804 805 819 822 835 848 849 886 908 
37 62 80 81 82 83 84 85 89 90 103 104 105 106 107 108 109 110 111 113 114 115 116 121 169 212 213 214 311 312 313 314 315 362 363 389 390 446 547 549 553 554 555 577 584 635 686 790 794 820 821 847 892 899 900 901 902 
6 7 8 9 10 12 14 61 63 94 95 112 122 125 126 154 157 234 341 380 462 537 541 543 560 576 583 585 591 619 621 622 624 625 661 662 708 717 718 808 844 845 846 856 864 897 898 
25 29 30 326 328 329 330 331 332 333 334 335 336 337 338 339 340 353 372 373 374 375 376 377 391 404 592 597 689 690 809 840 877 878 
72 96 97 98 127 128 175 176 415 507 508 509 510 511 512 513 557 558 570 572 573 574 575 578 586 587 637 688 699 865 
51 56 60 65 93 141 163 165 463 506 529 544 601 611 719 746 747 749 752 765 780 803 812 813 814 836 
76 136 246 247 248 251 252 254 256 259 261 457 458 459 460 461 562 566 640 759 833 862 870 
86 87 88 196 200 348 350 351 406 407 408 409 410 412 548 550 776 903 
146 147 148 149 150 218 219 225 227 278 279 280 444 448 449 504 843 
288 289 291 292 294 295 296 297 298 299 300 301 303 476 480 593 863 
135 137 139 140 142 144 145 494 495 497 500 851 852 
186 187 189 193 198 199 201 202 203 206 405 411 
620 641 642 643 644 645 646 648 649 658 659 660 
24 66 134 143 346 347 561 563 564 567 815 
172 173 174 177 360 464 465 694 710 754 755 
16 18 19 20 232 233 235 538 539 542 
71 73 99 496 559 571 703 704 705 796 
138 369 397 398 399 400 401 402 403 466 
210 371 473 474 475 609 610 612 697 698 
249 250 253 257 260 304 306 714 731 867 
236 237 238 239 240 241 242 788 889 
305 307 308 489 490 492 850 866 893 
310 647 667 799 800 801 816 817 818 
613 614 615 616 712 729 730 882 883 
17 23 204 579 580 806 807 825 
0 1 2 4 5 178 499 
35 36 38 207 528 687 881 
197 342 343 787 789 837 838 
674 675 678 740 741 853 854 
31 32 654 655 706 841 
188 194 205 447 736 909 
190 191 192 636 696 707 
195 532 533 534 535 536 
243 245 440 442 617 885 
266 267 268 269 270 839 
290 418 419 451 452 711 
384 385 386 483 484 525 
421 422 453 454 455 781 
151 152 153 281 282 
167 168 170 171 842 
228 229 230 485 486 
271 273 274 275 364 
366 367 368 370 791 
514 515 517 526 527 
623 626 627 628 629 
15 59 748 751 
33 34 55 58 
67 68 231 761 
120 156 262 546 
180 182 183 185 
276 277 668 669 
318 320 321 322 
428 429 430 431 
439 441 443 834 
450 700 701 702 
676 677 770 771 
750 762 763 764 
22 349 869 
57 392 393 
64 124 244 
77 887 888 
155 283 284 
179 589 896 
255 565 713 
293 709 739 
319 588 590 
323 324 325 
327 760 871 
381 382 383 
394 395 396 
434 435 445 
502 503 829 
522 523 524 
556 638 639 
650 651 652 
653 727 728 
722 723 724 
774 775 798 
777 778 792 
826 827 828 
868 872 873 
874 875 876 
879 894 907 
