3 21 42 43 44 45 46 47 48 49 67 68 102 103 104 110 128 130 132 133 231 246 247 248 249 250 251 252 253 255 256 257 258 259 260 261 266 271 272 274 275 276 277 289 293 294 295 297 298 299 300 303 352 354 358 361 423 439 440 441 442 443 472 476 477 478 489 490 491 492 493 494 495 496 498 513 556 561 562 563 564 565 566 567 576 590 593 617 618 620 638 639 640 657 668 669 675 703 704 705 709 710 714 722 723 724 753 754 755 760 761 768 769 772 777 778 779 792 793 796 804 805 815 822 833 834 835 848 849 853 854 863 866 885 
8 12 13 14 16 60 61 64 65 93 94 95 105 106 108 109 112 114 125 126 149 160 212 214 244 268 296 311 312 313 319 323 325 345 380 381 382 383 397 398 399 400 401 402 403 456 463 466 554 555 558 560 581 582 611 621 622 623 624 626 627 628 629 655 706 708 719 746 747 748 749 751 752 757 758 825 836 856 892 897 908 
71 72 73 96 97 98 99 127 153 172 173 174 175 176 177 211 341 342 344 355 357 360 413 414 415 464 465 500 507 508 509 510 511 512 514 515 516 517 526 527 557 559 570 571 572 573 574 575 578 583 586 614 615 619 661 662 694 699 739 765 787 789 819 865 874 875 876 898 
50 51 52 53 54 123 134 135 136 138 139 140 141 142 145 192 208 209 254 273 384 385 386 444 448 483 484 504 525 588 598 599 600 601 707 750 759 788 802 803 813 814 826 827 828 862 890 891 
87 186 187 188 194 195 196 197 200 201 202 203 205 206 350 351 405 406 407 408 409 410 412 447 497 532 533 534 535 536 641 643 644 645 646 648 649 658 659 660 696 736 776 837 903 909 
35 36 37 38 63 113 115 121 207 236 237 238 239 240 241 242 314 315 324 389 390 473 474 475 503 528 545 609 610 612 635 686 687 697 698 717 718 829 847 881 889 899 900 901 902 
301 326 327 328 329 330 331 332 333 334 335 336 337 338 339 340 348 349 353 356 372 373 374 375 376 377 596 597 730 809 855 869 871 877 878 879 894 907 
17 18 19 20 22 56 129 189 190 191 193 198 204 220 234 292 318 320 321 393 589 674 678 740 741 806 807 
78 79 143 144 267 269 270 304 305 306 307 308 309 310 346 347 480 667 713 731 799 800 801 839 867 893 
55 57 58 179 180 181 182 183 184 185 199 392 418 419 450 451 452 471 700 701 702 711 886 896 
111 146 147 148 150 218 219 221 222 223 224 225 226 227 278 279 280 411 449 579 580 672 673 843 
80 81 82 83 84 85 86 88 89 116 117 118 119 501 548 549 550 656 732 733 734 735 904 
107 122 151 152 154 155 156 157 213 281 282 363 364 420 421 422 453 454 455 488 781 845 846 
0 1 2 4 5 76 77 137 178 288 290 457 458 459 460 461 499 625 887 888 
120 131 262 322 434 435 445 546 547 553 587 613 616 642 695 712 729 882 883 
62 66 90 232 283 284 424 425 426 427 577 584 585 794 820 821 
167 168 169 170 171 362 365 446 481 482 774 775 790 798 842 
6 7 9 10 11 15 228 229 485 486 487 808 844 864 
59 210 366 368 369 370 371 462 529 762 763 764 851 852 
158 159 161 162 163 164 165 166 359 394 395 396 544 773 
33 34 233 235 291 537 538 539 540 541 542 543 591 
100 101 436 437 438 631 632 633 634 850 880 
367 502 520 521 522 523 524 791 797 838 
74 75 124 243 245 689 690 720 
23 343 676 677 770 771 786 
29 30 31 32 654 840 841 
302 404 467 468 505 506 780 
24 25 26 27 28 391 
650 651 652 653 727 728 
647 812 816 817 818 
428 429 430 431 
592 868 872 873 
479 870 884 
636 637 688 
