3 11 15 258 266 268 269 276 277 331 342 344 346 347 439 440 441 442 443 456 480 502 561 563 564 567 592 613 616 668 669 712 720 729 730 760 772 777 778 786 792 793 815 834 835 838 839 849 868 882 883 884 
30 290 301 326 327 328 330 332 333 334 335 336 337 338 339 340 349 372 373 374 375 376 377 391 404 467 468 587 869 871 
35 36 37 38 63 141 207 503 506 528 529 546 579 580 635 686 687 717 718 780 812 813 814 829 881 899 900 901 
102 103 104 105 106 107 108 109 110 111 112 113 114 115 212 213 214 262 311 312 313 553 554 555 847 892 
57 186 189 190 191 192 193 195 198 199 200 201 204 206 393 532 533 535 636 637 696 707 806 807 
304 305 306 307 308 309 310 489 490 491 492 493 667 799 800 801 816 817 818 850 866 867 893 
96 97 99 125 128 175 176 352 353 354 355 356 357 358 512 558 688 709 739 791 819 897 
146 147 148 149 150 218 220 222 224 225 226 227 278 279 280 444 448 449 504 843 
187 351 405 406 407 408 409 641 642 643 645 646 647 648 649 658 659 660 776 903 
9 33 34 55 58 61 120 121 122 126 151 154 291 612 808 821 844 845 846 
24 27 28 134 135 136 137 139 140 142 143 144 145 368 402 851 852 
289 292 294 297 298 299 300 303 593 674 675 678 740 741 853 854 863 
62 66 273 283 284 397 398 399 400 403 466 547 583 584 585 794 
80 81 82 83 84 85 86 87 88 89 90 548 549 550 656 904 
8 60 65 93 157 296 318 319 401 463 539 590 719 825 836 
188 194 196 197 202 203 205 348 350 410 447 576 736 837 909 
329 341 343 516 559 689 690 787 789 874 875 876 877 878 898 
42 44 45 46 47 48 49 476 477 478 479 577 657 848 
56 59 123 129 130 131 132 133 270 462 695 820 
13 345 622 746 747 748 749 750 751 752 908 
17 19 23 232 233 234 235 320 321 322 589 
74 75 181 418 419 424 425 427 451 452 711 
246 247 248 252 256 259 261 562 566 640 833 
98 415 507 508 509 510 511 513 699 865 
100 101 436 437 438 631 632 633 634 880 
236 237 238 240 241 242 367 446 545 790 
43 172 173 174 177 360 464 465 694 
50 51 52 53 54 208 209 210 211 
314 315 389 390 455 473 588 601 781 
29 31 32 654 655 706 840 841 
155 159 164 165 762 763 764 765 
158 160 161 162 163 166 359 773 
179 182 184 621 624 625 886 896 
228 229 230 485 486 487 795 864 
420 421 422 423 453 454 488 779 
474 475 600 609 610 611 697 698 
71 72 73 571 574 575 578 
167 168 170 171 481 482 842 
494 495 496 497 498 499 500 
20 94 95 540 543 591 
76 457 458 459 460 461 
127 557 570 572 573 586 
153 412 618 619 620 644 
156 361 362 363 364 365 
219 221 223 411 672 673 
249 250 253 257 260 731 
366 369 370 371 597 809 
384 385 386 483 484 525 
6 7 10 12 14 
16 18 21 22 426 
64 124 243 244 245 
116 117 118 119 501 
239 324 804 805 889 
295 710 753 754 755 
387 388 606 607 608 
514 515 517 526 527 
537 538 541 542 544 
598 599 802 803 822 
623 626 627 628 629 
681 682 683 737 738 
703 704 705 796 797 
39 40 41 721 
67 68 231 761 
251 254 759 870 
255 565 713 714 
271 272 274 275 
380 381 382 383 
428 429 430 431 
450 700 701 702 
521 522 523 524 
551 552 715 716 
664 665 666 784 
670 671 742 743 
676 677 770 771 
732 733 734 735 
1 4 5 
2 169 178 
69 70 630 
77 887 888 
152 281 282 
215 216 217 
263 264 265 
267 617 885 
285 286 287 
323 325 708 
378 379 602 
392 471 472 
394 395 396 
434 435 445 
469 470 785 
556 638 639 
560 856 862 
568 569 663 
603 604 605 
661 662 902 
679 680 861 
691 692 693 
722 723 724 
725 726 895 
744 745 756 
774 775 798 
826 827 828 
830 831 832 
879 894 907 
