3 6 7 8 9 10 11 12 13 14 21 44 45 46 47 48 49 50 52 53 54 61 62 63 64 67 68 74 75 80 81 82 83 84 85 86 87 88 89 90 94 95 102 112 116 120 121 122 123 124 125 126 129 130 131 132 133 146 147 148 149 150 154 156 157 158 159 160 161 162 164 166 208 209 211 218 219 220 221 222 223 224 225 226 227 231 234 244 246 251 258 262 271 272 273 274 275 278 279 280 341 344 345 352 354 355 356 357 358 359 361 364 365 380 381 382 383 384 385 386 394 395 396 420 423 424 425 426 427 448 449 456 462 471 472 477 478 479 483 484 488 491 493 498 503 504 520 525 537 540 541 543 546 548 549 550 560 576 577 583 591 598 599 600 618 619 620 621 622 623 624 625 626 627 628 629 655 657 661 662 672 673 676 677 695 700 701 702 706 708 717 718 720 722 723 724 753 757 758 761 770 771 773 777 778 779 786 792 793 794 802 804 805 808 819 820 822 826 827 828 829 835 843 844 845 846 848 849 856 862 864 870 884 897 898 908 
24 27 66 76 77 103 104 105 106 107 108 109 110 111 113 114 115 134 135 136 137 139 140 142 143 144 145 167 168 169 170 171 212 213 214 247 248 249 250 252 253 254 255 256 257 259 260 261 304 305 306 307 308 309 311 312 313 314 315 346 347 350 362 363 389 390 446 457 458 459 460 461 481 482 489 490 492 494 495 497 500 547 553 554 555 561 562 563 564 565 566 567 584 585 640 713 714 731 759 768 769 772 774 775 790 798 815 821 833 842 847 850 866 867 887 888 892 893 899 900 901 902 
42 43 71 72 73 96 97 98 99 127 128 172 173 174 175 176 177 197 342 343 360 413 414 415 428 464 465 496 502 507 508 509 510 511 512 513 556 557 558 559 570 571 572 573 574 575 578 586 587 614 637 638 639 688 694 699 703 704 705 710 754 755 787 789 796 837 838 865 
33 34 55 57 58 179 180 181 182 183 184 185 186 187 188 189 190 191 192 193 194 196 198 199 200 201 202 203 205 206 351 392 393 405 406 407 408 409 410 411 412 447 589 636 696 707 736 776 886 896 903 909 
302 326 328 329 330 331 333 334 335 336 337 338 339 340 372 374 375 376 377 404 467 468 514 515 516 517 526 527 545 592 689 690 877 878 879 894 907 
78 79 310 434 435 445 613 615 616 641 642 643 644 645 646 647 648 649 658 659 660 667 712 729 730 799 800 801 816 817 818 874 875 876 882 883 
51 56 60 65 93 141 163 165 444 463 505 506 529 544 601 611 719 746 747 749 750 752 762 763 764 765 780 803 812 813 814 836 890 891 
16 17 18 19 20 23 204 232 233 235 318 319 320 321 322 538 539 542 579 580 588 590 806 807 825 
0 1 2 4 5 25 26 178 327 332 353 373 391 499 596 597 760 809 855 871 
288 289 291 292 294 295 296 297 298 299 300 301 303 476 480 593 863 
210 371 421 422 453 454 455 473 474 475 609 610 612 697 698 781 
15 59 138 369 397 398 399 400 401 402 403 466 748 751 
195 532 533 534 535 536 650 651 652 653 727 728 
155 266 267 268 269 270 283 284 581 582 839 
35 36 37 38 207 528 635 686 687 881 
243 245 439 440 441 442 443 617 834 885 
290 418 419 450 451 452 711 868 872 873 
236 237 238 239 240 241 242 788 889 
29 30 31 32 654 840 841 
228 229 230 485 486 487 795 
366 367 368 370 791 851 852 
674 675 678 740 741 853 854 
151 152 153 281 282 
521 522 523 524 797 
22 348 349 869 
276 277 668 669 
293 709 739 
323 324 325 
