3 6 10 12 13 14 15 67 68 231 266 267 269 276 277 342 344 439 440 441 442 443 456 502 616 617 668 669 712 722 723 724 729 730 760 761 777 778 786 792 793 834 835 838 839 849 882 883 884 885 
8 9 55 56 59 60 64 65 93 122 129 130 132 157 270 296 366 367 369 370 380 401 462 463 719 808 820 821 825 836 844 845 846 
97 125 128 175 176 352 353 354 355 356 357 358 507 508 509 510 511 512 513 558 688 709 739 791 819 865 897 
289 294 297 298 299 301 326 327 328 330 331 333 334 335 336 337 338 339 340 372 374 375 376 377 545 593 871 
102 103 104 105 106 107 108 109 110 111 112 113 114 115 212 213 214 262 311 312 313 553 554 555 847 892 
247 248 249 251 252 253 254 255 256 259 261 561 562 563 564 565 566 567 640 713 759 815 833 870 
42 44 45 46 47 48 49 50 51 52 53 54 208 209 210 211 476 477 478 479 577 657 848 
146 147 148 149 150 218 219 220 221 222 225 227 278 279 280 444 448 449 504 672 673 843 
62 66 155 268 271 272 273 274 275 283 284 397 398 399 400 402 403 466 547 702 794 
24 27 28 76 134 135 136 137 139 140 142 143 144 145 457 458 459 460 461 560 
71 72 73 96 98 99 127 415 557 570 571 572 573 574 575 578 586 587 699 
57 189 190 191 192 193 198 199 204 206 393 636 637 696 707 806 807 
37 63 141 503 529 546 635 717 718 812 813 814 829 899 900 901 
80 81 82 83 84 85 86 87 88 89 90 548 549 550 656 904 
7 11 341 343 516 576 613 614 615 787 789 874 875 876 898 
0 1 4 5 332 373 391 520 521 522 523 524 597 809 
153 345 346 347 480 559 622 746 747 748 749 751 752 908 
158 159 160 161 162 163 164 165 166 359 394 395 396 773 
186 187 188 194 196 197 200 201 203 205 447 736 837 909 
17 19 23 232 233 234 235 318 319 320 321 322 589 
20 94 95 537 538 539 540 541 542 543 544 591 
61 120 121 123 126 131 133 151 154 291 695 750 
74 181 288 290 418 419 424 425 427 451 452 711 
179 180 182 183 184 185 621 624 625 886 896 
351 405 406 407 408 409 410 411 412 776 903 
641 642 643 645 646 647 648 649 658 659 660 
43 172 173 174 177 360 464 465 694 710 
100 101 436 437 438 631 632 633 634 880 
310 492 493 799 800 801 816 817 818 850 
420 421 422 423 453 454 455 488 779 781 
195 532 533 534 535 536 653 727 728 
228 229 230 485 486 487 795 864 
246 250 257 258 260 714 731 772 
300 303 674 675 678 740 741 863 
304 305 306 307 308 309 667 867 
494 495 496 497 498 499 500 796 
167 168 170 171 481 482 842 
156 361 362 363 364 365 
236 237 238 240 241 242 
314 315 389 390 588 601 
384 385 386 483 484 525 
2 169 178 446 790 
16 18 21 22 426 
116 117 118 119 501 
223 224 226 579 580 
239 324 804 805 889 
329 689 690 877 878 
387 388 606 607 608 
473 474 475 697 698 
489 490 491 866 893 
514 515 517 526 527 
600 609 610 611 802 
623 626 627 628 629 
681 682 683 737 738 
31 654 655 706 
35 38 687 881 
39 40 41 721 
124 243 244 245 
295 753 754 755 
302 404 467 468 
428 429 430 431 
551 552 715 716 
592 868 872 873 
598 599 803 822 
618 619 620 644 
664 665 666 784 
670 671 742 743 
676 677 770 771 
703 704 705 797 
732 733 734 735 
762 763 764 765 
29 32 841 
33 34 58 
36 207 528 
69 70 630 
77 887 888 
152 281 282 
215 216 217 
263 264 265 
285 286 287 
292 853 854 
323 325 708 
348 349 869 
368 851 852 
378 379 602 
381 382 383 
392 471 472 
434 435 445 
450 700 701 
469 470 785 
505 506 780 
556 638 639 
568 569 663 
583 584 585 
603 604 605 
650 651 652 
661 662 902 
679 680 861 
691 692 693 
725 726 895 
744 745 756 
774 775 798 
826 827 828 
830 831 832 
879 894 907 
