0 1 2 3 4 5 6 7 8 9 10 11 12 13 14 21 24 31 32 44 45 46 47 48 49 50 52 53 54 61 62 63 64 66 67 68 74 75 80 81 82 83 84 85 86 87 88 89 90 94 95 102 112 116 120 121 122 123 124 125 126 129 130 131 132 133 134 143 146 147 148 149 150 154 156 157 158 159 160 161 162 164 166 169 178 181 184 208 209 210 211 220 221 222 225 227 231 234 244 258 262 271 272 273 274 275 278 279 280 309 341 344 345 346 347 352 354 355 356 357 358 359 361 364 365 371 380 381 382 383 420 421 422 423 424 425 426 427 448 449 453 454 455 456 462 471 472 473 474 475 476 477 478 479 488 491 493 498 499 504 520 537 540 541 543 546 548 549 550 560 561 563 564 567 576 577 583 585 591 598 599 600 609 610 612 618 619 621 622 623 624 625 626 627 628 629 654 655 657 661 662 672 673 676 677 695 697 698 706 708 717 718 720 722 723 724 753 757 758 761 770 771 772 773 779 781 786 793 794 802 804 805 808 815 819 820 822 826 827 828 835 841 843 844 845 846 848 849 856 864 884 886 897 898 908 
42 43 71 72 73 96 97 98 99 127 128 172 173 174 175 176 177 197 202 342 343 350 360 413 414 415 428 429 430 431 464 465 496 497 507 508 509 510 511 512 513 556 557 558 559 570 571 572 573 574 575 578 586 587 637 638 639 688 694 699 710 754 755 787 789 791 796 837 838 865 
76 77 135 136 137 139 140 142 144 145 246 247 248 249 250 251 252 253 254 255 256 257 259 260 261 304 305 306 307 308 384 385 386 457 458 459 460 461 483 484 489 490 492 494 495 500 525 562 565 566 640 713 714 731 759 768 769 833 850 851 852 862 866 867 870 887 888 893 
35 36 37 38 103 104 105 106 107 108 109 110 111 113 114 115 207 212 213 214 218 311 312 313 314 315 362 363 389 390 446 528 547 553 554 555 584 635 686 687 774 775 790 798 821 847 881 892 899 900 901 902 
33 34 51 55 56 58 60 65 93 141 151 152 153 163 165 281 282 444 463 506 529 538 544 601 611 719 746 747 749 750 752 762 763 764 765 780 803 812 813 814 836 890 891 
78 79 310 405 434 435 445 613 614 615 616 620 641 642 643 644 645 646 647 648 649 658 659 660 667 712 729 730 799 800 801 816 817 818 874 875 876 882 883 
29 30 326 328 329 330 331 333 334 335 336 337 338 339 340 372 374 375 376 377 404 514 515 516 517 526 527 545 592 689 690 840 877 878 879 894 907 
57 186 187 188 189 190 191 192 193 194 196 198 199 200 201 203 205 206 348 351 392 393 406 407 408 409 410 412 447 636 696 707 736 776 903 909 
16 17 18 19 20 23 204 223 224 226 232 233 235 318 319 320 321 322 539 542 579 580 588 590 806 807 825 
179 180 182 183 185 195 532 533 534 535 536 589 650 651 652 653 727 728 896 
288 289 291 292 294 295 296 297 298 299 300 301 303 480 593 863 
15 59 138 369 397 398 399 400 401 402 403 466 748 751 
25 327 332 353 373 391 596 597 760 809 855 871 
155 266 267 268 269 270 283 284 581 582 839 
243 245 439 440 441 442 443 617 834 885 
290 418 419 450 451 452 700 701 702 711 
236 237 238 239 240 241 242 788 889 
521 522 523 524 703 704 705 797 
167 168 170 171 481 482 842 
228 229 230 485 486 487 795 
674 675 678 740 741 853 854 
276 277 668 669 
302 467 468 505 
366 367 368 370 
22 349 869 
293 709 739 
323 324 325 
394 395 396 
502 503 829 
777 778 792 
868 872 873 
