3 11 15 256 266 268 269 331 342 344 346 347 439 440 441 442 443 456 480 502 561 564 567 592 613 616 712 720 729 730 760 777 778 786 792 793 834 835 838 839 849 868 882 883 884 
9 55 56 59 61 120 121 122 123 126 129 130 131 132 133 151 154 270 291 366 369 370 371 462 612 695 750 808 820 821 844 845 846 
236 237 238 240 241 242 290 301 326 327 328 330 333 334 335 337 338 339 340 367 372 373 374 375 376 377 404 446 467 468 545 790 871 
146 147 148 149 150 218 219 220 221 222 223 224 225 226 227 278 279 280 411 444 448 449 504 672 673 843 
57 186 189 190 191 192 193 195 198 199 200 201 204 206 292 393 532 533 535 636 637 696 707 806 807 
96 97 99 125 128 175 176 352 353 354 355 356 357 358 512 558 688 709 739 791 819 897 
37 63 141 503 506 529 546 579 580 635 686 717 718 780 812 813 814 829 899 900 901 
187 351 405 406 407 408 409 641 642 643 645 646 647 648 649 658 659 660 776 903 
24 25 26 27 28 134 135 136 137 139 140 142 143 144 145 368 402 851 852 
188 194 196 197 202 203 205 348 349 350 410 447 576 736 837 869 909 
304 305 307 308 309 310 489 490 491 492 799 800 801 850 866 867 893 
8 60 65 93 157 296 318 319 380 401 463 539 590 719 825 836 
13 153 345 412 618 619 620 622 644 746 747 748 749 751 752 908 
80 81 82 83 84 85 86 87 88 89 90 548 549 550 656 904 
289 294 297 298 299 300 303 593 674 675 678 740 741 853 854 863 
246 247 248 249 250 252 257 258 259 261 562 563 640 815 833 
329 341 343 516 559 689 690 787 789 874 875 876 877 878 898 
50 51 52 53 54 208 209 210 211 476 477 657 848 
102 104 106 107 111 113 115 213 214 262 312 313 847 
103 105 108 109 110 112 114 212 311 553 554 555 892 
62 283 284 397 398 399 400 403 466 547 585 794 
17 19 23 232 233 234 235 320 321 322 589 
20 94 95 537 538 540 541 542 543 544 591 
74 75 181 418 419 424 425 427 451 452 711 
42 44 45 46 47 48 49 478 479 577 
98 415 507 508 509 510 511 513 699 865 
100 101 436 437 438 631 632 633 634 880 
43 172 173 174 177 360 464 465 694 
314 315 389 390 455 473 588 601 781 
29 31 32 654 655 706 840 841 
155 159 164 165 762 763 764 765 
158 160 161 162 163 166 359 773 
179 182 184 621 624 625 886 896 
228 229 230 485 486 487 795 864 
420 421 422 423 453 454 488 779 
474 475 600 609 610 611 697 698 
35 36 38 207 528 687 881 
71 72 73 571 574 575 578 
167 168 170 171 481 482 842 
494 495 496 497 498 499 500 
76 457 458 459 460 461 
127 557 570 572 573 586 
156 361 362 363 364 365 
306 493 667 816 817 818 
384 385 386 483 484 525 
6 7 10 12 14 
16 18 21 22 426 
64 124 243 244 245 
66 273 583 584 702 
116 117 118 119 501 
239 324 804 805 889 
254 560 759 856 862 
295 710 753 754 755 
387 388 606 607 608 
514 515 517 526 527 
598 599 802 803 822 
623 626 627 628 629 
681 682 683 737 738 
703 704 705 796 797 
39 40 41 721 
67 68 231 761 
253 260 714 731 
271 272 274 275 
276 277 668 669 
332 391 597 809 
428 429 430 431 
521 522 523 524 
551 552 715 716 
664 665 666 784 
670 671 742 743 
676 677 770 771 
732 733 734 735 
1 4 5 
2 169 178 
30 336 587 
33 34 58 
69 70 630 
77 887 888 
152 281 282 
215 216 217 
255 565 713 
263 264 265 
267 617 885 
285 286 287 
323 325 708 
378 379 602 
381 382 383 
392 471 472 
394 395 396 
434 435 445 
450 700 701 
469 470 785 
556 638 639 
568 569 663 
603 604 605 
661 662 902 
679 680 861 
691 692 693 
722 723 724 
725 726 895 
744 745 756 
774 775 798 
826 827 828 
830 831 832 
879 894 907 
