3 11 21 44 50 52 53 54 74 75 102 123 129 130 131 132 133 146 147 148 150 164 181 184 208 209 211 218 219 220 221 222 223 224 225 226 227 258 279 280 309 344 345 352 354 355 356 357 358 361 365 420 423 424 425 426 427 449 471 472 477 478 488 491 493 498 504 520 540 598 599 600 657 672 673 695 720 753 772 779 786 793 802 804 805 819 822 835 843 849 886 908 
6 7 8 9 10 12 14 31 32 61 62 63 80 82 84 85 89 90 94 95 112 121 122 125 126 149 154 157 158 159 160 161 162 166 234 278 341 359 456 462 503 537 541 543 549 560 576 577 583 591 621 622 624 625 654 655 661 662 706 708 717 718 773 794 808 820 829 841 844 845 846 856 864 897 898 
25 29 30 326 328 329 330 331 332 333 334 335 336 337 338 339 340 353 372 373 374 375 376 377 391 404 467 468 592 597 689 690 809 840 877 878 
72 96 97 98 127 128 175 176 415 428 507 508 509 510 511 512 513 557 558 570 572 573 574 575 578 586 587 637 688 699 865 
186 187 188 189 190 191 194 196 198 200 202 203 205 206 351 393 405 406 407 408 409 410 411 412 447 636 736 776 903 909 
246 247 248 249 250 251 252 253 255 256 257 259 261 561 562 563 564 565 566 567 640 713 815 833 
51 56 60 65 93 141 163 165 444 463 505 506 529 544 546 601 719 765 780 812 813 814 836 
103 104 105 106 107 108 109 110 111 114 212 213 214 311 312 313 363 554 555 892 
24 76 134 135 136 137 139 140 142 143 145 254 457 458 459 460 461 759 862 
288 289 291 292 294 295 296 297 298 299 300 301 302 303 476 480 593 863 
66 113 115 314 315 389 390 547 553 584 585 821 847 899 900 901 902 
42 43 45 46 47 48 49 172 173 174 177 360 464 465 694 848 
17 23 204 318 319 320 321 322 579 580 806 807 825 
641 642 643 644 645 646 647 648 649 658 659 660 
16 18 19 20 232 233 235 538 539 542 
35 36 37 38 207 528 635 686 687 881 
71 73 99 496 559 571 703 704 705 796 
138 369 397 398 399 400 401 402 403 466 
611 746 747 749 750 752 762 763 764 803 
197 342 343 350 502 787 789 837 838 
236 237 238 239 240 241 242 788 889 
305 307 308 489 490 492 850 866 893 
613 614 615 616 712 729 730 882 883 
81 83 86 87 88 116 548 550 
310 667 799 800 801 816 817 818 
473 474 475 609 610 612 697 698 
0 1 2 4 5 178 499 
144 346 347 494 495 497 500 
167 168 170 171 481 482 842 
179 180 182 183 185 589 896 
210 366 367 368 370 371 791 
674 675 678 740 741 853 854 
195 532 533 534 535 536 
243 245 440 442 617 885 
260 304 306 714 731 867 
290 418 419 451 452 711 
384 385 386 483 484 525 
421 422 453 454 455 781 
151 152 153 281 282 
192 193 201 696 707 
228 229 230 485 486 
266 267 269 270 839 
514 515 517 526 527 
623 626 627 628 629 
15 59 748 751 
22 348 349 869 
33 34 55 58 
67 68 231 761 
155 268 283 284 
169 362 446 790 
271 272 274 275 
276 277 668 669 
380 381 382 383 
439 441 443 834 
450 700 701 702 
676 677 770 771 
57 199 392 
64 124 244 
77 887 888 
120 156 262 
273 364 448 
293 709 739 
323 324 325 
327 760 871 
394 395 396 
434 435 445 
522 523 524 
556 638 639 
618 619 620 
650 651 652 
653 727 728 
710 754 755 
722 723 724 
774 775 798 
777 778 792 
826 827 828 
868 872 873 
874 875 876 
879 894 907 
