0 1 2 3 4 5 6 7 8 10 11 12 13 14 21 24 27 28 31 32 44 45 46 47 48 49 50 52 53 54 62 63 66 67 68 74 75 80 81 82 83 84 85 86 87 88 89 90 94 95 102 112 116 123 125 129 130 131 132 133 134 143 146 147 148 149 150 157 158 159 160 161 162 164 166 169 178 181 184 208 209 211 220 221 222 225 227 231 234 258 271 272 273 274 275 278 279 280 309 341 344 345 346 347 352 354 355 356 357 358 359 361 362 363 364 365 380 381 382 383 394 395 396 420 423 424 425 426 427 434 435 445 448 449 456 462 471 472 476 477 478 479 488 491 493 498 504 520 537 540 541 543 548 549 550 560 561 563 564 567 576 577 583 585 591 598 599 600 613 614 615 616 618 619 621 622 623 624 626 627 628 629 654 655 657 661 662 672 673 676 677 695 702 706 708 712 717 718 720 722 723 724 729 730 753 757 758 761 770 771 772 773 779 786 793 794 802 804 805 815 819 822 826 827 828 835 841 843 848 849 856 874 875 876 882 883 884 886 897 898 908 
9 61 64 103 104 105 106 107 108 109 110 111 113 114 115 120 121 122 124 126 151 152 153 154 156 210 212 213 214 218 244 262 281 282 311 312 313 314 315 371 389 390 421 422 446 453 454 455 473 474 475 547 553 554 555 584 609 610 612 697 698 774 775 781 790 798 808 820 821 844 845 846 847 864 892 899 900 901 902 
42 43 71 72 73 96 97 98 99 127 128 172 173 174 175 176 177 197 342 343 360 413 414 415 428 429 430 431 464 465 496 507 508 509 510 511 512 513 556 557 558 559 570 571 572 573 574 575 578 586 587 637 638 639 688 694 699 710 754 755 787 789 791 796 837 838 865 
57 179 180 182 183 185 186 187 188 189 190 191 192 193 194 195 196 198 199 200 201 202 203 205 206 219 348 350 351 392 393 405 406 407 408 409 410 411 412 447 532 533 534 535 536 589 620 636 641 642 643 644 645 646 647 648 649 658 659 660 696 707 736 776 896 903 909 
25 26 29 30 326 327 328 329 330 331 332 333 334 335 336 337 338 339 340 353 372 373 374 375 376 377 391 404 467 468 516 545 592 596 597 689 690 760 809 840 855 871 877 878 879 894 907 
78 79 135 137 139 140 142 144 145 250 253 255 257 260 304 305 306 307 308 310 489 490 492 494 495 497 499 500 565 625 667 713 714 731 768 769 799 800 801 816 850 851 852 866 867 893 
33 34 51 55 56 58 60 65 93 141 163 165 444 463 506 529 544 546 601 611 719 746 747 749 750 752 762 763 764 765 780 803 812 813 814 836 890 891 
76 77 136 246 247 248 249 251 252 254 256 259 261 384 385 386 457 458 459 460 461 483 484 525 562 566 640 759 833 862 870 887 888 
16 17 18 19 20 23 204 223 224 226 232 233 235 318 319 320 321 322 538 539 542 579 580 588 590 806 807 825 
288 289 291 292 294 295 296 297 298 299 300 301 302 303 480 505 593 678 863 
15 59 138 369 397 398 399 400 401 402 403 466 748 751 
155 266 267 268 269 270 283 284 502 503 581 582 829 839 
35 36 37 38 207 528 635 686 687 881 
243 245 439 440 441 442 443 617 834 885 
236 237 238 239 240 241 242 788 889 
290 418 419 450 451 452 700 701 711 
521 522 523 524 703 704 705 797 
167 168 170 171 481 482 842 
228 229 230 485 486 487 795 
674 675 740 741 853 854 
514 515 517 526 527 
276 277 668 669 
366 367 368 370 
22 349 869 
293 709 739 
323 324 325 
653 727 728 
777 778 792 
868 872 873 
