3 21 44 102 103 104 105 106 108 109 110 114 130 131 132 133 266 272 276 277 295 352 354 358 361 423 439 440 441 442 443 472 478 489 490 491 492 493 494 495 496 498 513 576 616 668 669 753 754 755 760 777 778 779 792 793 796 804 805 822 834 835 849 866 
8 12 13 14 16 31 32 60 61 65 66 93 94 95 112 125 126 149 160 212 214 271 296 323 325 345 380 456 463 554 555 558 609 610 611 621 622 624 654 655 706 708 719 746 747 748 749 751 752 836 841 856 892 897 908 
29 30 288 289 290 294 297 298 299 301 326 327 328 329 330 331 333 334 335 336 337 338 339 340 349 373 374 375 376 377 404 593 730 840 869 871 877 878 
87 186 187 188 194 195 196 197 200 201 202 203 205 206 348 350 351 405 406 407 408 409 410 411 447 497 648 696 736 776 837 903 909 
35 36 37 38 113 115 121 207 314 315 389 390 473 474 475 528 612 635 686 687 697 698 847 881 899 900 901 902 
50 51 52 53 54 134 141 150 192 208 210 273 364 444 448 449 588 598 599 600 601 702 707 802 803 813 814 
246 247 251 252 253 254 255 256 259 260 261 561 562 564 565 566 567 640 759 815 833 
72 97 127 175 176 357 557 570 572 573 574 575 578 586 587 739 791 819 
179 181 182 184 392 418 419 450 451 452 471 700 701 711 886 896 
6 7 9 10 11 15 228 229 292 485 486 487 808 844 864 
55 56 58 64 129 220 244 366 368 369 370 399 401 403 695 
62 90 232 283 284 424 425 426 427 577 584 585 794 820 821 
107 122 151 152 154 155 156 157 281 282 363 455 781 845 846 
42 43 128 172 173 174 177 360 415 464 465 694 710 848 
33 34 233 235 291 537 538 539 540 541 542 543 591 
63 236 237 238 239 240 241 242 324 545 717 718 889 
211 341 583 613 661 662 765 787 789 874 875 876 898 
304 305 307 308 310 713 714 731 799 800 801 867 893 
17 18 19 20 22 234 318 319 320 321 589 825 
80 81 82 84 85 86 88 89 548 549 550 904 
147 219 221 222 223 224 225 226 579 580 672 673 
57 189 190 191 193 198 199 204 393 806 807 
100 101 436 437 438 631 632 633 634 850 880 
158 159 161 162 163 164 165 166 359 544 773 
300 303 674 675 678 740 741 853 854 863 
355 428 507 508 509 510 511 512 865 
0 1 2 4 5 178 332 372 
45 46 47 48 49 476 477 657 
641 643 645 646 649 658 659 660 
76 136 457 458 459 460 461 
146 148 227 278 279 280 843 
167 168 170 171 481 482 842 
248 249 250 257 258 563 772 
384 385 386 483 484 525 862 
24 25 26 27 28 391 
71 73 99 500 559 571 
96 98 516 614 615 699 
153 342 344 346 347 480 
180 532 533 534 535 536 
302 467 468 505 506 780 
322 553 712 729 882 883 
420 421 422 453 454 488 
59 462 762 763 764 
124 243 245 689 690 
169 362 365 446 790 
267 269 617 839 885 
514 515 517 526 527 
521 703 704 705 797 
623 626 627 628 629 
647 812 816 817 818 
67 68 231 761 
117 118 119 501 
123 209 504 750 
135 139 142 145 
143 144 270 560 
213 262 619 642 
293 590 618 709 
371 529 597 809 
397 398 402 466 
592 868 872 873 
676 677 770 771 
732 733 734 735 
23 343 786 
74 75 720 
77 887 888 
83 116 656 
120 546 547 
137 499 625 
140 851 852 
306 309 667 
311 312 313 
367 520 838 
381 382 383 
394 395 396 
412 620 644 
429 430 431 
434 435 445 
479 870 884 
502 503 829 
522 523 524 
556 638 639 
636 637 688 
650 651 652 
653 727 728 
722 723 724 
774 775 798 
826 827 828 
879 894 907 
