0 3 11 21 32 42 44 45 46 47 48 49 50 52 53 54 123 130 132 133 155 158 159 160 161 162 164 166 208 209 211 220 221 222 223 224 226 258 276 277 309 352 354 355 358 359 420 421 422 423 426 439 440 441 442 443 453 454 456 471 472 476 477 478 479 488 491 493 540 598 599 600 619 654 655 657 668 669 672 673 676 677 706 708 753 755 760 770 771 773 777 778 779 786 792 804 805 822 834 835 841 848 849 
16 17 18 19 20 22 23 57 81 83 84 86 87 88 116 179 181 182 184 186 187 188 189 190 191 192 193 194 195 196 198 199 200 201 202 203 204 205 206 232 233 235 318 319 320 321 322 349 351 392 393 405 406 407 408 409 410 411 412 447 542 548 550 579 580 588 589 590 636 648 674 678 696 707 736 740 741 776 806 807 825 854 869 886 896 903 909 
25 29 30 31 236 237 238 239 240 241 242 290 323 324 325 326 327 328 329 330 331 332 333 334 335 336 337 338 339 340 353 356 372 373 374 375 376 377 391 404 418 419 434 435 445 450 451 452 545 592 596 616 620 641 642 643 644 645 646 647 649 658 659 660 711 712 729 730 788 840 855 868 871 872 873 877 878 879 882 883 889 894 907 
6 7 8 10 12 13 14 24 62 63 66 80 82 85 89 90 121 134 138 143 157 234 283 341 346 366 367 368 370 380 381 382 383 424 425 427 520 521 522 523 524 537 541 543 547 549 560 561 563 564 567 577 583 585 591 612 618 621 622 623 624 626 627 628 629 661 662 717 718 757 758 791 794 797 815 856 884 898 
76 77 78 79 135 136 137 139 140 142 144 145 246 247 248 249 250 251 252 253 254 255 256 257 259 260 261 304 305 306 307 308 310 384 385 386 457 458 459 460 461 483 484 489 490 492 525 562 565 566 640 667 713 714 731 759 768 769 772 799 800 801 816 833 850 851 852 862 866 867 870 887 888 893 
1 2 4 5 9 61 74 75 94 95 120 122 124 125 126 131 154 156 169 178 228 229 230 243 245 262 284 357 446 485 486 487 546 558 584 637 688 689 690 695 720 774 775 790 795 798 808 819 820 821 844 845 846 864 897 
37 102 103 104 105 106 107 108 109 110 111 112 113 114 115 210 212 213 214 311 312 313 314 315 361 362 363 364 365 371 389 390 455 473 474 475 529 553 554 555 597 609 610 635 686 697 698 781 809 847 892 899 900 901 902 
43 72 97 98 128 172 173 174 175 176 177 360 413 414 415 428 464 465 507 513 556 557 570 572 573 574 575 578 586 587 613 614 615 638 639 694 699 710 754 865 874 875 876 
33 34 51 55 56 58 60 64 65 93 129 141 163 165 244 462 463 505 506 538 544 601 611 719 746 747 749 752 765 780 802 803 812 813 814 836 890 891 
71 73 96 99 127 197 342 343 344 345 494 495 496 499 500 514 515 516 517 526 527 559 571 625 787 789 796 837 838 908 
146 147 148 149 150 218 219 225 227 271 272 273 274 275 278 279 280 444 448 449 504 700 701 702 826 827 828 843 
15 59 266 267 268 269 270 369 397 398 399 400 401 402 403 466 502 503 581 582 617 748 751 829 839 885 
288 289 291 292 293 294 295 296 297 298 299 300 301 302 303 347 467 468 480 539 593 675 709 739 853 
180 183 185 532 533 534 535 536 650 651 652 653 727 728 
35 36 38 207 528 687 881 
167 168 170 171 481 482 842 
151 152 153 281 282 
67 68 231 761 
750 762 763 764 
348 350 497 
394 395 396 
498 576 793 
722 723 724 
