0 3 6 7 10 11 12 13 14 15 29 31 32 67 68 231 258 266 268 269 276 277 323 325 331 342 344 345 346 347 434 435 439 440 441 442 443 445 456 480 502 520 521 522 523 524 561 563 564 567 581 582 592 613 614 615 616 622 654 655 668 669 676 677 706 708 712 720 722 723 724 729 730 746 747 748 749 750 751 752 760 761 770 771 772 777 778 786 792 793 815 834 835 838 839 840 841 849 868 882 883 884 908 
153 187 188 194 196 197 202 203 205 329 341 343 348 350 351 405 406 407 408 409 410 412 447 514 515 516 517 526 527 559 576 618 619 620 641 642 643 644 645 646 647 648 649 658 659 660 689 690 736 776 787 789 837 874 875 876 877 878 879 894 898 903 907 909 
8 9 33 34 55 56 58 59 60 61 64 65 93 120 121 122 123 124 126 129 130 131 132 133 151 154 157 243 244 245 270 291 296 318 319 366 369 370 371 401 462 463 539 590 597 612 695 719 757 758 808 809 820 821 825 836 844 845 846 
43 71 72 73 96 97 98 99 125 127 128 172 173 174 175 176 177 352 353 354 355 356 357 358 360 413 414 415 464 465 507 508 509 510 511 512 513 556 557 558 570 571 572 573 574 575 578 586 638 639 688 694 699 709 739 791 819 865 897 
30 236 237 238 240 241 242 290 301 326 327 328 330 332 333 334 335 336 337 338 339 340 349 367 372 373 374 375 376 377 391 404 446 467 468 545 587 596 774 775 790 798 855 869 871 
24 25 26 27 28 76 77 134 135 136 137 138 139 140 142 143 144 145 251 254 368 384 385 386 402 457 458 459 460 461 483 484 525 560 759 788 851 852 856 862 870 887 888 
35 36 37 38 63 74 75 141 181 207 418 419 424 425 427 451 452 503 506 528 529 546 579 580 635 686 687 711 717 718 780 812 813 814 829 881 890 891 899 900 901 
57 186 189 190 191 192 193 195 198 199 200 201 204 206 289 292 294 297 298 299 300 303 393 532 533 535 593 636 637 674 675 678 696 707 740 741 806 807 853 854 863 
78 79 100 101 304 305 306 307 308 309 310 436 437 438 489 490 491 492 493 631 632 633 634 667 799 800 801 816 817 818 850 866 867 880 893 
102 103 104 105 106 107 108 109 110 111 112 113 114 115 212 213 214 262 311 312 313 553 554 555 847 892 
146 147 148 149 150 218 219 220 221 222 223 224 225 226 227 278 279 280 411 444 448 449 504 672 673 843 
42 44 45 46 47 48 49 50 51 52 53 54 208 209 210 211 476 477 478 479 577 657 848 
62 66 271 272 273 274 275 283 284 397 398 399 400 403 466 547 583 584 585 794 826 827 828 
246 247 248 249 250 252 253 255 256 257 259 260 261 562 565 566 640 713 714 731 768 769 833 
314 315 389 390 455 473 474 475 588 598 599 600 601 609 610 611 697 698 781 802 803 822 
80 81 82 83 84 85 86 87 88 89 90 548 549 550 656 732 733 734 735 904 
155 158 159 160 161 162 163 164 165 166 359 394 395 396 762 763 764 765 773 
179 180 182 183 184 185 536 621 623 624 625 626 627 628 629 886 896 
16 17 18 19 21 22 23 232 233 234 235 320 321 322 426 589 
1 2 4 5 167 168 169 170 171 178 481 482 842 
20 94 95 537 538 540 541 542 543 544 591 
228 229 230 485 486 487 795 864 
420 421 422 423 453 454 488 779 
387 388 416 417 606 607 608 
494 495 496 497 498 499 500 
156 361 362 363 364 365 
116 117 118 119 501 
239 324 804 805 889 
295 710 753 754 755 
681 682 683 737 738 
703 704 705 796 797 
39 40 41 721 
288 293 302 505 
380 381 382 383 
428 429 430 431 
450 700 701 702 
551 552 715 716 
664 665 666 784 
670 671 742 743 
69 70 630 
152 281 282 
215 216 217 
263 264 265 
267 617 885 
285 286 287 
378 379 602 
392 471 472 
469 470 785 
568 569 663 
603 604 605 
661 662 902 
679 680 861 
691 692 693 
725 726 895 
744 745 756 
830 831 832 
