43 71 72 73 96 97 98 99 125 127 128 172 173 174 175 176 177 352 353 354 355 356 357 358 360 413 414 415 464 465 507 508 509 510 511 512 513 557 558 570 571 572 573 574 575 578 586 587 688 694 699 710 753 754 755 791 819 865 897 
8 9 33 34 55 56 58 59 60 61 64 65 93 120 121 122 123 124 126 129 130 131 132 133 151 152 154 157 243 244 245 281 282 366 367 370 380 381 382 383 462 463 617 695 719 750 757 758 808 820 821 836 844 845 846 885 
74 75 181 290 302 326 327 328 329 330 331 332 333 334 335 336 337 338 339 340 372 373 374 375 376 377 391 404 418 419 424 425 427 451 452 467 468 505 506 545 596 689 690 711 720 780 855 871 877 878 879 894 907 
57 186 187 188 189 190 191 192 193 194 196 197 198 199 200 201 202 203 204 205 206 348 349 350 351 392 393 405 406 407 408 409 410 411 412 447 471 472 636 637 696 707 736 776 806 807 837 869 903 909 
3 67 68 231 276 277 434 435 439 440 441 442 443 445 456 613 614 615 616 668 669 676 677 712 722 723 724 729 730 760 761 770 771 777 778 786 792 793 834 835 849 882 883 
6 7 10 11 12 13 14 15 153 341 342 343 344 345 346 347 514 515 516 517 526 527 559 576 622 746 747 748 749 751 752 787 789 838 874 875 876 884 898 908 
63 141 146 147 148 149 150 218 219 220 221 222 223 224 225 226 227 278 279 280 444 448 449 503 504 529 546 579 580 672 673 717 718 812 813 814 829 843 890 891 
35 36 37 38 207 314 315 371 389 390 473 474 475 528 597 598 599 600 601 609 610 611 612 635 661 662 686 687 697 698 802 803 809 822 881 899 900 901 902 
16 17 18 19 20 21 22 23 94 95 232 233 234 235 293 318 319 320 321 322 426 537 538 539 540 541 542 543 544 588 589 590 591 709 739 825 
78 79 100 101 304 305 306 307 308 309 310 436 437 438 489 490 491 492 493 631 632 633 634 667 799 800 801 816 817 818 850 866 867 880 893 
246 247 248 249 250 251 252 253 254 255 256 257 258 259 260 261 561 562 563 564 565 566 567 640 713 714 731 759 768 769 772 815 833 870 
24 25 26 27 28 76 77 134 135 136 137 139 140 142 143 144 145 368 457 458 459 460 461 560 851 852 887 888 
179 180 182 183 184 185 195 532 533 534 535 536 621 623 624 625 626 627 628 629 650 651 652 653 727 728 886 896 
62 66 155 156 271 272 273 274 275 283 284 361 362 363 364 365 450 583 584 585 700 701 702 794 826 827 828 
102 103 104 105 106 107 108 109 110 111 112 113 114 115 212 213 214 262 311 312 313 547 553 554 555 847 892 
0 1 2 4 5 167 168 169 170 171 178 446 481 482 520 521 522 523 524 774 775 790 798 842 
42 44 45 46 47 48 49 50 51 52 53 54 208 209 210 211 476 477 478 479 577 657 848 
288 289 291 292 294 295 296 297 298 299 300 301 303 480 593 674 675 678 740 741 853 854 863 
80 81 82 83 84 85 86 87 88 89 90 548 549 550 656 732 733 734 735 904 
158 159 160 161 162 163 164 165 166 359 394 395 396 762 763 764 765 773 
266 267 268 269 270 369 397 398 399 400 401 402 403 466 502 581 582 839 
138 236 237 238 239 240 241 242 323 324 325 708 788 804 805 889 
618 619 620 641 642 643 644 645 646 647 648 649 658 659 660 
494 495 496 497 498 499 500 703 704 705 796 797 
420 421 422 423 453 454 455 488 779 781 
29 30 31 32 654 655 706 840 841 
228 229 230 485 486 487 795 864 
384 385 386 483 484 525 856 862 
387 388 416 417 606 607 608 
116 117 118 119 501 
681 682 683 737 738 
39 40 41 721 
428 429 430 431 
551 552 715 716 
592 868 872 873 
664 665 666 784 
670 671 742 743 
69 70 630 
215 216 217 
263 264 265 
285 286 287 
378 379 602 
469 470 785 
556 638 639 
568 569 663 
603 604 605 
679 680 861 
691 692 693 
725 726 895 
744 745 756 
830 831 832 
