1 12 13 15 22 23 32 34 36 40 42 43 53 63 66 69 86 87 93 94 119 148 149 165 174 189 195 208 212 217 219 220 235 245 250 255 257 258 269 272 277 278 296 303 305 306 309 320 322 325 327 339 340 349 350 353 354 360 361 366 374 381 388 392 403 406 413 414 421 433 440 457 467 468 475 489 502 503 508 513 515 516 526 570 573 588 594 599 600 604 608 619 625 626 627 649 650 724 734 765 817 845 867 872 875 877 908 909 917 936 967 979 997 1019 1037 1058 1085 1106 1118 1147 1162 1187 1260 1266 1273 1304 1315 1332 1348 
4 10 30 33 70 88 97 124 133 135 155 158 160 161 172 204 207 243 244 268 271 294 301 302 334 356 379 395 429 453 454 598 615 636 687 693 722 737 778 889 944 1064 1073 1093 1094 1103 1114 1146 1168 1189 1195 1305 
5 57 128 137 171 237 248 318 420 426 437 478 486 530 540 564 566 595 602 616 623 692 710 764 866 915 987 1046 1107 1142 1194 1206 1241 1289 1310 
44 178 185 265 317 372 373 391 445 543 618 665 666 768 784 790 916 933 948 954 970 988 1034 1053 1066 1076 1091 1123 1141 1199 1200 1205 1237 1243 1271 
20 31 46 141 238 275 409 410 415 425 428 434 444 527 534 539 545 589 634 653 672 718 785 839 840 899 953 1096 1325 
48 56 191 233 393 418 460 542 603 624 648 656 714 715 742 803 809 969 996 1124 1135 1177 1223 1234 1270 1290 1302 1306 
7 126 336 390 396 397 474 556 561 578 581 582 707 728 748 759 820 945 980 1159 1181 1218 1328 1329 
45 120 378 446 496 497 528 622 708 746 747 752 763 773 815 816 892 1160 1173 1193 1210 1244 1245 
47 147 152 274 295 358 359 394 462 471 523 757 794 798 808 879 880 910 1065 1082 1083 1235 
25 91 213 214 273 299 328 329 484 537 610 729 865 900 903 1014 1188 1249 1319 1324 
84 85 201 209 210 412 473 506 531 702 942 1052 1063 1075 1321 
106 176 188 224 260 261 313 348 419 512 771 974 1068 1208 1275 
18 38 145 405 713 919 1018 1062 1098 1115 1254 1278 1280 1295 
61 62 266 646 876 896 990 1001 1011 1259 1286 1318 1330 1335 
75 83 132 307 375 400 520 601 652 906 907 957 1044 1045 
107 108 187 203 284 298 389 550 611 733 754 860 981 1236 
24 427 452 517 671 704 779 781 856 929 1215 1307 1308 
215 310 311 345 459 494 552 590 654 655 658 744 756 
0 37 104 338 367 498 548 549 583 609 869 978 
254 482 483 641 642 829 830 924 928 1084 1105 1144 
81 285 347 488 569 593 688 795 886 887 1131 
105 116 398 466 490 775 844 1071 1137 1203 1333 
183 184 239 323 337 709 788 958 1069 1130 1204 
102 567 740 854 912 956 1059 1078 1152 1157 
118 129 256 259 308 352 591 645 1023 1331 
192 290 330 331 518 605 731 755 975 1212 
211 216 229 283 441 529 560 664 753 930 
276 493 661 662 836 918 986 989 1101 1221 
14 565 571 596 597 913 1004 1050 1242 
99 198 199 270 297 335 533 628 973 
234 293 442 495 697 758 814 1117 1253 
319 365 435 491 659 766 783 1051 1161 
342 576 738 772 966 993 1111 1222 1248 
3 382 384 385 749 843 1088 1089 
68 640 670 835 893 971 1022 1214 
73 351 404 614 651 800 1077 1207 
103 197 541 705 706 882 982 1031 
182 186 282 782 793 822 964 1054 
357 555 579 632 725 1020 1184 1256 
387 620 717 776 846 847 1097 1192 
524 660 849 961 1166 1216 1351 1354 
677 678 777 862 873 976 1136 1153 
27 60 100 281 332 417 870 
29 76 927 1092 1170 1176 1285 
39 142 223 1067 1108 1225 1347 
59 575 635 780 1033 1035 1036 
64 77 532 631 943 1247 1293 
153 154 225 386 1003 1056 1258 
230 401 450 674 921 1043 1196 
249 644 681 732 811 812 857 
343 344 481 538 577 751 760 
402 621 695 716 831 832 1030 
21 279 818 901 1143 1183 
51 52 221 227 1048 1087 
113 114 196 251 525 723 
130 144 563 606 1238 1239 
138 139 842 1026 1027 1116 
140 447 485 946 1039 1079 
267 968 1025 1090 1230 1303 
368 998 1024 1070 1154 1167 
424 519 585 668 686 959 
509 510 739 828 1299 1343 
535 536 871 1148 1265 1301 
629 801 807 898 1038 1202 
769 939 1190 1274 1284 1316 
853 902 935 1240 1262 1292 
884 885 952 977 999 1277 
1009 1010 1185 1191 1296 1297 
11 694 767 1145 1345 
26 859 951 992 1317 
35 205 314 689 1201 
79 443 574 580 1110 
82 180 288 461 802 
89 90 222 1140 1311 
111 362 792 1213 1261 
115 868 1112 1246 1263 
136 193 1000 1074 1156 
146 287 682 786 787 
156 157 612 878 911 
164 166 521 1016 1055 
218 669 995 1102 1125 
252 355 438 937 1282 
264 463 691 940 994 
300 962 963 1047 1269 
324 464 477 698 1129 
371 1104 1122 1342 1349 
407 617 861 1272 1294 
430 673 890 1060 1072 
436 841 894 895 1006 
469 470 511 972 1049 
675 774 1229 1232 1350 
680 1155 1164 1165 1288 
730 950 1015 1057 1228 
796 797 824 1119 1120 
833 834 1150 1151 1257 
6 190 376 607 
16 17 78 1291 
28 50 71 465 
41 522 904 1021 
49 451 761 762 
74 123 727 1002 
80 173 476 874 
98 423 439 1028 
101 480 770 813 
112 169 226 1169 
134 735 1198 1231 
151 949 1109 1255 
159 262 926 1138 
162 700 719 720 
206 499 500 947 
231 507 638 1224 
240 241 492 1013 
246 383 1029 1281 
370 380 676 984 
411 568 864 883 
422 586 587 1217 
449 1226 1227 1320 
455 456 741 1040 
458 557 584 1007 
505 881 923 934 
647 1134 1276 1326 
684 685 1279 1298 
750 1264 1344 1346 
2 514 819 
19 179 562 
54 848 1182 
55 181 1186 
58 200 1139 
65 263 804 
92 559 1099 
95 122 745 
96 1100 1209 
109 487 826 
110 175 914 
117 553 931 
121 253 1005 
163 316 572 
170 363 364 
194 657 827 
228 247 558 
232 633 679 
242 544 1211 
280 504 1081 
291 292 922 
304 736 821 
326 639 699 
333 985 991 
346 825 1314 
399 1017 1172 
408 701 905 
416 696 721 
431 432 1233 
448 858 965 
472 547 1179 
501 960 1041 
551 855 1128 
554 1042 1178 
667 703 983 
690 1080 1163 
711 712 1158 
789 941 1300 
791 823 925 
805 806 1336 
837 838 1283 
891 1012 1133 
955 1327 1338 
1008 1032 1252 
