6 7 16 24 25 34 35 40 41 58 67 73 74 76 80 81 84 85 113 123 132 142 147 148 150 157 164 165 168 169 177 190 227 291 292 314 315 328 329 346 366 382 384 401 402 408 412 414 422 424 457 464 466 484 488 489 516 517 519 531 535 545 546 547 574 576 580 584 585 586 607 629 630 631 663 667 668 675 686 700 738 745 758 761 762 772 775 779 780 788 790 792 793 807 814 816 832 836 837 838 843 844 846 865 874 875 878 883 886 900 902 948 955 961 986 988 994 1012 1024 1032 1041 1054 1058 1085 1089 1094 1100 1102 1111 1113 1117 1118 1124 1125 1131 1149 1162 1166 1193 1202 1220 1221 1232 1240 1244 1245 1252 1260 1261 1271 1273 1283 1294 1327 1332 1333 1338 1350 
0 1 12 13 22 23 32 36 37 42 43 44 48 53 55 59 63 64 65 66 75 79 83 86 87 88 93 94 108 111 112 155 174 189 195 200 205 208 212 218 219 220 234 235 242 245 250 255 256 257 259 269 272 277 278 285 296 303 304 305 306 307 308 309 321 322 327 339 340 341 349 353 355 360 361 374 375 379 381 388 398 403 415 416 421 443 467 468 473 475 481 502 503 504 508 526 573 588 594 599 608 625 626 627 656 681 688 724 728 736 751 770 786 798 803 812 867 873 890 899 926 936 942 952 953 980 993 997 1029 1061 1070 1071 1106 1122 1137 1138 1147 1159 1160 1167 1168 1187 1213 1234 1247 1248 1270 1272 1306 1310 1315 1325 1349 
10 31 56 57 69 103 104 120 125 126 135 156 158 160 172 173 196 197 231 236 237 248 251 268 288 294 295 352 378 394 409 428 429 430 434 442 461 463 472 495 527 528 534 539 540 541 595 640 648 657 676 697 703 706 718 727 742 747 827 840 841 851 861 863 897 904 905 922 923 933 941 943 951 969 971 982 992 996 1008 1020 1021 1031 1048 1060 1064 1073 1088 1096 1103 1133 1141 1170 1173 1177 1194 1210 1223 1233 1243 1305 
8 9 20 101 102 124 146 187 188 202 203 211 216 217 221 229 230 246 247 252 262 263 276 319 320 332 333 334 345 354 357 365 399 431 435 440 441 476 491 492 505 550 551 558 560 561 592 622 632 635 698 733 735 753 754 756 766 783 823 852 860 862 870 935 975 981 987 995 1002 1036 1038 1067 1087 1121 1129 1188 1281 1324 
27 46 68 82 107 121 122 134 140 141 166 179 194 253 284 289 290 324 343 400 413 423 426 427 451 452 494 499 520 572 590 606 628 637 639 652 655 658 669 704 744 778 795 818 835 845 856 931 957 1007 1044 1045 1211 1212 1231 1276 1348 
4 5 26 30 33 45 91 92 97 98 129 130 133 152 161 180 213 214 243 244 254 271 279 301 302 397 453 454 458 474 498 507 556 577 581 598 610 619 687 693 773 802 891 910 932 944 985 1040 1175 1238 1239 1320 1328 
153 154 225 226 299 300 368 369 386 387 506 510 536 537 600 601 684 685 702 729 749 750 765 781 817 903 998 1003 1056 1057 1154 1169 1172 1215 1258 1264 1298 1307 1308 1319 1321 1346 
2 3 21 105 106 109 110 176 224 233 260 261 347 348 393 419 420 437 512 571 597 634 715 771 809 819 901 915 974 1139 1142 1143 1183 1208 1275 
127 128 136 137 170 171 191 192 223 264 265 460 477 478 486 487 542 564 616 623 624 691 692 710 721 1068 1083 1107 1108 1112 1135 1241 1290 1302 1347 
11 118 119 167 207 222 391 392 395 447 448 485 500 570 589 615 714 726 797 800 804 889 934 946 947 967 1042 1079 
70 71 72 238 239 446 496 497 501 552 605 653 672 746 748 752 763 785 801 815 825 855 884 892 976 979 991 1277 
15 183 184 267 336 337 396 565 611 649 709 743 759 968 1025 1050 1069 1090 1130 1153 1204 1230 1236 1242 1303 1329 
28 29 139 182 186 370 371 444 465 532 636 659 671 699 764 782 810 937 960 983 984 1019 1104 1132 1282 1342 
77 144 145 175 201 209 210 280 281 282 344 569 591 888 898 914 1046 1051 1052 1063 1075 1097 1105 1192 
258 293 338 350 356 367 383 548 549 557 582 583 604 609 696 869 893 940 978 1039 1178 1269 
509 515 524 555 567 568 739 740 741 799 854 885 956 1013 1059 1078 1152 1157 1351 
38 39 232 404 405 713 760 919 1062 1181 1199 1207 1224 1225 1278 1299 1344 
162 163 389 390 417 418 538 707 708 719 720 820 945 1093 1186 
312 313 469 521 522 554 633 690 789 1014 1016 1055 1128 1163 1285 
364 411 614 731 808 864 879 880 887 962 1065 1082 1155 1235 1287 
47 99 100 275 358 359 425 462 471 523 665 757 794 927 
60 117 316 317 372 373 445 755 964 965 1005 1034 1066 1140 
206 249 342 514 643 644 732 811 848 857 1145 1182 1189 1198 
54 95 96 149 151 204 490 563 578 579 866 1114 1146 
215 310 311 325 362 438 439 459 562 654 882 894 1028 
283 529 530 664 694 695 839 859 930 999 1035 1317 
805 806 826 868 906 907 1134 1158 1246 1263 1335 1336 
78 493 661 662 774 847 918 970 989 1101 1136 
116 266 480 730 831 949 950 963 1015 1047 1228 
193 323 376 470 511 821 925 972 1030 1049 1072 
432 673 674 701 705 722 723 921 938 1043 1196 
482 483 641 642 734 829 830 924 928 1084 1144 
178 351 784 954 1076 1077 1080 1098 1237 1295 
198 199 270 297 298 335 533 958 959 973 
181 185 666 683 822 849 1161 1222 1229 
50 638 737 1017 1018 1099 1280 1314 
61 62 646 896 990 1011 1318 1330 
89 90 330 331 518 920 1110 1311 
286 287 318 682 858 908 1209 1249 
650 725 796 824 912 1119 1120 1201 
131 377 455 456 670 1206 1214 
593 612 613 791 911 1109 1197 
651 876 877 1001 1203 1259 1286 
769 939 1179 1190 1274 1284 1316 
18 19 553 559 566 787 
240 241 273 274 385 929 
433 525 602 603 1081 1262 
479 587 1074 1217 1256 1293 
871 872 1037 1148 1265 1301 
1009 1010 1185 1191 1296 1297 
51 52 228 1022 1023 
406 407 575 767 1345 
677 678 776 777 828 
679 680 1164 1253 1331 
711 712 842 1026 1027 
833 834 1150 1151 1257 
17 410 850 1291 
49 617 618 1205 
115 326 596 1004 
138 881 1171 1184 
436 689 895 1006 
620 621 716 717 
660 1092 1216 1354 
916 1053 1123 1200 
14 513 913 
114 813 909 
159 1000 1176 
363 380 966 
449 1156 1255 
450 1086 1116 
645 977 1091 
647 1266 1326 
768 917 1304 
853 1033 1292 
1115 1254 1343 
1126 1127 1174 
1165 1279 1288 
1195 1289 1300 
1218 1219 1312 
