20 46 54 65 111 112 119 124 135 155 195 200 204 207 239 249 250 255 256 291 303 308 321 349 361 367 379 429 502 511 547 589 602 615 619 732 765 786 792 804 811 827 850 851 952 961 995 997 998 1043 1064 1073 1154 1159 1160 1168 1182 1244 1245 1261 1308 1321 1325 
48 56 57 105 127 128 137 162 170 171 191 192 264 281 391 393 460 477 486 487 512 542 564 571 595 616 623 624 656 657 691 692 715 775 809 966 969 1107 1108 1135 1177 1234 1241 1290 1302 1306 
8 9 93 187 202 203 211 217 229 248 262 293 317 318 319 345 378 426 435 440 441 476 492 560 566 622 689 739 753 754 766 783 866 915 981 987 996 1031 1038 1082 1142 1289 
4 44 100 117 131 140 167 265 316 325 326 392 445 466 471 490 514 515 523 540 541 543 570 618 743 755 794 800 818 849 976 1005 1034 1053 1091 1102 1123 1200 1226 1333 
0 1 15 22 34 36 42 64 174 208 212 220 238 272 305 327 360 381 388 421 475 526 573 599 608 627 736 787 803 957 1124 1198 1332 
61 62 84 109 646 647 651 672 805 806 826 868 876 877 896 990 1001 1011 1134 1158 1203 1259 1263 1286 1326 1330 1335 1336 
49 50 218 350 479 507 555 588 727 812 873 881 1033 1040 1086 1150 1153 1197 1262 1292 1316 
35 148 149 503 585 660 663 686 749 781 875 899 922 1106 1247 1266 1273 1307 1348 1354 
14 107 336 337 396 525 565 603 611 733 759 913 1004 1236 1278 1329 
13 63 252 342 344 355 438 504 538 871 872 979 1037 1217 1301 
24 43 242 245 277 452 480 684 729 929 1008 1172 1215 1279 1298 
7 58 73 74 329 484 545 546 667 745 865 900 1237 1249 
16 78 132 274 411 625 661 662 700 879 989 1101 1235 1287 
26 39 60 223 332 417 459 550 614 747 848 1067 1072 1347 
126 163 180 289 290 294 400 704 707 763 945 1022 1023 1210 
205 457 488 489 576 779 780 861 1035 1041 1118 1201 1327 1338 
59 198 270 297 298 335 533 535 817 958 973 1148 1265 
164 312 313 423 469 521 522 690 938 1014 1016 1128 1285 
5 33 45 133 158 301 302 577 579 693 820 1256 
31 32 189 234 309 320 340 770 943 970 1213 1271 
41 75 76 215 307 369 384 756 883 1088 1089 1214 
91 92 343 559 654 682 774 906 907 1045 1099 1246 
141 160 236 268 428 434 496 528 634 675 718 801 
144 153 201 210 569 869 898 1050 1051 1063 1105 1202 
299 300 328 536 537 600 601 750 1057 1156 1319 1346 
453 768 769 910 917 918 939 1179 1190 1274 1284 1304 
3 118 139 591 645 741 977 1026 1116 1173 1183 
27 122 572 590 658 669 778 845 856 931 936 
147 166 194 422 685 880 955 1065 1083 1093 1110 
165 266 279 414 442 630 814 816 863 878 940 
292 351 574 575 767 854 1012 1113 1133 1345 
405 501 612 613 713 905 911 1109 1295 1344 
99 159 199 374 519 702 926 1074 1096 
154 225 226 386 387 1003 1056 1169 1258 
241 261 413 717 724 1070 1167 1212 1275 
482 641 642 734 830 924 928 1084 1144 
6 29 190 376 401 568 607 972 
38 738 833 834 988 1052 1151 1257 
70 98 129 130 254 829 1238 1239 
150 156 196 636 639 699 941 951 
175 176 233 260 348 771 819 1208 
182 282 283 666 725 782 964 1054 
193 377 402 456 527 923 1030 1049 
206 448 643 644 728 947 1015 1206 
40 347 403 412 584 593 688 
258 498 549 582 604 1046 1085 
276 458 760 960 1132 1222 1282 
280 776 846 847 859 888 1229 
330 331 517 518 920 1018 1184 
529 620 664 695 716 832 930 
673 676 706 723 1060 1170 1233 
679 680 1155 1164 1165 1288 1305 
2 21 451 901 1143 1166 
18 123 152 665 867 1312 
23 85 86 942 1195 1300 
30 978 1071 1187 1205 1310 
68 485 640 971 1039 1145 
81 284 852 886 887 1131 
95 125 151 772 1111 1255 
96 263 478 563 632 1114 
97 244 410 454 944 1028 
102 103 104 197 251 904 
157 552 884 885 982 1277 
221 227 228 418 1048 1199 
240 273 902 903 954 1047 
267 968 1025 1090 1230 1303 
334 631 703 746 1055 1192 
364 420 513 1149 1240 1276 
382 409 561 562 991 1029 
394 395 796 797 889 1079 
404 757 843 1013 1232 1350 
406 407 824 912 1119 1120 
509 510 677 678 799 828 
1009 1010 1185 1191 1296 1297 
25 66 172 306 467 
51 315 597 790 1146 
52 730 831 949 950 
71 446 748 891 892 
80 286 807 808 858 
82 288 397 1076 1077 
88 681 711 1097 1189 
89 90 222 278 1311 
108 352 532 784 1315 
110 362 474 531 1328 
113 114 322 752 1139 
134 427 470 742 1100 
173 802 983 1104 1342 
177 333 472 822 985 
184 709 1069 1130 1204 
214 444 594 789 967 
237 539 897 932 933 
285 341 408 649 1272 
295 370 758 764 937 
310 311 483 655 882 
339 416 481 823 1147 
346 795 864 962 1032 
365 596 659 701 1242 
493 836 986 1136 1209 
554 773 927 1042 1176 
586 587 837 838 1283 
740 956 1059 1078 1157 
839 840 853 862 935 
1181 1207 1218 1219 1223 
10 857 1122 1349 
19 179 553 722 
47 798 980 1094 
87 161 909 1231 
101 314 835 1044 
106 145 914 1270 
138 670 934 1171 
181 271 534 1186 
185 524 1152 1351 
209 246 813 1281 
219 269 443 1075 
224 354 598 815 
231 232 810 1019 
247 558 999 1036 
259 356 751 893 
275 609 610 1021 
324 464 1129 1248 
357 551 648 855 
363 668 841 959 
371 436 698 1141 
463 495 697 1117 
468 617 1137 1138 
874 919 1017 1280 
992 1224 1225 1243 
1002 1087 1188 1324 
1115 1254 1299 1343 
11 621 694 
12 304 821 
17 389 1291 
28 465 735 
53 696 975 
55 79 1066 
67 516 908 
72 497 1175 
94 415 650 
120 375 1062 
146 287 358 
169 1058 1294 
186 385 860 
188 437 1068 
235 580 583 
257 338 548 
296 383 1178 
368 520 1024 
390 731 916 
398 844 1081 
399 974 1227 
430 705 890 
433 508 953 
449 450 1320 
461 683 1216 
494 499 633 
530 556 1317 
557 1007 1061 
567 777 785 
581 710 1000 
606 652 726 
628 629 720 
671 825 1314 
674 788 1196 
687 994 1020 
712 791 925 
761 762 793 
894 895 1006 
946 1092 1252 
1193 1194 1260 
