1 12 13 15 22 23 32 34 36 40 42 43 53 55 66 69 86 87 88 89 90 93 94 148 149 174 195 208 212 219 220 234 235 245 250 252 255 257 269 277 278 280 296 303 305 306 308 309 320 322 325 327 339 340 349 350 352 353 355 360 361 366 374 381 388 392 403 406 414 421 433 438 440 468 475 502 503 504 508 516 526 570 573 588 591 594 599 600 604 606 608 619 627 645 649 765 781 817 845 875 877 908 909 936 937 957 979 997 1023 1058 1081 1097 1106 1147 1162 1172 1187 1217 1220 1260 1266 1273 1311 1315 1332 1348 
7 16 39 75 81 82 83 115 118 119 132 138 223 284 285 288 291 307 336 347 354 390 396 397 405 411 457 458 474 488 489 556 569 578 581 582 584 593 595 601 625 688 721 728 748 759 883 945 951 1000 1007 1041 1050 1060 1118 1131 1159 1287 1329 1347 
44 178 183 185 186 317 372 373 445 515 534 543 551 618 666 782 784 793 822 916 954 964 965 988 1034 1053 1054 1066 1076 1085 1091 1123 1199 1200 1237 1271 
20 31 46 64 244 275 409 410 425 428 479 527 528 539 631 634 718 770 839 840 899 933 943 953 970 1096 1213 1247 1325 
30 33 97 135 158 172 204 207 256 271 301 302 394 395 429 454 598 636 687 693 889 944 998 1020 1073 1154 1205 1305 
48 56 57 191 393 460 542 624 648 656 715 742 803 809 969 996 1124 1135 1177 1233 1234 1241 1290 1302 1306 
106 110 145 175 176 188 224 233 260 313 330 348 419 437 512 517 518 771 914 974 1068 1208 1270 1275 
19 80 98 131 179 215 243 286 310 311 423 439 459 494 552 562 654 655 744 756 967 1012 1028 
45 70 120 129 130 378 446 496 622 746 747 752 773 815 891 892 1062 1160 1173 1239 
68 146 165 287 293 442 495 640 670 682 697 758 786 787 814 971 1022 1117 1214 
144 248 318 476 478 530 540 563 566 710 915 987 1046 1170 1193 1194 1289 1310 
3 76 369 382 384 385 387 561 632 749 750 776 843 846 1088 1089 1346 
84 85 201 210 412 473 506 531 557 702 942 956 1063 1075 1321 
509 510 555 739 740 799 828 854 1078 1152 1157 1184 1299 1343 
25 91 213 214 299 328 467 536 537 610 729 903 1319 
54 246 249 644 681 711 811 812 848 857 1158 1182 1189 
0 37 104 258 338 367 498 548 549 609 978 
107 108 187 203 550 611 733 754 860 981 1236 
128 137 171 264 486 564 616 623 692 1107 1108 
141 160 236 238 268 434 545 653 663 672 785 
35 205 314 660 689 866 1201 1216 1327 1354 
111 189 218 362 669 792 867 995 1102 1125 
152 295 358 359 462 523 665 757 794 1021 
27 60 100 281 332 391 417 444 870 
58 95 122 200 484 667 703 745 983 
140 436 447 485 841 894 895 1039 1079 
180 290 294 334 357 704 779 835 1210 
181 524 774 849 1166 1229 1232 1350 1351 
96 231 232 507 633 638 1209 1238 
126 162 163 400 707 708 763 1093 
147 471 808 879 880 1065 1082 1083 
351 620 621 695 716 832 902 1240 
482 641 642 830 924 928 1084 1144 
10 127 173 389 461 683 802 
18 713 788 1098 1115 1254 1295 
21 451 761 901 1143 1183 1276 
51 221 227 961 1006 1087 1146 
63 871 872 1037 1148 1265 1301 
65 124 263 379 589 732 804 
73 266 404 651 723 800 1077 
101 375 652 1029 1044 1192 1281 
117 121 253 590 778 931 1005 
164 521 690 1014 1016 1055 1285 
177 424 519 585 668 686 959 
206 448 499 500 714 946 947 
261 413 717 724 842 1070 1167 
5 26 133 820 859 1317 
11 222 694 767 1145 1345 
17 469 470 511 1049 1291 
41 103 197 522 904 982 
112 155 615 737 1114 1206 
154 225 386 1003 1056 1258 
161 237 418 897 932 1320 
192 331 731 755 975 1212 
198 270 297 335 533 973 
267 968 1025 1090 1230 1303 
342 576 966 993 1222 1248 
401 673 674 921 1043 1196 
408 431 432 701 764 905 
450 700 719 720 1156 1255 
493 836 847 986 1136 1221 
629 801 807 869 898 1202 
777 862 873 976 1153 1316 
1009 1010 1185 1191 1296 1297 
6 29 190 376 607 
61 62 876 1259 1330 
79 443 574 580 1110 
92 559 1018 1099 1280 
105 116 775 1071 1203 
113 114 329 525 813 
211 441 560 753 783 
216 229 283 922 1103 
279 630 816 878 940 
300 962 963 1047 1269 
364 420 513 888 1149 
371 698 1122 1141 1349 
399 1017 1064 1226 1227 
402 712 791 925 1030 
452 480 568 605 1186 
541 705 706 882 1031 
646 647 1134 1326 1335 
769 939 1190 1274 1284 
833 834 1150 1151 1257 
850 851 863 1113 1133 
852 874 886 887 1011 
992 1048 1224 1225 1243 
2 514 819 1139 
14 565 913 1242 
24 427 671 856 
28 465 735 1001 
38 738 772 1052 
47 798 980 1094 
59 292 575 635 
74 123 727 1002 
78 142 1264 1344 
109 487 826 1109 
136 193 972 1074 
139 1026 1027 1116 
150 151 377 1111 
159 262 926 1138 
196 554 1042 1178 
209 900 1188 1324 
217 734 1019 1304 
239 602 1069 1277 
272 356 415 650 
274 1155 1235 1288 
304 736 821 1272 
319 435 558 766 
343 906 907 1045 
344 481 577 751 
370 380 676 984 
407 617 861 1294 
455 456 741 1040 
501 567 912 960 
661 662 989 1101 
685 829 955 1338 
730 950 1015 1057 
868 1112 1246 1263 
919 1165 1278 1279 
49 603 762 
50 71 1314 
52 949 1067 
72 497 1175 
77 532 1293 
99 199 628 
102 251 1059 
134 1198 1231 
153 491 1051 
156 157 1100 
166 230 1168 
169 226 1169 
182 282 725 
194 657 827 
228 247 1036 
240 273 929 
241 492 1013 
242 544 1211 
254 483 1105 
259 383 1038 
265 818 910 
298 535 958 
315 643 790 
316 572 639 
323 324 583 
326 699 1004 
333 985 991 
337 709 1204 
346 825 864 
365 659 1161 
368 520 1024 
398 844 1137 
416 696 823 
430 890 1072 
449 592 1061 
463 691 994 
464 477 1129 
466 490 1333 
472 547 1179 
529 664 930 
571 596 597 
637 1121 1140 
679 680 1164 
684 1215 1298 
780 1033 1035 
789 941 1300 
805 806 1336 
824 1119 1120 
837 838 1283 
881 923 934 
893 1181 1218 
896 990 1286 
927 1132 1282 
952 977 999 
1008 1032 1252 
1080 1163 1318 
1092 1176 1197 
1244 1245 1261 
