4 10 11 38 44 46 87 108 116 117 118 119 131 135 140 155 161 167 173 206 207 214 216 249 253 288 291 295 325 326 346 352 358 359 365 370 372 389 392 395 397 429 431 432 445 447 448 461 466 490 514 515 532 541 543 547 570 596 607 615 618 644 645 659 689 694 699 701 714 726 741 743 755 758 764 765 784 790 794 797 800 802 804 849 850 851 857 866 889 894 895 909 937 946 947 951 952 961 976 977 983 984 988 993 997 1000 1004 1005 1007 1015 1034 1042 1043 1052 1053 1061 1064 1073 1092 1095 1102 1103 1104 1122 1123 1140 1163 1180 1196 1200 1203 1231 1242 1252 1291 1307 1308 1315 1333 1342 1349 
48 56 57 71 105 127 128 137 141 160 162 170 171 188 191 239 243 264 268 281 299 300 320 328 366 391 393 407 434 437 446 450 454 460 486 487 496 504 512 528 530 536 537 542 552 556 564 567 571 595 600 601 602 605 616 623 624 656 692 715 718 748 750 775 777 785 801 809 867 891 892 898 944 958 966 969 1057 1068 1069 1107 1108 1124 1135 1152 1156 1169 1177 1234 1241 1271 1290 1302 1306 1317 1319 1346 
0 1 7 15 16 22 29 34 36 37 42 58 64 67 73 74 109 132 192 201 208 212 220 238 251 267 329 339 360 381 388 405 411 421 438 457 484 488 489 501 523 526 544 545 546 568 573 576 599 608 625 627 700 713 736 745 779 780 782 787 803 826 861 865 869 957 968 1025 1035 1041 1090 1109 1118 1175 1198 1221 1230 1236 1287 1295 1303 1332 
2 3 14 103 104 107 113 114 115 120 150 156 157 187 196 197 257 276 282 322 323 336 337 338 357 375 396 458 472 499 525 548 550 551 565 581 591 603 611 636 638 648 653 666 667 709 710 711 712 733 737 752 759 760 904 905 913 960 982 1054 1062 1132 1139 1158 1166 1171 1173 1183 1204 1222 1259 1282 1329 
13 20 54 65 95 96 110 111 112 147 195 200 204 205 224 250 255 256 305 308 321 349 354 362 379 380 428 474 502 511 589 598 619 643 673 676 706 721 723 728 732 773 774 786 811 880 995 1002 1060 1065 1083 1110 1136 1146 1159 1160 1170 1188 1201 1206 1233 1325 1327 
25 53 63 68 69 77 91 92 172 190 252 259 272 296 306 324 343 344 356 383 415 419 467 485 650 654 681 682 696 747 751 815 844 871 872 893 906 907 975 979 1037 1038 1039 1045 1046 1085 1145 1178 1181 1182 1189 1202 1207 1217 1218 1219 1223 1246 1293 1301 1328 
40 75 84 88 102 280 285 341 347 368 376 387 408 424 430 464 471 477 491 506 507 509 510 520 555 584 620 649 672 677 678 688 740 776 828 846 847 854 859 876 877 888 956 1011 1059 1078 1097 1129 1150 1157 1229 1248 1272 
8 12 47 72 93 124 202 213 248 263 317 318 319 327 353 378 435 558 563 566 606 637 739 766 792 798 821 855 915 980 987 996 1031 1082 1094 1115 1244 1245 1254 1261 1289 1299 1300 1322 1323 1343 
19 23 27 28 61 62 85 86 94 122 134 179 304 316 342 345 394 426 427 465 553 559 572 590 639 652 658 669 722 735 742 744 778 845 856 896 931 942 990 1001 1079 1100 1142 1195 1286 1330 
203 211 262 364 399 416 420 440 441 455 481 492 505 513 560 592 622 647 687 753 754 783 823 839 840 862 935 974 981 994 1020 1050 1098 1147 1149 1161 1193 1194 1228 1240 1260 1276 1326 1335 
6 35 55 79 148 149 177 209 229 246 247 283 412 475 503 529 585 660 663 664 686 695 749 781 799 875 899 900 922 930 936 999 1036 1066 1106 1247 1266 1273 1309 1324 1334 1348 1354 
5 26 33 45 70 126 129 130 133 158 163 180 194 254 290 293 294 301 302 463 497 577 579 640 691 693 697 763 820 971 1093 1117 1210 1238 1239 1256 1312 
9 66 101 125 151 165 266 279 314 334 414 442 480 630 631 646 703 746 805 806 813 816 863 868 878 921 940 1044 1055 1111 1112 1134 1192 1255 1263 1336 
24 43 80 146 230 242 245 258 277 286 287 361 476 498 549 582 604 684 729 807 808 858 929 963 1008 1168 1172 1215 1249 1269 1279 1298 
41 76 153 154 215 225 307 369 382 384 386 409 561 756 757 883 884 885 991 1003 1029 1051 1056 1087 1088 1089 1211 1214 1258 1265 1277 1281 
159 217 231 232 478 482 554 632 641 642 679 680 734 830 924 927 928 1019 1084 1114 1144 1155 1164 1165 1253 1267 1268 1288 1304 1305 1331 
235 273 292 351 404 494 574 575 580 583 633 651 767 843 902 903 954 1012 1013 1047 1091 1113 1125 1133 1162 1232 1278 1345 1350 
49 50 186 218 350 385 452 479 493 534 588 613 727 812 860 873 881 1033 1040 1086 1153 1186 1197 1209 1292 1316 1340 1341 
81 89 90 185 222 278 284 310 311 483 500 524 562 655 657 852 874 882 886 887 919 965 1017 1099 1131 1280 1311 1351 
18 123 152 174 193 219 221 269 377 402 425 443 456 470 516 527 621 665 719 832 836 923 925 972 1030 1049 1075 
106 144 145 175 176 210 233 260 330 331 348 517 518 569 771 819 914 920 1018 1063 1105 1184 1208 1270 
227 228 237 289 403 418 539 671 704 707 814 825 897 932 933 945 1006 1022 1023 1048 1199 1213 1314 
59 198 199 270 297 298 335 533 535 795 817 827 853 864 959 962 973 998 1024 1148 1154 1321 
136 164 166 312 313 400 423 473 521 522 557 690 761 762 793 908 938 1014 1016 1128 1176 1220 
30 31 32 189 234 309 340 436 626 634 770 943 948 953 970 978 1071 1187 1205 1310 
241 261 413 495 717 724 810 842 992 1027 1070 1167 1224 1225 1243 1275 1313 1339 
60 100 181 240 271 274 332 390 417 459 587 614 731 879 916 1212 1235 
78 142 143 275 303 355 367 609 610 661 662 989 1021 1101 1264 1337 1344 
138 139 444 531 594 670 789 934 967 1009 1010 1026 1116 1185 1191 1296 1297 
82 83 178 398 593 612 791 835 911 1076 1077 1081 1237 1262 
265 453 768 769 818 910 917 918 939 1179 1190 1274 1284 
236 371 538 675 698 738 772 833 834 1141 1151 1257 
99 183 184 373 374 519 702 926 1074 1096 1130 
52 169 226 716 730 831 848 949 950 1067 
363 462 668 708 725 796 824 841 1119 1120 
168 422 685 829 955 1058 1121 1294 1338 
315 401 586 674 788 837 838 964 1283 
406 468 617 628 629 720 912 1137 1138 
39 51 223 597 683 1072 1216 1347 
17 182 333 469 822 941 985 
21 451 578 870 901 1143 
433 439 508 635 705 890 
449 540 1226 1227 1285 1320 
97 244 410 1028 1032 
98 121 986 1080 1318 
