1 12 13 15 22 23 32 34 36 40 42 43 53 63 66 69 86 87 93 94 111 119 148 149 165 174 189 195 208 212 219 220 234 235 245 250 252 255 257 258 269 272 277 278 296 303 305 306 309 320 322 327 339 340 349 350 353 354 355 360 361 366 374 381 388 392 403 406 414 421 433 438 440 457 467 468 475 489 501 502 503 508 513 515 516 526 570 573 588 594 599 600 604 608 619 625 626 627 645 649 650 724 765 770 798 845 867 872 875 877 908 909 936 937 960 967 979 997 1037 1041 1058 1085 1094 1106 1147 1187 1203 1217 1259 1260 1266 1273 1282 1315 1332 1348 
7 81 83 126 285 336 347 390 396 397 400 474 488 556 561 578 581 582 593 652 688 707 728 748 759 820 886 887 945 980 1131 1159 1181 1218 1328 1329 
26 30 33 82 97 133 155 158 172 180 244 271 288 294 301 302 334 356 395 429 453 454 598 636 687 693 737 778 859 889 944 951 1064 1073 1093 1317 
44 178 185 265 317 372 373 391 445 543 589 618 665 666 768 784 790 916 933 954 970 988 1034 1053 1066 1076 1091 1123 1141 1199 1200 1205 1237 1271 
5 57 128 137 171 237 248 318 420 426 437 478 486 530 540 564 566 595 602 616 623 692 710 866 915 987 1046 1107 1142 1194 1206 1289 1310 
20 31 46 141 238 268 275 409 410 415 425 428 434 527 534 539 545 590 634 653 672 718 785 839 840 899 943 948 953 1096 1247 1325 
48 56 191 233 393 418 460 542 603 624 648 656 715 742 803 809 897 932 969 996 1124 1135 1177 1223 1234 1241 1290 1302 1306 
45 120 378 446 496 622 708 746 747 752 763 815 816 892 1160 1173 1193 1210 1244 1245 
84 85 144 201 209 210 412 473 506 531 702 914 942 1052 1063 1075 1321 
276 493 661 662 769 836 918 939 986 989 1101 1136 1190 1221 1274 1284 1316 
18 38 145 405 713 714 788 919 1018 1062 1098 1115 1254 1278 1280 1295 
106 176 188 224 260 313 348 419 512 771 974 1068 1208 1270 1275 
107 108 187 203 284 389 550 611 733 754 860 981 1236 1344 
254 482 483 641 642 829 830 924 928 1084 1105 1144 1219 1312 
524 660 675 774 849 961 1166 1216 1229 1232 1243 1350 1351 1354 
211 319 365 435 441 491 560 659 753 766 783 1051 1161 
47 147 274 298 471 808 879 880 1065 1082 1083 1235 
75 132 153 307 375 569 601 750 835 1044 1050 1346 
192 290 331 411 452 479 568 605 731 755 975 1212 
62 266 646 874 876 896 990 1011 1286 1330 1335 
140 436 447 485 841 894 895 946 1006 1039 1079 
68 640 670 891 971 1012 1022 1133 1214 1238 
135 204 325 615 764 817 1103 1114 1168 1305 
152 295 358 359 394 462 523 757 794 910 
387 620 677 678 717 776 846 847 1097 1192 
24 427 517 704 779 781 856 929 1215 
96 231 232 507 633 638 679 1209 1224 
99 198 199 270 297 335 533 628 973 
118 129 256 259 308 352 591 1023 1331 
273 299 328 537 729 903 1014 1016 1319 
342 576 738 772 966 993 1111 1222 1248 
621 695 716 730 832 950 1015 1057 1228 
3 382 384 385 749 843 1088 1089 
6 177 424 585 668 686 852 959 
51 52 221 227 992 1048 1087 1146 
98 261 413 423 439 459 842 1028 
103 197 541 705 706 882 982 1031 
105 116 398 466 490 775 1071 1333 
136 193 469 470 511 972 1049 1074 
160 161 190 215 239 243 756 958 
182 186 282 782 793 822 964 1054 
293 442 495 697 758 814 1117 1253 
357 555 579 632 725 1020 1184 1256 
612 777 791 862 873 911 976 1153 
29 76 927 1092 1170 1176 1285 
65 124 263 379 732 804 1189 
183 184 337 709 1069 1130 1204 
338 498 583 609 869 893 978 
343 344 481 538 577 751 760 
368 520 998 1024 1070 1154 1167 
529 664 780 930 1033 1035 1162 
11 292 694 767 1145 1345 
14 341 565 743 913 1004 
21 279 818 901 1143 1183 
59 280 504 575 635 1081 
73 351 404 651 800 1077 
142 223 1067 1108 1264 1347 
150 151 377 949 1118 1255 
154 225 386 1003 1056 1258 
207 249 681 811 812 857 
267 968 1025 1090 1230 1303 
371 698 1104 1122 1342 1349 
401 450 674 921 1043 1196 
494 535 536 871 1148 1301 
509 510 739 828 1299 1343 
629 801 807 898 1038 1202 
853 902 935 1240 1262 1292 
884 885 952 977 999 1277 
1009 1010 1185 1191 1296 1297 
25 91 213 214 610 
27 60 100 332 417 
35 291 922 1220 1287 
54 311 644 848 1182 
79 443 574 580 1110 
113 114 251 525 723 
115 868 1112 1246 1263 
138 139 1026 1027 1116 
146 287 682 786 787 
194 657 827 957 1231 
205 314 519 689 1201 
217 734 917 1019 1304 
218 669 995 1102 1125 
240 241 492 1013 1152 
264 463 691 940 994 
300 962 963 1047 1269 
310 362 792 1213 1261 
312 690 938 1080 1163 
329 472 484 547 1179 
407 617 861 1272 1294 
430 673 890 1060 1072 
680 1155 1164 1165 1288 
740 854 956 1078 1157 
796 797 824 1119 1120 
833 834 1150 1151 1257 
0 104 548 549 
4 70 323 1195 
10 461 552 802 
28 50 71 465 
41 522 904 1021 
49 451 761 762 
61 1001 1100 1318 
74 123 727 1002 
88 711 712 1158 
89 90 222 1311 
101 480 813 1036 
109 487 826 1109 
110 175 330 518 
112 169 226 1169 
130 563 606 1239 
159 262 926 1138 
162 700 719 720 
196 554 1042 1178 
206 499 500 947 
246 383 1029 1281 
324 464 477 1129 
346 671 825 1314 
370 380 676 984 
402 557 1007 1030 
449 1226 1227 1320 
455 456 741 1040 
505 881 923 934 
521 789 941 1300 
571 596 597 1242 
647 1134 1276 1326 
684 685 1279 1298 
2 514 819 
16 17 1291 
19 179 562 
37 78 367 
55 181 1186 
58 200 1139 
64 532 631 
72 497 1175 
80 173 476 
92 559 1099 
95 122 745 
117 553 931 
121 253 1005 
134 735 1198 
156 157 1128 
163 316 572 
164 878 1055 
170 363 364 
216 229 283 
228 247 558 
242 544 1211 
281 444 870 
304 736 821 
326 639 699 
333 985 991 
369 799 1265 
399 1017 1172 
408 701 905 
416 696 721 
431 432 1233 
448 795 858 
528 722 773 
551 855 965 
613 630 1171 
637 1121 1140 
654 655 744 
667 703 983 
805 806 1336 
837 838 1283 
900 1188 1324 
906 907 1045 
955 1327 1338 
1008 1032 1252 
