1 12 13 22 23 32 34 36 37 40 42 43 53 59 63 66 69 86 87 88 93 94 111 119 142 143 148 149 174 189 195 208 212 219 220 234 235 239 245 250 252 255 256 257 258 259 269 272 277 278 280 291 296 303 305 306 308 309 320 322 327 339 340 349 350 352 353 354 355 360 361 362 366 374 381 388 392 403 406 414 421 433 438 440 457 467 468 475 489 501 502 503 504 508 513 515 516 526 570 573 575 588 591 594 599 600 604 608 619 625 626 627 635 645 649 650 724 765 780 788 792 845 867 872 875 877 908 909 936 937 953 958 960 967 979 997 1023 1033 1035 1037 1041 1058 1081 1085 1094 1106 1147 1162 1187 1213 1260 1266 1273 1282 1309 1315 1331 1332 1334 1337 1348 
8 20 21 27 31 39 44 46 60 64 99 100 134 141 156 157 163 178 182 185 186 198 199 236 238 264 265 268 270 275 279 281 282 289 297 316 317 335 372 373 391 401 409 410 415 417 425 428 434 444 445 448 450 479 527 532 533 534 539 543 545 551 572 589 613 618 628 630 631 634 639 653 663 665 666 672 718 735 768 782 784 785 790 793 795 818 822 839 840 855 858 870 899 901 916 921 933 943 948 954 964 965 970 973 988 1034 1043 1053 1054 1066 1076 1091 1095 1096 1098 1123 1128 1141 1143 1171 1180 1183 1198 1199 1200 1205 1225 1231 1237 1247 1271 1295 1325 
5 48 56 61 62 73 106 109 118 140 176 188 191 206 224 233 251 260 266 313 348 393 404 408 416 418 419 431 432 436 447 460 485 499 500 512 518 542 595 603 624 646 647 648 651 656 696 701 711 712 715 721 723 726 742 771 796 797 800 803 805 806 809 824 841 850 851 868 876 894 895 896 905 920 946 947 969 974 990 996 1001 1006 1011 1039 1068 1077 1079 1100 1112 1119 1120 1124 1134 1135 1158 1177 1208 1223 1233 1234 1246 1259 1263 1270 1275 1286 1290 1302 1306 1313 1318 1326 1330 1335 1336 1339 
4 10 26 30 33 47 51 52 65 70 97 113 114 124 126 133 135 147 152 155 158 172 180 204 221 227 244 263 271 274 288 294 295 301 302 315 325 334 356 358 359 368 379 389 394 395 400 429 453 454 461 462 471 497 505 520 523 525 598 615 636 643 674 687 693 707 732 737 757 764 778 794 798 802 804 808 820 859 879 880 881 889 910 923 934 944 951 992 998 1024 1048 1064 1065 1073 1082 1083 1087 1093 1103 1114 1146 1154 1175 1189 1195 1235 1305 1317 
7 14 15 55 75 81 83 107 108 115 129 132 181 183 184 187 203 218 228 247 267 284 285 298 307 332 336 337 347 375 390 396 397 474 488 550 556 565 569 578 581 582 593 601 611 652 669 688 709 728 733 748 754 759 860 886 887 906 907 913 945 957 968 980 981 995 1004 1025 1044 1045 1050 1069 1090 1102 1125 1130 1131 1159 1181 1186 1204 1218 1230 1236 1264 1303 1328 1329 1344 
3 11 28 29 50 71 76 217 261 292 299 357 369 371 382 384 385 387 413 465 555 579 592 612 620 632 677 678 680 694 698 716 717 725 734 749 750 767 776 777 791 799 810 842 843 846 862 873 911 927 976 1003 1019 1020 1061 1070 1086 1088 1089 1092 1097 1122 1132 1145 1153 1155 1164 1165 1167 1170 1176 1184 1192 1197 1256 1265 1285 1288 1304 1340 1341 1345 1346 1349 
0 19 68 77 78 82 104 146 165 168 179 190 202 287 293 323 324 338 367 442 458 464 477 495 498 548 549 557 558 561 562 583 584 609 640 670 682 697 758 786 787 814 835 869 891 893 971 978 1007 1012 1022 1036 1117 1129 1133 1214 1253 1267 1268 
18 38 57 128 137 144 145 166 171 230 237 248 318 405 420 437 478 486 530 540 563 564 566 602 606 616 623 692 710 713 714 817 866 914 915 919 987 1018 1046 1062 1107 1115 1168 1194 1206 1241 1254 1278 1280 1289 1310 
24 117 121 136 211 216 229 253 283 346 426 427 441 452 517 529 553 560 664 671 684 685 704 753 779 781 825 833 834 856 884 885 929 930 931 952 977 999 1005 1142 1150 1151 1215 1257 1277 1279 1298 1307 1308 1314 
6 35 67 74 80 123 167 173 205 314 329 376 424 472 476 484 519 547 585 607 668 686 689 727 865 874 888 900 917 922 955 959 1149 1179 1201 1220 1249 1324 1327 1338 
45 72 96 120 131 231 232 286 378 446 496 507 528 622 633 638 679 708 722 746 747 752 763 773 815 816 863 892 1113 1160 1173 1193 1196 1209 1210 1224 1244 1245 1261 
79 84 85 201 210 300 304 407 412 430 443 473 506 531 574 580 617 673 702 736 821 861 890 942 956 962 963 1047 1052 1060 1063 1072 1075 1110 1269 1272 1294 1321 
41 89 90 103 197 222 522 524 541 637 660 675 705 706 774 849 882 904 961 982 1021 1031 1121 1140 1166 1216 1229 1232 1243 1311 1322 1323 1350 1351 1354 
25 91 112 127 154 169 213 214 223 225 226 273 328 386 537 610 629 683 729 801 807 898 903 1014 1016 1038 1056 1067 1108 1169 1202 1258 1319 1347 
2 54 101 170 207 209 246 249 363 364 370 380 383 463 480 514 644 676 681 691 770 811 812 813 819 848 857 940 984 994 1029 1182 1281 
16 17 98 160 161 215 243 310 311 326 345 423 439 459 494 552 590 654 655 658 699 744 756 1008 1028 1032 1080 1163 1252 1291 
49 138 139 164 312 451 521 690 761 762 789 878 938 941 1009 1010 1026 1027 1055 1116 1185 1191 1276 1296 1297 1300 
342 351 402 576 621 695 730 738 772 832 853 902 935 950 966 993 1015 1030 1057 1111 1222 1228 1240 1248 1262 1292 
102 240 241 242 319 435 492 509 510 544 567 739 740 766 828 854 912 1013 1059 1078 1152 1157 1211 1299 1343 
159 192 193 194 290 331 411 469 470 511 568 605 657 731 755 827 864 883 972 975 1000 1049 1074 1156 1212 
130 196 254 482 483 554 641 642 829 830 924 928 1042 1084 1105 1144 1178 1219 1238 1239 1312 
276 493 614 661 662 769 836 847 918 939 986 989 1101 1136 1190 1207 1221 1274 1284 1287 1316 
92 105 116 398 455 456 466 490 559 741 775 844 1040 1071 1099 1137 1203 1333 
9 125 150 151 377 487 783 826 949 1109 1118 1255 
58 95 122 200 667 703 745 983 1104 1139 1342 
153 365 491 571 596 597 659 1051 1161 1242 
343 344 399 481 538 577 751 760 1017 1172 
177 333 823 852 897 925 932 985 991 
422 586 587 831 837 838 1217 1283 1293 
110 175 321 330 546 1002 1188 
162 262 700 719 720 926 1138 
341 535 536 743 871 1148 1301 
449 1226 1227 1320 
