48 56 57 105 127 128 137 162 170 171 191 264 281 391 393 460 486 487 512 542 564 571 595 616 623 624 656 692 715 775 809 867 966 969 1107 1108 1124 1135 1177 1234 1241 1290 1302 1306 
4 44 131 140 316 392 438 445 466 490 514 515 543 618 689 743 755 790 800 849 894 895 976 1034 1053 1091 1102 1123 1200 1333 
0 1 15 22 34 36 208 212 220 238 360 381 388 421 573 599 608 627 736 787 803 957 1153 1198 1236 1332 
24 27 43 122 242 245 277 345 426 572 590 658 669 684 729 778 845 856 929 931 936 1008 1142 1172 1215 1298 
72 93 202 213 237 248 317 318 378 566 739 855 915 987 996 1031 1082 1289 1300 
13 20 54 95 96 112 195 200 204 205 255 308 428 511 811 1146 1201 1325 
217 231 232 482 641 642 734 810 830 924 928 1019 1084 1144 1155 1304 
187 203 211 262 435 440 441 492 560 622 753 754 783 981 
121 193 323 377 402 456 470 527 923 925 972 1030 1049 
136 148 149 412 473 475 503 781 899 1247 1266 1273 1348 
164 166 230 312 313 423 521 522 557 690 938 1016 1128 
280 368 520 620 677 678 776 828 846 847 859 888 1229 
6 35 177 246 585 660 663 686 813 875 1106 1354 
31 32 189 234 309 340 634 770 943 953 970 1213 
40 285 341 347 376 408 430 471 584 649 688 1272 
81 185 284 524 657 852 874 886 919 1017 1131 1351 
141 160 243 268 434 454 496 528 552 718 801 944 
241 261 413 459 495 717 724 842 1027 1070 1167 1275 
299 300 328 536 537 600 601 750 1057 1169 1319 1346 
42 64 119 457 635 779 780 861 1035 1041 1118 
138 139 444 594 670 789 881 934 967 1026 1116 
364 420 513 647 913 1050 1149 1240 1276 1326 1335 
7 58 73 74 329 484 545 745 865 1249 
14 184 336 337 565 611 759 1130 1242 1329 
91 92 324 343 654 682 906 907 1045 1246 
154 225 369 384 386 387 510 1003 1056 1258 
165 266 279 414 442 576 630 816 878 940 
206 207 395 448 714 797 946 947 1015 1140 
18 123 152 174 221 407 439 665 836 
26 45 133 158 497 579 820 985 1256 
49 50 218 350 588 812 1040 1086 1197 
63 681 871 872 1037 1182 1189 1265 1301 
75 132 224 250 305 354 488 619 625 
84 507 509 555 672 876 877 1011 1150 
107 282 396 525 603 667 712 733 982 
115 276 458 760 960 1132 1222 1259 1282 
118 167 541 570 645 951 952 977 1042 
258 361 498 549 582 604 963 1269 1279 
290 293 294 463 640 691 697 971 1117 
453 768 769 917 918 939 1179 1190 1274 
8 319 505 766 839 840 862 935 
175 176 233 260 348 771 819 1208 
198 199 270 297 335 533 959 973 
292 574 575 767 1012 1113 1133 1345 
529 664 695 716 730 831 832 930 
679 680 1164 1165 1253 1288 1305 1331 
5 33 301 302 577 687 693 
25 172 272 306 415 467 650 
61 134 427 653 735 742 1100 
70 129 130 254 1238 1239 1312 
102 740 854 956 1059 1078 1157 
113 114 322 615 737 752 1139 
150 156 196 636 666 905 1054 
192 411 700 782 887 1221 1287 
227 228 1006 1022 1023 1048 1199 
330 331 517 518 920 1018 1184 
334 631 703 746 844 921 1055 
351 404 651 843 1013 1232 1350 
382 409 561 991 1029 1211 1281 
450 546 713 1156 1295 1299 1344 
479 613 727 873 1033 1262 1292 
673 676 706 723 1060 1170 1233 
3 591 638 1173 1183 1210 
30 978 1071 1187 1205 1310 
39 223 683 1072 1216 1347 
59 298 535 817 853 1148 
60 100 332 390 417 614 
78 610 661 662 989 1101 
80 286 476 807 808 858 
99 374 519 926 1074 1096 
111 256 349 598 786 995 
124 502 792 1244 1245 1261 
126 163 194 400 763 1093 
144 210 569 914 1063 1105 
147 774 880 1065 1083 1110 
157 501 516 567 777 785 
252 344 898 1046 1085 1202 
259 356 383 751 893 1038 
267 968 1025 1090 1230 1303 
310 311 483 562 655 882 
321 489 1002 1159 1160 1188 
406 468 617 912 1137 1138 
738 772 833 834 1151 1257 
765 866 1007 1061 1307 1308 
1009 1010 1185 1191 1296 1297 
1181 1207 1218 1219 1223 1328 
2 21 451 901 1143 
16 251 405 523 1175 
19 179 553 559 722 
23 85 86 942 1195 
28 62 465 1001 1330 
47 327 798 980 1094 
68 485 815 1039 1145 
71 605 748 979 1217 
89 90 222 278 1311 
101 314 480 621 1044 
103 104 197 472 904 
108 352 432 784 1315 
116 291 346 1043 1203 
120 375 1062 1166 1171 
173 180 288 802 983 
236 371 436 698 1141 
239 397 602 958 1069 
249 643 644 728 1206 
273 902 903 954 1047 
289 403 704 835 945 
315 586 837 838 1283 
418 539 897 932 933 
646 868 1112 1134 1263 
827 998 1024 1154 1321 
11 607 694 741 
41 215 756 1214 
65 379 589 732 
76 153 307 1051 
87 161 909 1231 
98 986 1080 1318 
109 370 826 1109 
117 253 372 1005 
169 226 848 1067 
219 269 443 1075 
235 580 583 1278 
240 274 879 1235 
247 558 999 1036 
357 550 551 648 
365 659 701 1196 
416 481 823 1147 
422 955 1327 1338 
433 508 705 890 
447 984 1104 1342 
464 477 1129 1248 
493 1209 1284 1316 
587 731 916 1212 
796 824 1119 1120 
850 851 1073 1291 
992 1224 1225 1243 
10 889 1064 
17 469 941 
29 568 1152 
37 339 544 
38 988 1052 
46 135 325 
51 596 597 
52 949 950 
53 696 975 
55 79 1066 
67 908 1220 
77 532 1293 
83 178 791 
88 491 1097 
94 394 1079 
97 1028 1032 
106 145 1270 
110 362 474 
146 287 1168 
151 1111 1255 
155 547 1163 
159 554 927 
182 333 822 
186 385 860 
188 437 1068 
209 900 1324 
229 283 922 
257 338 548 
263 563 606 
265 818 910 
275 609 1021 
303 355 367 
320 526 1271 
363 668 841 
366 744 863 
399 974 1228 
446 891 892 
449 455 592 
452 534 1186 
462 708 725 
478 632 1114 
499 711 1158 
530 556 1317 
540 1226 1285 
581 710 1000 
593 612 911 
628 629 720 
639 699 1004 
671 825 1314 
761 762 793 
795 864 962 
805 806 1336 
857 1122 1349 
883 1088 1089 
884 885 1277 
896 990 1286 
1115 1254 1343 
1193 1194 1260 
