1 12 13 22 23 32 34 36 40 42 43 53 55 63 66 69 86 87 88 89 90 93 94 111 120 148 149 165 169 174 181 189 195 208 212 219 220 234 235 245 250 252 255 256 257 259 269 277 278 280 296 303 305 306 308 309 320 322 325 327 339 340 349 350 352 353 354 355 360 361 362 366 374 381 388 392 403 406 414 421 433 438 440 468 475 501 502 503 504 508 513 516 526 570 573 588 591 594 599 600 604 606 608 619 627 645 649 708 724 792 817 845 863 867 871 872 875 877 908 909 936 937 957 960 979 997 1023 1037 1058 1078 1081 1097 1106 1113 1147 1148 1160 1162 1186 1187 1193 1217 1220 1260 1265 1266 1273 1301 1309 1315 1331 1332 1334 1348 
48 56 61 62 73 109 140 176 188 191 206 224 233 237 260 264 266 313 348 393 404 408 416 418 419 431 432 436 447 460 485 487 499 500 512 542 614 624 646 647 648 651 656 673 696 701 715 721 723 726 742 771 800 803 805 806 809 823 826 841 868 874 876 894 895 896 905 920 932 946 947 969 974 990 996 1001 1011 1039 1050 1060 1068 1077 1079 1100 1124 1134 1135 1170 1177 1203 1207 1208 1223 1233 1234 1246 1259 1263 1275 1286 1290 1302 1306 1313 1326 1328 1330 1335 1336 1339 
4 20 30 33 47 65 70 97 112 124 129 135 146 147 152 155 156 158 172 204 207 263 271 287 301 302 358 359 379 394 395 429 462 471 523 557 598 615 636 665 687 693 732 737 757 765 778 789 794 796 797 798 804 808 824 850 851 879 880 881 889 923 934 941 980 998 1008 1020 1032 1065 1073 1082 1083 1094 1104 1114 1119 1120 1154 1181 1189 1195 1218 1219 1252 1300 1312 1325 
5 7 16 17 26 59 75 78 81 82 83 118 119 126 132 133 138 162 163 180 217 274 284 285 288 290 294 307 334 336 347 390 396 397 400 405 457 464 474 477 488 489 556 569 575 578 581 582 593 595 601 625 635 688 704 707 728 734 748 759 763 779 780 820 859 917 918 945 951 1000 1019 1035 1041 1103 1108 1118 1129 1131 1159 1210 1235 1291 1304 1317 1329 
27 44 60 100 178 182 183 185 186 265 281 282 289 316 317 332 365 368 372 373 391 417 444 445 448 491 515 520 543 551 567 572 618 639 659 666 674 725 782 784 785 790 793 795 818 822 835 839 840 858 870 912 916 933 954 964 965 970 988 1024 1034 1051 1053 1054 1066 1076 1091 1095 1123 1141 1161 1180 1199 1200 1205 1237 
10 19 80 98 101 107 108 113 114 131 161 173 179 187 203 215 228 243 247 276 286 310 311 375 389 423 435 439 454 458 459 461 493 494 525 550 552 558 562 565 589 611 652 654 655 661 662 733 744 754 756 760 802 813 836 860 897 944 967 981 986 989 1012 1028 1029 1036 1044 1046 1085 1101 1221 1236 1281 1320 
0 37 38 51 52 68 79 104 221 227 258 272 293 315 324 338 343 356 367 415 442 443 479 495 498 548 549 574 580 583 609 640 643 650 670 679 680 682 697 758 786 787 814 893 906 907 919 971 978 1006 1018 1022 1045 1048 1052 1062 1087 1093 1110 1117 1146 1155 1164 1165 1214 1278 1279 1280 1288 1305 
8 57 74 106 115 123 128 137 144 145 157 166 171 202 211 230 248 318 319 357 420 426 437 476 478 486 530 540 555 560 563 564 566 579 612 616 623 632 692 710 727 766 783 852 855 886 887 911 914 915 987 1002 1107 1112 1128 1142 1168 1184 1194 1206 1241 1256 1270 1289 1310 
24 25 91 110 175 213 214 240 273 299 321 328 330 344 467 481 517 518 536 537 546 577 610 629 637 671 684 685 729 751 781 801 807 856 869 884 898 903 929 952 955 977 999 1038 1121 1140 1202 1215 1298 1307 1308 1311 1319 1322 1323 
3 11 76 153 154 192 222 225 226 261 346 369 371 382 384 385 386 387 411 413 561 694 698 717 749 750 767 776 810 825 842 843 846 864 883 1003 1056 1070 1088 1089 1122 1133 1145 1150 1167 1169 1258 1287 1342 1345 1346 1349 
31 46 64 77 141 160 236 238 244 268 275 409 410 425 427 428 434 527 532 534 539 545 626 631 634 653 663 672 718 770 847 899 943 948 953 1096 1192 1213 1247 1271 1293 
159 198 262 270 297 298 335 342 351 422 533 535 576 620 621 695 716 730 772 831 832 853 902 926 935 958 966 973 993 1015 1057 1111 1138 1222 1240 1248 1262 1292 
28 50 71 449 465 592 677 678 769 777 862 873 927 939 976 1033 1061 1092 1132 1153 1176 1190 1197 1253 1267 1268 1274 1282 1284 1314 1316 1340 1341 
6 29 35 177 190 205 314 376 401 424 450 519 584 585 607 660 668 686 689 700 719 720 866 921 959 1007 1043 1201 1216 1327 1338 1354 
18 136 184 193 239 323 337 402 602 709 712 713 714 788 791 925 972 1030 1049 1069 1074 1086 1098 1115 1130 1156 1204 1254 1277 1295 
14 15 267 295 326 341 370 380 463 571 596 597 676 691 699 743 764 913 940 968 984 994 1004 1021 1025 1090 1230 1242 1303 
41 72 103 197 497 522 524 538 541 675 705 706 774 849 882 904 961 982 1031 1166 1175 1229 1232 1264 1344 1350 1351 
54 134 170 209 246 249 363 364 514 644 681 711 735 811 812 819 848 857 888 900 1149 1158 1182 1188 1198 1231 1324 
139 164 194 312 469 470 511 521 657 690 827 938 1009 1010 1014 1016 1026 1027 1055 1080 1116 1163 1185 1191 1285 1296 1297 
45 96 231 232 378 446 496 507 528 622 633 638 746 747 752 773 815 891 892 992 1173 1209 1224 1225 1238 1243 
92 105 116 241 242 398 455 456 466 490 492 544 559 741 775 844 854 1013 1040 1071 1099 1152 1211 1333 
117 121 216 229 253 283 291 292 441 529 553 590 664 722 753 922 930 931 1005 1196 1318 
84 85 201 210 300 412 473 506 531 702 942 956 962 963 1047 1063 1075 1269 1321 
130 196 254 482 483 554 641 642 829 830 924 928 1042 1084 1105 1144 1178 1239 
39 127 142 143 223 430 683 738 833 834 890 1067 1072 1151 1257 1337 1347 
331 383 452 480 568 586 587 605 731 755 837 838 975 1212 1283 
9 125 279 453 613 630 768 816 878 910 1171 1244 1245 1261 
58 95 122 200 329 484 667 703 745 865 983 1136 1139 1249 
218 304 407 617 669 736 821 861 995 1102 1125 1137 1272 1294 
2 21 49 345 451 603 658 761 762 901 1143 1183 1276 
99 199 399 505 628 1017 1064 1172 1226 1227 1228 
509 510 739 740 799 828 885 1157 1299 1343 
150 151 377 949 950 1109 1255 
67 102 167 168 251 1059 
333 472 547 985 991 1179 
