5 48 56 57 105 127 128 137 162 170 171 191 192 223 264 281 366 391 393 446 460 477 486 487 504 512 542 564 571 595 616 623 624 656 692 715 775 809 898 966 969 1072 1107 1108 1124 1135 1177 1234 1241 1290 1302 1306 1347 
13 20 22 54 65 82 95 96 111 112 155 195 200 204 205 250 255 308 349 379 380 392 488 511 589 676 706 732 811 866 995 1077 1146 1201 1325 
4 44 131 140 432 438 445 466 490 514 515 543 618 689 743 755 790 800 849 976 1005 1034 1053 1091 1102 1123 1200 1333 
72 93 237 248 318 378 540 566 739 855 915 987 996 1031 1046 1082 1170 1226 1285 1289 1300 
26 30 126 293 294 358 463 497 640 691 697 820 971 978 1117 1187 1205 1210 1310 
24 43 134 242 245 277 427 452 684 704 729 742 856 929 1008 1172 1215 1298 
1 148 149 305 412 475 503 749 781 876 877 899 1247 1266 1273 1307 1348 
15 34 220 238 324 400 520 627 726 736 787 957 1198 1236 1332 
81 185 284 524 657 660 852 874 886 887 1017 1131 1280 1351 1354 
14 107 187 336 337 396 603 611 667 712 733 759 1329 1344 
217 231 482 641 642 734 830 924 928 1019 1084 1144 1155 1304 
27 122 345 426 572 590 639 658 669 778 845 936 1142 
203 211 229 262 435 440 441 492 558 560 622 753 783 
225 299 300 328 536 537 600 601 750 1057 1169 1319 1346 
513 565 596 647 913 1004 1050 1149 1240 1242 1276 1326 1335 
36 40 208 360 381 388 421 471 573 599 608 724 
118 119 167 541 570 615 645 951 952 977 1042 1103 
8 319 505 754 823 839 840 862 925 935 972 
31 32 64 189 212 234 340 803 943 970 1213 
33 45 70 133 254 301 302 577 687 693 1312 
91 92 343 559 654 682 906 907 1045 1099 1246 
103 104 150 156 196 197 472 636 904 905 1021 
3 139 370 591 638 737 1026 1116 1173 1183 
7 58 73 74 329 484 545 745 900 1324 
63 681 711 871 872 1037 1148 1189 1265 1301 
154 273 386 902 903 954 1003 1047 1056 1258 
164 312 313 423 521 522 690 938 1016 1128 
529 664 779 780 930 1033 1035 1118 1262 1292 
76 153 307 369 382 883 1051 1088 1089 
108 352 532 765 784 1007 1061 1308 1315 
141 268 434 496 528 534 718 801 1233 
193 377 402 456 516 527 923 1030 1049 
227 228 418 894 895 1006 1023 1048 1199 
317 334 428 631 634 703 746 844 921 
575 850 851 863 891 1012 1073 1113 1133 
768 769 917 918 939 1179 1190 1274 1284 
18 123 152 221 407 665 836 867 
49 50 350 588 812 1040 1071 1197 
75 132 224 354 375 619 625 786 
97 244 279 410 453 454 944 1028 
175 176 233 260 348 771 819 1208 
239 270 602 884 885 958 1069 1277 
241 261 413 495 717 842 1027 1275 
258 498 549 582 963 1159 1269 1279 
368 387 677 678 776 828 846 1229 
11 222 607 694 741 767 1345 
25 53 121 272 306 415 467 
60 100 163 316 332 417 614 
80 230 286 476 807 808 858 
113 114 282 322 525 752 1139 
116 291 292 346 1032 1043 1203 
330 331 517 518 920 1018 1184 
394 395 796 797 889 947 1079 
404 651 723 843 1013 1232 1350 
2 21 451 870 901 1143 
23 85 86 744 942 1195 
28 62 465 735 1001 1330 
68 485 815 835 1039 1145 
78 610 661 662 989 1101 
87 160 161 215 243 756 
94 650 824 1070 1119 1120 
115 285 408 649 1259 1272 
124 502 792 1244 1245 1261 
144 210 569 1052 1063 1105 
147 774 880 1065 1083 1110 
177 585 663 686 875 1106 
198 297 335 533 959 973 
266 414 576 630 878 940 
267 968 1025 1090 1230 1303 
310 311 483 562 655 882 
406 468 617 912 1137 1138 
509 510 555 725 799 1150 
738 772 833 834 1151 1257 
740 854 956 1078 1152 1157 
827 998 1024 1154 1167 1321 
1009 1010 1185 1191 1296 1297 
0 433 508 770 953 
6 246 813 1029 1281 
9 125 151 1111 1255 
17 469 470 941 1291 
39 992 1224 1225 1243 
42 218 309 457 861 
46 135 325 389 817 
47 327 798 980 1094 
59 298 341 535 853 
71 748 892 979 1217 
88 376 464 1129 1248 
165 174 442 816 1055 
172 256 705 890 1060 
206 644 857 1122 1349 
207 447 984 1104 1342 
219 269 443 914 1075 
236 371 436 698 1141 
357 550 551 648 981 
374 519 926 1074 1096 
397 546 713 1295 1299 
416 429 961 1064 1147 
458 960 1132 1222 1282 
501 567 777 785 1041 
620 621 695 716 832 
646 868 1112 1134 1263 
680 1164 1165 1288 1305 
791 873 881 1153 1316 
10 461 683 1216 
12 563 606 821 
16 251 523 1175 
55 403 945 1186 
83 178 652 1044 
98 459 1080 1318 
101 314 480 1182 
117 253 372 931 
120 1062 1160 1171 
129 130 578 1239 
138 491 670 934 
166 194 1093 1231 
169 226 848 1067 
173 288 802 983 
182 333 822 985 
188 437 552 1068 
209 247 782 999 
240 274 879 1235 
259 356 751 1038 
321 489 1002 1188 
347 430 584 688 
365 659 701 1196 
384 478 632 1114 
390 731 916 1212 
409 561 991 1211 
444 594 789 967 
539 897 932 933 
580 583 919 1278 
586 837 838 1283 
643 721 728 1206 
730 831 950 1228 
805 806 1158 1336 
893 1181 1218 1219 
19 179 553 
37 339 544 
51 315 597 
61 1100 1209 
84 672 1011 
89 90 278 
102 766 1059 
106 145 1270 
109 826 1109 
110 362 474 
136 473 557 
146 287 1168 
157 263 982 
158 579 1256 
159 554 927 
180 190 747 
186 385 860 
214 295 699 
216 758 937 
249 804 997 
252 1085 1202 
257 338 548 
265 818 910 
276 405 760 
283 666 1054 
290 696 975 
296 383 1178 
303 355 367 
320 526 1271 
351 359 993 
361 604 909 
363 364 420 
425 719 1156 
439 635 1036 
449 1227 1320 
450 810 1086 
455 1253 1331 
462 708 763 
479 613 727 
493 986 1136 
494 499 633 
530 556 1317 
581 710 1000 
592 1098 1161 
593 612 911 
628 629 720 
671 825 1314 
673 674 788 
685 829 1121 
714 1140 1311 
761 762 793 
795 864 962 
847 888 1097 
896 990 1286 
946 1092 1252 
955 1327 1338 
1115 1254 1343 
1193 1194 1260 
1207 1223 1328 
1220 1221 1287 
