4 32 44 48 56 57 70 71 100 105 116 117 127 128 129 130 131 137 140 141 157 160 162 167 170 171 188 191 192 214 216 225 239 254 264 265 268 281 288 291 295 299 300 316 326 328 346 368 391 393 397 409 434 437 438 445 446 460 466 471 477 486 487 490 496 497 501 512 514 515 520 523 528 529 530 536 537 541 542 543 552 554 556 561 562 564 567 571 593 600 601 602 612 613 616 618 623 624 656 657 664 671 691 692 695 713 714 715 718 743 748 750 755 758 775 777 785 790 794 800 801 809 818 825 829 849 884 889 891 892 910 911 927 930 937 946 947 964 966 969 976 979 991 1003 1005 1024 1029 1032 1034 1043 1046 1053 1057 1068 1085 1092 1095 1102 1103 1107 1108 1109 1115 1123 1124 1135 1140 1156 1169 1171 1176 1177 1180 1200 1202 1211 1217 1234 1238 1239 1241 1252 1254 1277 1281 1290 1295 1299 1302 1306 1314 1317 1319 1333 1343 1346 
0 1 6 7 15 22 25 29 34 35 36 40 42 53 55 58 64 67 68 69 73 74 79 83 94 115 121 136 148 149 169 174 177 178 190 193 208 212 220 226 238 246 259 267 272 285 296 305 306 309 324 325 327 329 341 347 356 360 376 377 381 383 388 394 398 401 402 408 412 415 419 421 424 430 456 467 470 473 475 484 485 503 506 516 526 527 545 546 547 568 573 584 585 588 595 599 604 606 607 608 626 627 649 650 652 660 663 674 686 688 696 726 736 740 745 749 751 781 787 788 795 803 832 844 854 864 865 875 879 885 893 899 908 923 948 956 957 959 962 963 968 975 1007 1012 1025 1030 1038 1039 1049 1058 1059 1066 1078 1079 1081 1090 1106 1112 1125 1145 1152 1157 1162 1178 1198 1220 1230 1247 1249 1266 1273 1294 1303 1307 1309 1318 1332 1334 1348 1354 
3 10 11 13 20 23 37 46 54 65 82 85 86 87 88 96 97 111 112 118 119 124 135 155 161 172 195 200 204 205 206 207 249 250 255 256 303 308 321 349 355 361 366 367 379 380 395 406 410 428 429 447 448 468 491 502 511 544 570 581 589 591 615 617 619 621 628 629 638 643 644 645 693 694 710 711 720 721 728 732 737 741 744 765 786 792 796 797 804 811 827 850 851 857 909 912 942 951 952 961 977 984 986 995 997 998 1000 1015 1042 1064 1077 1097 1104 1122 1137 1138 1146 1154 1159 1160 1168 1173 1183 1195 1201 1206 1231 1244 1245 1261 1300 1308 1321 1325 1342 1349 
8 12 27 47 72 81 89 90 93 99 122 159 168 183 185 187 199 202 203 211 213 217 222 229 248 253 262 263 278 284 317 318 319 345 353 372 373 374 378 426 435 440 441 476 478 483 492 500 519 524 540 560 563 566 572 590 605 622 632 637 639 655 658 659 669 689 699 702 706 739 753 754 764 766 778 783 798 821 845 852 855 856 866 874 882 886 887 894 895 915 926 931 936 965 980 981 987 996 1004 1017 1031 1074 1082 1094 1096 1099 1114 1121 1131 1142 1175 1272 1280 1289 1311 1322 1323 1344 1351 
30 49 50 186 218 235 241 261 273 292 350 351 385 404 413 452 464 479 480 493 495 507 509 510 534 555 574 575 580 677 678 724 727 757 767 799 810 812 828 842 843 860 873 881 902 903 919 954 978 992 1013 1027 1033 1040 1047 1070 1071 1076 1086 1091 1113 1129 1133 1150 1153 1167 1186 1187 1197 1205 1209 1224 1225 1232 1237 1243 1248 1262 1275 1284 1292 1310 1313 1316 1339 1340 1341 1345 1350 
16 26 39 51 60 78 102 103 104 132 142 143 181 209 223 240 247 251 271 274 315 332 390 405 411 417 457 459 488 489 558 576 586 587 597 614 625 661 662 700 731 747 779 780 782 837 838 848 861 900 916 941 989 999 1035 1036 1041 1067 1072 1080 1101 1118 1163 1212 1221 1235 1264 1283 1287 1324 1337 1347 
14 231 232 339 359 364 370 399 416 420 449 450 455 481 482 505 513 565 592 596 641 642 679 680 687 734 823 830 839 840 853 862 913 924 928 935 974 993 994 1019 1020 1050 1084 1098 1144 1147 1149 1155 1161 1164 1165 1193 1194 1226 1227 1228 1240 1242 1253 1260 1267 1268 1288 1305 1320 1331 
5 33 45 107 110 113 114 133 158 184 224 276 282 301 302 322 323 336 337 354 362 396 458 474 525 531 577 579 583 598 603 611 653 667 673 676 709 717 723 733 752 759 760 815 820 960 982 1060 1069 1130 1132 1139 1170 1204 1222 1233 1236 1256 1278 1282 1329 
2 21 24 43 80 120 138 139 230 242 245 257 258 277 286 338 375 392 444 451 498 548 549 578 582 594 670 684 729 789 807 808 858 870 901 921 929 934 967 1008 1009 1010 1026 1062 1116 1143 1166 1172 1185 1191 1215 1269 1276 1279 1296 1297 1298 
19 31 126 163 179 189 221 227 228 234 237 289 290 293 294 320 340 400 403 418 463 539 553 634 640 697 704 707 722 763 770 773 814 835 897 932 933 943 945 953 970 971 1006 1022 1023 1048 1117 1136 1199 1210 1213 1271 
28 61 62 84 109 154 280 386 387 433 439 465 508 620 635 646 647 651 672 705 735 776 805 806 826 846 847 859 868 876 877 888 890 896 990 1001 1011 1056 1134 1158 1203 1229 1259 1263 1286 1326 1330 1335 1336 
9 17 98 106 145 165 175 176 233 243 244 260 266 275 279 310 311 334 348 389 414 442 454 461 609 610 630 631 683 703 746 771 816 819 863 878 914 940 944 1021 1028 1055 1073 1208 1216 1270 1291 
91 92 147 164 166 194 236 312 313 343 371 422 423 436 469 521 522 538 557 559 654 675 682 685 690 698 761 762 774 793 880 906 907 938 955 1014 1016 1045 1065 1083 1093 1110 1128 1141 1246 1285 1338 
18 38 77 108 123 146 152 173 180 287 352 358 363 407 425 431 432 462 532 665 668 708 719 738 784 802 833 834 836 841 867 983 988 1052 1061 1151 1181 1207 1218 1219 1223 1257 1293 1312 1315 1328 
41 52 66 75 76 95 101 125 151 215 307 314 369 382 384 712 716 730 756 772 791 813 831 883 925 949 950 972 1002 1044 1087 1088 1089 1111 1188 1192 1214 1255 1258 1327 
59 150 156 182 196 197 198 270 283 297 298 333 335 357 472 494 499 533 535 550 551 633 636 648 666 725 817 822 824 904 905 922 958 973 985 1054 1119 1120 1148 1265 
63 134 144 153 201 210 219 252 269 304 342 344 365 427 443 504 569 681 701 742 869 871 872 898 1037 1051 1063 1075 1100 1105 1182 1189 1196 1301 
453 768 769 917 918 939 1179 1190 1274 1304 
330 331 517 518 920 1018 1184 
