48 56 57 105 127 128 137 162 170 171 191 264 281 391 393 460 486 487 512 542 564 571 595 616 623 624 656 692 715 775 809 867 966 969 1107 1108 1135 1177 1234 1241 1290 1302 1306 
4 44 131 140 445 466 490 514 515 543 618 683 689 743 755 790 800 849 894 895 976 1024 1034 1053 1091 1102 1123 1200 1216 1333 
14 15 107 187 203 211 262 337 396 440 441 492 525 560 565 596 603 611 622 667 733 752 753 754 759 783 913 981 1004 1242 
0 1 22 34 36 42 64 208 212 220 238 360 381 388 421 438 526 573 599 608 627 736 787 803 957 1124 1198 1332 
8 72 93 202 213 248 263 317 318 319 378 435 476 558 566 739 766 855 915 987 1031 1082 1289 1300 
26 126 133 163 180 290 293 294 463 497 640 691 697 763 820 971 1093 1117 1175 1210 
16 132 405 457 488 489 501 523 576 625 779 780 861 1035 1041 1118 
27 122 316 345 426 572 590 639 658 669 778 845 856 931 936 1142 
76 144 153 201 210 269 307 869 898 914 1051 1063 1075 1105 1202 
217 231 232 482 641 642 734 830 924 928 1019 1084 1144 1304 
479 493 507 509 555 727 873 1033 1150 1153 1209 1262 1292 1316 
206 207 249 448 643 644 728 773 797 947 1015 1136 1206 
299 300 328 536 537 600 601 750 1057 1156 1169 1319 1346 
24 43 242 245 277 684 729 929 1008 1172 1215 1298 
103 104 150 156 196 197 472 636 666 904 905 1054 
113 114 276 282 322 458 760 960 1132 1139 1222 1282 
118 119 167 541 570 615 645 951 952 977 1042 1103 
7 58 73 74 329 484 545 745 865 900 1324 
31 189 309 320 340 770 943 953 970 1213 1271 
84 646 651 672 876 877 990 1011 1203 1259 1335 
138 139 444 594 670 789 881 934 967 1026 1116 
141 160 268 428 434 496 528 552 634 718 801 
193 377 402 456 516 527 923 925 972 1030 1049 
148 149 475 503 781 899 1247 1266 1273 1348 
292 351 574 575 767 854 1012 1113 1133 1345 
453 768 769 917 918 939 1179 1190 1274 1284 
13 20 112 200 255 308 511 811 1325 
30 436 724 978 1070 1071 1187 1205 1310 
45 70 129 130 194 254 1238 1239 1312 
49 50 218 350 588 812 1040 1086 1197 
91 92 324 654 682 906 907 1045 1246 
241 261 413 495 717 810 842 1027 1167 
258 498 549 582 963 1159 1160 1269 1279 
364 420 513 647 1050 1149 1240 1276 1326 
399 505 839 840 862 935 974 1064 1228 
46 87 135 204 389 395 400 461 
63 252 343 344 871 872 1037 1301 
175 176 233 260 348 771 819 1208 
198 199 270 297 335 533 959 973 
387 620 677 678 776 828 846 1229 
679 680 1155 1164 1165 1288 1305 1331 
9 98 243 279 454 944 1028 
10 173 288 397 802 889 983 
18 123 152 221 407 665 836 
71 446 605 748 891 892 991 
78 142 610 661 662 989 1101 
99 374 519 702 926 1074 1096 
101 314 480 730 831 950 1044 
161 464 477 1129 1231 1248 1320 
195 224 250 305 354 619 786 
229 283 529 664 695 922 930 
266 414 630 816 863 878 940 
312 313 522 690 938 1016 1128 
330 331 517 518 920 1018 1184 
673 676 706 723 1060 1170 1233 
805 806 868 1112 1134 1263 1336 
3 591 638 737 1173 1183 
5 33 301 302 577 693 
6 209 246 247 813 999 
28 62 465 735 1001 1330 
29 568 740 1078 1152 1157 
40 368 412 471 520 832 
59 298 535 817 853 1148 
60 100 332 417 459 614 
65 95 379 589 732 1146 
108 352 432 532 784 1315 
110 362 474 531 1275 1328 
124 502 792 1244 1245 1261 
146 230 287 858 1168 1249 
147 774 880 1065 1083 1110 
165 174 219 234 442 443 
177 585 663 686 875 1106 
192 411 700 782 1221 1287 
227 228 1006 1023 1048 1199 
237 418 539 897 932 933 
267 968 1025 1090 1230 1303 
310 311 483 562 655 882 
334 631 703 746 921 1055 
382 409 561 1029 1211 1281 
404 843 996 1013 1232 1350 
406 468 617 912 1137 1138 
738 772 833 834 1151 1257 
765 866 1007 1061 1307 1308 
1009 1010 1185 1191 1296 1297 
2 21 451 901 1143 
11 607 621 694 741 
12 563 606 821 1272 
19 179 553 559 722 
23 85 86 942 1195 
32 546 613 713 1299 
47 327 798 980 1094 
61 134 427 742 1100 
68 485 815 1039 1145 
89 90 222 278 1311 
96 205 1201 1327 1338 
115 285 341 408 649 
120 375 1062 1166 1171 
125 151 450 1111 1255 
154 225 386 1056 1258 
273 902 903 954 1047 
289 403 704 945 1022 
315 586 837 838 1283 
336 530 556 1317 1329 
349 827 998 1154 1321 
390 587 731 916 1212 
452 534 1046 1085 1186 
751 893 1181 1218 1219 
17 469 470 941 
25 306 467 844 
39 223 1072 1347 
54 321 1002 1188 
55 79 325 1066 
81 284 657 852 
82 835 1076 1077 
109 370 826 1109 
116 291 346 1043 
117 253 372 1005 
121 986 1080 1318 
157 612 911 982 
159 554 927 1253 
169 226 848 1067 
182 333 822 985 
185 524 1236 1351 
236 371 698 1141 
239 602 958 1069 
240 274 879 1235 
244 366 410 744 
272 356 415 650 
280 847 859 888 
347 430 593 688 
357 550 551 648 
365 659 701 1196 
369 384 1003 1265 
416 481 823 1147 
422 685 829 955 
433 508 705 890 
447 984 1104 1342 
499 711 712 1158 
540 1226 1227 1285 
796 824 1119 1120 
850 851 1073 1291 
992 1224 1225 1243 
35 660 1354 
37 339 544 
38 988 1052 
52 716 949 
53 696 975 
80 215 756 
83 178 791 
88 491 1097 
94 394 1079 
106 145 1270 
111 598 995 
136 473 557 
158 579 1256 
164 423 521 
166 908 1220 
186 385 860 
188 437 1068 
216 758 937 
235 580 1278 
257 338 548 
265 818 910 
275 609 1021 
286 807 808 
296 383 1178 
303 355 367 
323 583 653 
326 699 794 
361 604 909 
363 668 841 
424 506 956 
439 635 1036 
449 455 592 
462 708 725 
478 632 1114 
510 749 799 
567 777 785 
581 710 1000 
628 629 720 
671 825 1314 
674 788 1295 
681 1182 1189 
687 994 1020 
761 762 793 
795 864 962 
857 1122 1349 
874 919 1017 
883 1088 1089 
884 885 1277 
886 887 1131 
946 1092 1252 
1098 1161 1237 
1115 1254 1343 
1193 1194 1260 
