8 72 93 144 187 202 203 211 213 217 229 248 262 263 317 318 319 332 345 378 435 440 441 476 492 550 558 560 563 566 622 739 753 754 756 766 783 855 915 981 987 1031 1082 1289 1300 
48 56 57 105 127 128 137 162 167 170 171 191 264 281 391 393 460 477 486 487 512 542 564 571 616 623 624 656 692 715 775 809 867 966 969 1107 1108 1124 1135 1177 1234 1290 1302 1306 
4 44 100 117 119 131 140 291 326 429 438 445 466 471 490 514 515 523 543 618 743 755 765 790 794 800 849 961 976 1005 1024 1034 1043 1053 1091 1102 1123 1200 1308 1333 
22 36 40 42 88 208 220 280 368 376 387 388 464 516 520 584 599 620 776 846 847 859 888 1097 1129 1229 
13 20 46 54 95 96 112 135 195 200 204 205 255 256 308 321 361 511 811 1002 1188 1201 1325 1327 
71 141 160 188 239 268 428 434 437 496 528 552 602 605 634 718 748 801 1068 1069 
61 62 109 646 647 805 806 826 868 876 1050 1134 1158 1259 1263 1326 1330 1335 1336 
9 165 279 334 414 442 630 631 703 746 816 863 878 921 940 1055 1112 
0 1 34 212 238 381 421 573 608 627 736 787 803 957 1198 1332 
14 15 184 267 337 565 611 759 913 968 1025 1090 1130 1230 1242 1303 
16 132 224 354 405 457 488 489 576 625 779 780 861 1035 1041 1118 
49 50 218 219 350 588 812 873 881 1033 1040 1153 1197 1262 1292 1316 
231 232 482 641 642 679 680 734 830 924 928 1019 1084 1144 1155 1331 
27 122 353 426 572 590 637 658 669 778 845 856 931 936 1142 
41 76 154 215 307 369 384 386 883 1003 1056 1088 1089 1214 1258 
136 148 149 305 412 473 475 503 781 899 1247 1266 1273 1307 1348 
25 172 177 272 306 415 467 585 650 663 686 844 875 1106 
225 299 300 328 536 537 600 601 750 1057 1156 1169 1319 1346 
157 501 546 593 612 613 674 713 788 911 1109 1295 1299 
24 43 242 245 277 684 729 929 1008 1172 1215 1298 
31 32 64 189 234 309 340 360 770 943 970 1213 
59 198 270 297 298 335 533 535 817 853 958 973 
106 145 175 176 233 260 348 771 819 914 1208 1270 
193 323 377 402 456 470 527 923 925 972 1030 1049 
68 259 356 383 485 549 604 815 1038 1039 1145 
164 312 313 423 521 522 557 690 938 1016 1128 
290 293 294 463 640 691 697 971 1117 1210 1241 
453 768 769 917 918 939 1179 1190 1274 1284 1304 
3 139 370 591 638 737 1026 1116 1173 1183 
7 58 73 74 329 484 545 745 865 1249 
29 401 568 740 854 964 1059 1078 1152 1157 
81 284 657 852 874 886 887 919 1017 1131 
91 92 324 343 654 682 906 907 1045 1246 
153 201 210 569 869 898 1051 1063 1105 1202 
5 33 45 133 301 302 577 693 820 
18 123 152 174 221 407 443 665 836 
63 252 344 871 872 1037 1148 1265 1301 
99 199 374 519 702 926 959 1074 1096 
479 507 509 555 677 678 727 828 1150 
2 21 451 578 870 901 1143 1166 
30 724 978 1070 1071 1187 1205 1310 
38 738 833 834 988 1052 1151 1257 
103 104 673 676 723 1060 1170 1233 
115 276 458 760 960 1132 1222 1282 
150 156 196 197 472 636 904 905 
206 207 395 448 796 797 947 1015 
241 261 413 495 717 842 1027 1167 
292 351 574 575 767 1113 1133 1345 
529 664 695 716 730 831 832 930 
113 114 282 322 606 752 1139 
126 163 166 194 400 763 1093 
147 774 880 1065 1083 1110 1311 
227 228 1006 1022 1023 1048 1199 
266 404 843 996 1013 1232 1350 
330 331 517 518 920 1018 1184 
382 409 561 991 1029 1211 1281 
26 60 271 417 459 614 
70 129 130 254 1238 1239 
78 142 661 662 989 1101 
87 161 897 909 1231 1320 
107 525 603 667 733 982 
108 352 432 532 784 1315 
110 362 474 531 1275 1328 
111 250 349 598 786 995 
138 444 670 789 934 967 
182 725 824 941 1119 1120 
214 295 431 758 764 937 
249 643 644 728 773 1136 
310 311 483 562 655 882 
359 839 840 862 935 993 
364 420 513 1149 1240 1276 
399 505 974 1064 1227 1228 
406 468 617 912 1137 1138 
499 681 711 712 1182 1189 
541 570 581 615 710 951 
1009 1010 1185 1191 1296 1297 
1181 1207 1218 1219 1223 1312 
11 222 607 694 741 
19 179 553 559 722 
23 85 86 942 1195 
47 327 798 980 1094 
98 454 944 986 1080 
118 645 952 977 1000 
120 375 1062 1160 1171 
134 427 653 742 1100 
146 230 287 858 1168 
181 185 524 1236 1351 
237 418 539 932 933 
273 902 903 954 1047 
315 586 837 838 1283 
336 530 556 1317 1329 
365 596 659 701 1196 
390 587 731 916 1212 
422 685 829 955 1338 
433 508 705 890 953 
10 857 1122 1349 
28 465 735 1001 
39 223 1072 1347 
55 79 325 1066 
65 379 589 732 
80 286 807 808 
82 835 1076 1077 
94 394 889 1079 
101 314 621 1044 
151 772 1111 1255 
159 554 927 1042 
169 226 848 1067 
209 782 900 1324 
235 580 583 1278 
244 366 410 744 
258 963 1269 1279 
275 609 610 1021 
283 666 922 1054 
285 341 408 649 
289 403 704 945 
347 430 595 688 
371 436 698 1141 
389 461 683 1216 
396 651 990 1011 
416 481 823 1147 
447 984 1104 1342 
449 455 592 1253 
689 866 894 895 
795 864 879 962 
827 998 1154 1321 
850 851 1073 1291 
992 1224 1225 1243 
1164 1165 1288 1305 
6 246 813 
12 821 1272 
35 660 1354 
37 339 544 
51 597 1146 
52 949 950 
53 696 975 
67 908 1220 
75 594 619 
83 178 791 
84 672 877 
89 90 278 
97 1028 1032 
124 502 792 
125 216 1103 
155 392 1206 
158 579 1256 
173 802 983 
180 190 747 
186 385 860 
192 411 700 
236 538 675 
240 274 1235 
247 999 1036 
257 338 548 
265 818 910 
303 355 367 
320 526 1271 
333 822 985 
342 504 1248 
357 551 648 
363 668 841 
424 506 956 
425 719 720 
446 891 892 
450 810 1086 
478 632 1114 
494 633 1012 
498 582 1159 
510 749 799 
540 1226 1285 
567 777 785 
671 825 1314 
687 994 1020 
706 1264 1344 
761 762 793 
884 885 1277 
896 1203 1286 
946 1092 1252 
1098 1161 1237 
1115 1254 1343 
1193 1194 1260 
1244 1245 1261 
