0 1 15 34 36 40 59 77 83 84 88 108 115 136 148 149 178 201 208 220 238 285 298 305 324 341 347 352 360 368 376 381 387 388 400 408 412 421 422 430 433 464 471 473 475 503 508 520 532 535 557 573 584 587 599 608 627 649 652 672 677 678 688 724 726 736 749 765 770 776 781 784 787 828 846 847 853 869 876 877 888 899 953 955 957 1007 1011 1044 1061 1076 1097 1129 1198 1229 1236 1237 1247 1248 1259 1266 1272 1273 1293 1307 1308 1309 1315 1327 1332 1334 1338 1348 
4 10 16 44 94 116 118 119 131 140 167 173 214 216 251 252 288 291 292 295 346 361 365 394 395 416 429 432 438 445 461 466 490 494 499 501 514 515 523 541 543 567 570 604 615 618 633 645 650 659 683 689 699 701 743 755 758 777 785 790 796 797 800 802 824 849 889 909 937 946 947 951 952 961 976 977 983 1005 1032 1034 1041 1042 1043 1053 1064 1070 1079 1085 1091 1092 1095 1102 1103 1119 1120 1123 1147 1175 1180 1196 1200 1202 1203 1216 1252 1333 
5 48 56 57 105 127 128 137 141 162 170 171 191 192 223 225 264 268 281 299 300 320 328 366 391 393 409 425 434 446 460 477 486 487 496 504 512 526 528 530 534 536 537 542 556 561 564 571 595 600 601 616 623 624 656 692 715 718 719 750 775 801 809 898 966 969 991 1057 1072 1107 1108 1124 1135 1156 1169 1177 1211 1233 1234 1241 1271 1290 1302 1306 1317 1319 1346 1347 
23 49 50 61 85 86 109 154 186 235 241 261 273 350 351 359 385 386 397 404 413 444 450 479 493 495 546 574 581 588 593 594 612 613 651 710 713 717 723 727 744 789 791 810 812 826 842 843 860 873 881 902 903 911 942 954 967 986 993 1000 1003 1013 1027 1040 1047 1056 1071 1086 1100 1109 1136 1153 1195 1197 1209 1232 1258 1275 1295 1299 1313 1316 1339 1340 1341 1350 
3 12 14 103 104 107 113 114 139 150 156 157 187 196 197 263 276 282 322 323 336 337 357 370 396 405 458 472 525 550 551 563 580 583 591 603 606 611 636 638 648 653 667 712 733 737 752 759 760 821 904 905 919 960 981 982 1009 1010 1021 1026 1116 1132 1139 1173 1183 1185 1191 1222 1278 1282 1296 1297 1329 1344 
13 20 22 54 65 69 75 82 95 96 111 112 124 132 155 195 200 204 205 224 249 250 255 303 308 321 349 354 355 367 375 379 380 392 419 481 488 489 502 511 589 598 619 625 643 676 706 721 722 728 732 773 786 792 804 811 866 995 997 1002 1077 1146 1188 1201 1206 1244 1245 1261 1325 
33 45 46 47 70 71 72 93 110 133 135 146 158 213 237 248 254 287 301 302 318 325 327 362 378 389 424 431 474 506 531 540 566 577 579 605 687 693 702 707 739 748 764 798 814 817 855 892 915 979 980 987 996 1031 1046 1082 1094 1115 1168 1170 1217 1226 1254 1256 1285 1289 1300 1312 1343 
164 165 174 175 176 233 260 266 312 313 317 334 348 414 423 428 442 521 522 575 576 630 631 634 646 690 703 746 761 762 771 793 816 819 844 850 851 863 868 878 891 921 938 940 1012 1016 1055 1073 1112 1113 1128 1133 1134 1208 1263 
8 28 62 203 211 229 232 262 319 435 440 441 449 455 465 492 505 558 560 592 622 679 680 735 753 754 783 823 839 840 862 896 925 935 972 990 1001 1098 1161 1164 1165 1227 1253 1267 1268 1286 1288 1305 1320 1330 1331 
19 24 27 43 117 122 134 179 242 245 253 277 345 353 372 426 427 452 553 572 590 637 639 658 669 671 684 704 729 742 778 825 845 856 929 931 936 1008 1142 1172 1215 1298 1314 1322 1323 
11 51 102 222 315 330 331 507 509 510 517 518 547 555 586 597 607 694 725 740 741 766 767 799 837 838 854 920 956 1018 1059 1078 1150 1152 1157 1163 1184 1238 1283 1345 
26 30 60 98 100 126 163 240 274 289 293 294 316 332 358 390 417 459 463 497 614 640 691 697 731 820 879 916 971 978 1022 1080 1117 1187 1205 1210 1212 1235 1310 1318 
18 97 123 152 172 180 190 219 221 244 256 265 269 279 326 407 410 439 443 453 454 635 665 705 747 794 818 836 867 890 910 914 944 1028 1036 1060 1075 
29 76 153 159 217 231 307 369 382 384 478 482 554 568 632 641 642 734 830 883 924 927 928 1014 1019 1051 1084 1088 1089 1114 1144 1155 1176 1304 
31 32 37 42 64 189 212 218 234 309 339 340 457 529 544 626 664 779 780 803 861 930 943 948 970 1033 1035 1118 1125 1162 1213 1262 1292 
39 81 89 90 181 185 271 278 284 310 311 483 500 524 562 655 657 660 852 874 882 886 887 965 992 1017 1131 1224 1225 1243 1280 1351 1354 
267 363 364 399 420 513 565 596 647 805 806 913 968 974 994 1004 1020 1025 1050 1090 1149 1158 1193 1194 1230 1240 1242 1260 1276 1303 1326 1335 1336 
25 53 66 68 121 177 193 272 306 377 402 415 456 467 485 516 527 585 663 686 815 835 875 923 1030 1039 1049 1106 1145 1192 
87 160 161 188 198 215 239 243 270 297 335 437 533 552 602 709 756 884 885 958 959 973 1068 1069 1204 1277 
91 92 147 166 194 343 398 559 654 682 774 880 906 907 1045 1065 1081 1083 1093 1099 1110 1231 1246 
9 101 125 151 314 480 620 621 695 716 730 831 832 950 1111 1182 1228 1255 
80 230 258 286 476 498 549 582 795 807 808 858 864 962 963 1159 1269 1279 
7 58 67 73 74 329 484 545 745 865 900 908 1220 1221 1249 1287 1324 
55 227 228 403 418 539 894 895 897 932 933 945 1006 1023 1048 1186 1199 
142 143 236 371 436 538 675 698 738 772 833 834 1141 1151 1257 1264 1337 
206 207 447 448 644 714 857 984 1015 1104 1122 1140 1311 1342 1349 
63 304 342 344 681 711 871 872 1037 1148 1166 1189 1265 1301 
259 296 356 383 751 893 1038 1178 1181 1207 1218 1219 1223 1328 
17 182 290 333 469 470 696 822 941 975 985 1291 
144 209 210 247 411 569 700 782 999 1052 1063 1105 
406 468 617 827 912 998 1024 1137 1138 1154 1167 1321 
79 768 769 917 918 939 1066 1179 1190 1274 1284 
99 183 184 199 373 374 519 926 1074 1096 1130 
2 21 129 130 451 578 870 901 1143 1239 
6 35 246 283 666 813 922 1029 1054 1281 
120 257 280 338 548 859 1062 1160 1171 
52 169 226 848 949 1058 1067 1294 
78 275 609 610 661 662 989 1101 
138 491 628 629 670 720 934 
38 106 145 988 1270 
168 202 685 829 1121 
401 673 674 788 964 
462 668 708 763 841 
41 757 1087 1214 
