1 12 13 22 23 32 34 36 40 42 43 53 55 59 63 66 69 86 87 93 94 111 119 130 148 149 156 174 189 195 208 212 219 220 234 235 245 250 252 255 257 258 259 269 272 277 278 280 296 303 305 306 308 309 320 322 325 327 339 340 349 350 352 353 355 360 361 362 366 374 381 388 392 403 406 410 414 421 433 438 440 443 467 468 475 501 502 503 504 508 513 515 516 526 570 573 588 591 594 599 600 604 606 608 619 626 627 645 649 792 817 845 867 872 875 877 891 908 909 936 937 960 979 997 1012 1023 1037 1058 1081 1106 1147 1162 1187 1213 1217 1238 1239 1260 1266 1273 1282 1315 1332 1348 
4 26 30 33 70 88 97 124 133 135 155 158 172 180 204 207 244 256 268 271 288 291 294 301 302 334 354 356 395 429 453 454 461 499 598 615 636 687 693 711 737 765 778 802 859 889 922 944 985 998 1020 1073 1093 1094 1103 1114 1154 1158 1167 1189 1195 1317 
44 117 129 178 185 265 317 372 373 391 445 543 589 618 666 674 768 782 784 790 818 916 933 954 970 988 1024 1034 1053 1066 1076 1091 1123 1141 1200 1205 1243 
7 126 138 336 390 396 397 474 556 561 578 581 582 704 707 728 748 759 779 820 945 951 980 1136 1159 1181 1218 1329 
48 56 191 233 393 460 542 624 648 656 715 742 803 809 841 969 996 1124 1135 1177 1223 1233 1234 1290 1302 1306 1328 
5 75 81 82 83 132 284 285 307 347 457 464 477 488 489 569 593 595 601 625 688 795 1041 1118 1129 1131 
139 164 193 194 312 469 470 511 521 690 827 972 1014 1016 1026 1027 1049 1055 1074 1086 1116 1156 
31 46 141 238 275 409 428 434 527 534 539 545 634 653 672 718 785 899 953 1096 1271 
57 145 248 318 420 426 437 476 530 566 602 710 764 915 987 1142 1194 1206 1241 1289 1310 
25 91 213 214 273 299 328 329 484 537 610 729 865 903 1319 
84 85 153 201 210 412 473 506 702 942 956 1052 1063 1075 1321 
106 176 188 224 260 313 348 419 512 771 974 1068 1208 1270 1275 
319 332 345 365 435 491 550 560 659 754 766 783 981 1051 1161 
14 15 267 341 565 743 913 968 1025 1050 1090 1230 1242 1303 
41 522 524 675 774 849 904 961 982 1166 1229 1232 1350 1351 
45 378 446 496 528 622 746 747 752 773 815 892 1173 1210 
152 295 358 359 394 425 462 523 665 757 794 910 1021 
198 270 297 335 533 535 536 871 958 973 1148 1265 1301 
215 310 311 459 494 552 590 654 655 658 744 756 931 
6 29 190 376 401 449 450 585 607 686 921 1043 
101 375 400 652 813 906 907 957 1029 1044 1045 1281 
254 482 483 641 642 829 830 924 928 1084 1105 1144 
24 136 330 427 517 518 657 781 856 929 1215 
92 105 116 398 466 490 559 775 1071 1099 1333 
0 37 104 367 498 548 549 583 609 978 
47 147 471 798 808 879 880 1065 1082 1083 
79 493 574 580 661 662 986 989 1101 1110 
107 108 187 203 298 389 611 733 860 1236 
140 436 447 485 894 895 946 1006 1039 1079 
509 510 739 740 828 854 1078 1157 1299 1343 
3 240 382 384 385 749 843 1088 1089 
18 713 714 788 1098 1115 1237 1254 1295 
20 21 415 901 1143 1183 1198 1278 1325 
51 52 221 227 992 1022 1048 1087 1146 
128 137 171 486 564 616 623 692 1107 
165 293 442 495 697 758 814 1117 1253 
217 479 734 839 840 917 918 1019 1304 
11 371 529 664 694 698 930 1145 
61 62 876 896 1001 1100 1259 1330 
68 338 640 670 835 893 971 1214 
95 122 667 703 745 983 1104 1342 
146 287 448 682 786 787 858 1249 
182 186 282 793 822 964 1054 1199 
342 576 772 966 993 1111 1222 1248 
357 478 555 579 632 725 1184 1256 
387 620 717 776 846 847 1097 1192 
677 678 777 862 873 976 1033 1153 
679 680 1155 1164 1165 1288 1305 1331 
16 17 78 274 326 405 1235 
73 266 404 651 723 800 1077 
96 231 232 507 633 638 1209 
113 114 202 525 531 967 1062 
120 816 1160 1193 1244 1245 1261 
183 184 337 709 1069 1130 1204 
629 801 807 869 898 1038 1202 
805 806 868 1246 1263 1335 1336 
98 243 423 439 557 1028 
103 541 705 706 882 1031 
154 225 386 1003 1056 1258 
211 216 229 283 441 753 
261 413 810 842 1224 1225 
399 1017 1064 1172 1227 1320 
769 939 1190 1274 1284 1316 
1009 1010 1185 1191 1296 1297 
27 60 100 163 417 
28 50 71 465 1314 
35 660 1216 1220 1354 
39 142 223 1067 1347 
65 263 379 732 804 
74 123 197 727 1002 
118 290 331 975 1000 
125 151 949 1109 1255 
206 500 947 1122 1349 
218 669 995 1102 1125 
239 292 767 1133 1345 
249 681 811 812 857 
264 416 696 721 1108 
276 558 836 1221 1287 
300 962 963 1047 1269 
407 617 861 1272 1294 
408 431 432 701 905 
553 673 722 938 1196 
567 824 912 1119 1120 
612 613 630 911 1171 
646 647 1134 1276 1326 
684 685 955 1279 1298 
833 834 1150 1151 1257 
54 644 848 1182 
76 712 791 925 
89 90 222 1311 
112 169 226 1169 
121 253 1005 1318 
159 262 926 1138 
177 424 668 959 
192 411 864 883 
196 554 1042 1178 
205 1201 1327 1338 
209 900 1188 1324 
237 418 823 932 
241 492 1013 1152 
281 444 671 870 
351 621 902 1240 
369 750 799 1346 
370 380 676 984 
430 890 1060 1072 
455 456 741 1040 
463 691 940 994 
519 852 886 887 
540 1170 1226 1285 
568 731 755 1212 
575 635 780 1035 
730 950 1015 1057 
770 943 948 1247 
853 935 1262 1292 
2 514 819 
9 279 878 
10 161 897 
19 179 562 
38 738 919 
49 603 762 
58 200 1139 
64 532 631 
72 497 1175 
99 199 628 
109 487 826 
110 175 914 
134 735 1231 
160 402 1030 
162 708 763 
166 230 1168 
228 247 1036 
242 544 1211 
246 364 383 
304 736 821 
316 572 639 
323 724 1070 
344 538 577 
452 480 605 
472 547 1179 
551 855 965 
571 596 597 
637 1121 1140 
695 716 832 
700 719 720 
789 941 1300 
837 838 1283 
850 851 1291 
874 990 1011 
881 923 934 
884 885 1277 
952 977 999 
1008 1032 1252 
1092 1176 1197 
