24 43 49 50 84 120 138 139 186 218 235 242 245 257 258 273 277 286 292 312 313 338 350 351 357 375 385 404 444 479 493 494 498 499 507 509 522 540 548 549 550 551 555 574 575 580 582 588 594 633 646 648 651 670 671 672 684 690 711 712 727 729 767 789 807 808 812 825 843 854 860 873 876 877 881 902 903 929 934 938 954 963 967 990 996 1008 1009 1010 1011 1012 1013 1014 1016 1026 1033 1040 1047 1062 1086 1113 1116 1128 1133 1150 1153 1158 1159 1160 1166 1171 1172 1176 1185 1191 1197 1203 1209 1215 1226 1227 1232 1259 1262 1269 1278 1279 1285 1292 1296 1297 1298 1314 1316 1335 1340 1341 1345 1350 
4 10 11 38 44 46 77 87 108 110 116 117 118 119 131 135 140 167 173 204 214 216 253 288 291 295 326 346 352 358 362 365 372 389 395 397 400 429 431 432 445 461 466 474 490 514 515 531 532 541 543 570 607 615 618 621 645 659 683 689 694 699 701 714 726 741 743 755 758 764 765 784 790 794 800 802 849 857 866 889 894 895 937 946 951 952 961 976 977 983 988 1005 1007 1024 1034 1042 1043 1052 1053 1061 1091 1092 1095 1102 1103 1122 1123 1140 1180 1196 1200 1216 1252 1275 1293 1307 1308 1313 1315 1328 1333 1339 1349 
9 18 25 66 68 69 78 98 121 123 142 143 152 165 174 177 190 193 219 221 234 243 259 266 272 275 279 296 306 334 356 377 383 402 407 414 415 419 424 425 442 443 454 456 467 485 506 516 527 585 609 610 630 631 650 661 662 663 665 686 703 719 746 747 751 805 806 815 816 836 844 850 851 863 868 875 878 893 921 923 925 940 944 956 972 986 989 1021 1028 1030 1038 1039 1049 1055 1073 1080 1101 1106 1112 1134 1145 1178 1181 1192 1207 1218 1219 1223 1263 1264 1291 1318 1336 1337 1344 
6 7 16 29 32 35 55 58 67 73 74 79 102 103 104 109 132 148 149 150 156 157 192 196 197 209 229 246 247 251 283 325 329 370 401 405 411 457 472 475 484 488 489 501 503 510 523 529 545 546 568 576 612 613 625 636 660 664 666 674 695 700 713 740 745 749 779 780 781 782 788 799 813 826 861 865 884 885 899 900 904 905 911 922 930 964 982 999 1035 1041 1054 1059 1066 1078 1109 1118 1152 1157 1221 1247 1266 1273 1277 1287 1295 1299 1309 1324 1334 1348 1354 
0 1 22 31 34 36 37 40 42 64 82 83 88 115 178 189 208 212 220 238 280 285 309 320 339 340 341 347 360 368 376 381 387 388 398 408 412 421 430 433 438 471 491 508 520 526 544 573 584 593 599 608 620 626 627 649 677 678 688 705 736 770 776 787 791 803 828 832 835 846 847 859 888 890 943 948 953 957 970 1076 1077 1081 1097 1124 1125 1162 1198 1213 1229 1271 1332 
48 56 57 71 105 127 128 137 141 160 162 170 171 188 191 239 264 268 281 299 300 328 336 391 393 428 434 437 446 460 486 487 496 512 528 530 536 537 542 552 556 564 567 571 595 600 601 602 605 616 623 624 634 656 692 715 718 748 750 775 777 785 801 809 867 891 892 958 966 969 991 1057 1068 1069 1107 1108 1135 1156 1169 1177 1234 1241 1290 1302 1306 1317 1319 1329 1346 
5 26 30 33 45 52 70 126 129 130 133 158 161 163 169 180 194 226 227 228 237 254 289 290 293 294 301 302 403 418 436 463 464 477 497 539 577 579 640 691 693 697 704 707 716 724 763 814 820 848 897 932 933 945 949 971 978 1006 1022 1023 1048 1058 1067 1070 1071 1093 1117 1129 1175 1187 1199 1205 1210 1231 1238 1239 1248 1256 1294 1310 1312 1320 
3 14 15 39 51 91 92 107 113 114 147 187 203 211 223 262 267 276 282 322 323 324 337 396 440 441 458 492 525 560 565 583 591 596 597 603 611 622 638 653 654 667 682 709 733 737 752 753 754 759 760 774 783 880 906 907 913 960 968 981 1004 1025 1045 1065 1072 1083 1090 1110 1132 1139 1173 1183 1204 1222 1230 1242 1246 1282 1303 1347 
13 20 54 65 95 96 111 112 155 172 195 200 205 206 207 224 249 250 255 256 303 305 308 321 353 354 355 367 379 380 392 447 448 511 547 589 598 619 637 643 644 673 676 706 721 723 728 732 773 786 797 804 811 947 984 995 997 1002 1015 1060 1104 1136 1146 1163 1170 1188 1201 1206 1233 1322 1323 1325 1327 1338 1342 
2 19 21 23 27 28 59 61 62 85 86 97 122 134 179 198 199 244 270 297 298 316 335 345 349 366 410 426 427 451 465 533 535 553 559 572 578 590 639 658 669 722 735 742 744 778 795 817 827 845 853 856 864 870 896 901 931 936 942 959 962 973 998 1001 1032 1100 1142 1143 1148 1154 1195 1286 1321 1330 
159 217 231 232 359 364 399 406 416 420 449 455 468 481 482 505 513 554 592 617 628 629 641 642 647 679 680 687 720 734 823 830 839 840 862 912 924 927 928 935 974 993 994 1019 1020 1050 1064 1084 1098 1137 1138 1144 1147 1149 1155 1161 1164 1165 1193 1194 1228 1237 1240 1253 1260 1267 1268 1276 1288 1304 1305 1326 1331 
8 12 47 72 89 90 93 94 124 146 166 202 213 222 230 248 263 278 287 317 318 319 327 361 378 394 435 476 478 502 558 563 566 604 606 632 739 766 792 798 821 855 858 908 909 915 980 987 1031 1079 1082 1094 1114 1115 1168 1220 1244 1245 1249 1254 1261 1272 1289 1300 1311 1343 
17 53 60 100 181 182 185 240 241 261 271 274 332 333 363 390 413 417 459 462 469 470 495 524 587 614 668 696 708 717 725 731 796 810 822 824 841 842 879 916 941 975 985 992 1027 1119 1120 1167 1212 1224 1225 1235 1236 1243 1351 
41 75 76 80 144 153 154 168 201 210 215 225 269 307 369 382 384 386 409 422 561 569 685 756 757 829 869 883 898 914 955 1003 1029 1051 1056 1063 1075 1087 1088 1089 1105 1121 1202 1211 1214 1258 1265 1281 
81 99 183 184 284 310 311 315 373 374 483 500 519 562 586 655 657 702 837 838 852 874 882 886 887 919 926 965 1017 1074 1096 1099 1130 1131 1280 1283 
63 101 125 151 252 304 314 342 343 344 450 452 480 504 534 652 681 730 831 871 872 950 979 1037 1044 1046 1085 1111 1182 1186 1189 1217 1255 1301 
136 164 236 371 423 439 473 521 538 557 581 635 675 698 710 738 761 762 772 793 833 834 1000 1036 1141 1151 1257 
106 145 175 176 233 260 330 331 348 517 518 771 819 920 1018 1184 1208 1270 
265 453 768 769 818 910 917 918 939 1179 1190 1274 1284 
