48 56 57 105 127 128 137 158 162 170 171 191 192 207 264 281 391 393 429 460 477 486 487 512 542 564 571 579 595 616 623 624 656 673 691 692 715 723 775 809 851 961 966 969 1060 1073 1107 1108 1124 1135 1170 1177 1233 1234 1241 1256 1290 1302 1306 
4 10 44 100 131 140 172 173 394 395 432 438 445 461 466 471 490 514 515 543 618 665 683 689 743 755 790 800 802 841 849 889 894 895 976 983 1005 1034 1053 1064 1091 1102 1123 1200 1216 1333 
3 76 101 151 215 252 314 366 369 382 384 385 480 558 561 632 744 756 883 898 991 1036 1085 1088 1089 1111 1114 1182 1183 1202 1211 1255 
0 1 15 22 34 36 208 212 220 238 360 381 388 421 573 599 608 627 726 736 787 803 957 1153 1198 1236 1332 
8 102 187 203 211 217 229 262 319 435 440 441 492 505 560 622 753 754 766 783 823 839 840 862 925 935 981 
13 20 54 95 96 112 195 200 204 205 255 308 349 361 428 511 811 866 1146 1201 1325 
72 93 237 248 317 318 378 478 566 739 855 915 987 996 1031 1046 1082 1289 1300 
14 107 336 337 396 525 565 603 611 667 712 733 759 913 1004 1329 1344 
45 126 163 180 290 293 294 316 463 640 697 763 820 971 1093 1117 1210 
31 32 42 64 189 218 219 234 309 340 457 634 861 943 970 1213 
24 43 242 245 277 452 684 729 856 929 1008 1172 1215 1298 
27 122 345 426 572 590 658 669 778 845 931 936 1142 
68 121 193 377 402 456 485 516 527 923 1030 1039 1145 
225 299 300 328 536 537 600 601 750 1057 1169 1319 1346 
231 232 482 641 642 734 830 924 928 1019 1084 1144 1155 
148 149 475 503 749 781 832 899 1247 1266 1273 1348 
364 420 513 596 647 1050 1149 1240 1242 1276 1326 1335 
91 92 343 559 654 682 906 907 1045 1099 1246 
103 104 150 156 196 197 472 636 904 905 1021 
154 240 273 386 902 903 954 1003 1047 1056 1258 
165 266 279 414 442 576 630 816 863 878 940 
167 214 295 541 570 615 639 699 951 1042 1103 
241 261 413 495 717 810 842 1027 1167 1212 1275 
5 33 133 301 302 454 577 687 693 944 
7 58 73 74 329 484 545 745 900 1324 
147 274 774 879 880 1065 1083 1110 1235 1311 
206 448 499 714 797 946 947 1015 1079 1140 
280 368 387 620 776 846 847 859 888 1229 
61 134 376 427 470 742 972 1049 1100 
81 284 852 874 886 887 1017 1131 1280 
141 160 268 434 496 501 528 718 801 
334 631 703 746 868 921 1055 1112 1263 
507 509 510 555 677 678 799 828 1150 
11 222 607 621 694 741 767 1345 
18 123 152 174 221 407 836 867 
49 50 350 588 812 1040 1086 1197 
59 270 298 341 535 817 853 1148 
87 108 161 352 532 784 909 1315 
132 224 305 354 375 488 625 815 
139 370 591 638 737 1026 1116 1173 
175 176 233 260 348 771 819 1208 
227 228 288 418 1006 1023 1048 1199 
351 404 574 651 843 1013 1232 1350 
769 917 918 939 1179 1190 1274 1284 
30 978 1070 1071 1187 1205 1310 
40 84 672 876 877 1011 1259 
124 502 722 792 1244 1245 1261 
198 199 297 335 533 959 973 
239 602 884 885 958 1069 1277 
276 458 760 960 1132 1222 1282 
313 405 521 522 690 1016 1128 
330 331 517 518 920 1018 1184 
679 680 1164 1165 1288 1305 1331 
740 854 956 1059 1078 1152 1157 
779 780 1033 1035 1118 1262 1292 
2 21 451 870 901 1143 
6 35 246 813 1029 1281 
28 62 465 735 1001 1330 
52 716 730 831 949 950 
63 871 872 1037 1265 1301 
78 610 661 662 989 1101 
94 272 356 650 751 893 
99 374 519 926 1074 1096 
111 250 256 676 706 995 
113 114 282 322 752 1139 
118 416 645 952 977 1147 
144 210 569 1052 1063 1105 
177 585 663 686 875 1106 
185 524 657 660 1351 1354 
267 968 1025 1090 1230 1303 
310 311 483 562 655 882 
738 772 833 834 1151 1257 
770 827 998 1024 1154 1321 
1009 1010 1185 1191 1296 1297 
1181 1207 1218 1219 1223 1328 
23 85 86 942 1195 
25 306 415 467 844 
39 992 1224 1225 1243 
47 327 798 980 1094 
55 79 768 1066 1186 
65 379 589 644 732 
67 908 1220 1221 1287 
70 194 254 1231 1312 
83 178 791 835 1044 
109 646 826 1109 1134 
116 291 346 1043 1203 
120 243 1062 1160 1171 
129 130 578 1238 1239 
164 166 400 423 520 
236 371 436 698 1141 
292 575 1012 1113 1133 
397 546 713 1295 1299 
412 468 617 1137 1138 
433 508 705 890 953 
498 549 582 604 1159 
765 1007 1061 1307 1308 
16 251 523 1175 
17 469 941 1291 
41 757 1087 1214 
46 135 325 389 
60 332 417 614 
110 362 474 748 
115 285 408 649 
146 287 358 1168 
182 333 822 985 
188 437 552 1068 
202 464 1129 1248 
209 247 782 999 
235 580 919 1278 
244 409 410 850 
258 963 1269 1279 
265 453 818 910 
269 443 914 1075 
283 666 922 1054 
321 489 1002 1188 
323 324 583 653 
347 430 584 688 
357 550 551 648 
425 450 719 1156 
444 594 789 967 
447 984 1104 1342 
529 664 695 930 
539 897 932 933 
586 837 838 1283 
643 728 773 1136 
671 704 825 1314 
796 824 1119 1120 
805 806 1158 1336 
12 821 1272 
19 179 553 
37 339 544 
51 315 597 
53 696 975 
71 979 1217 
75 619 786 
89 90 278 
97 1028 1032 
98 459 1304 
106 145 1270 
117 253 372 
136 473 557 
138 670 720 
153 307 1051 
155 392 1206 
159 554 927 
183 373 659 
216 758 937 
223 1072 1347 
230 808 858 
257 338 548 
263 563 606 
296 383 1178 
320 526 1271 
365 701 1196 
390 731 916 
399 974 1228 
439 1092 1252 
446 891 892 
462 708 725 
479 613 727 
493 1209 1316 
530 556 1317 
534 873 881 
540 1226 1285 
567 777 785 
581 710 1000 
593 612 911 
681 711 1189 
761 762 793 
795 864 962 
857 1122 1349 
896 990 1286 
955 1327 1338 
986 1080 1318 
1115 1254 1343 
1193 1194 1260 
