6 7 25 29 35 40 55 58 66 67 68 69 73 74 79 83 121 136 148 149 172 178 190 193 306 329 347 376 377 401 402 403 412 419 424 456 467 473 484 485 503 506 516 527 529 545 546 557 568 584 585 593 607 620 640 660 663 664 667 674 686 688 695 712 716 740 745 749 781 788 791 832 865 875 899 900 908 922 923 925 930 956 971 972 1007 1030 1039 1049 1059 1061 1066 1078 1106 1145 1157 1196 1220 1221 1237 1247 1249 1266 1273 1307 1309 1318 1334 1348 1354 
20 37 46 54 65 87 88 111 112 119 124 135 155 161 195 200 204 206 207 224 239 249 250 255 256 291 303 308 321 349 354 361 367 379 380 406 407 429 447 448 468 502 511 544 547 589 598 602 615 617 619 628 629 643 644 681 711 720 721 728 732 765 786 792 804 811 815 824 827 850 851 909 912 947 952 961 984 995 997 998 1015 1043 1064 1073 1097 1119 1120 1137 1138 1154 1159 1160 1168 1182 1189 1206 1231 1244 1245 1261 1308 1321 1325 
14 28 61 62 84 107 109 113 114 150 156 182 184 196 276 282 283 322 323 336 337 396 404 458 465 525 565 603 611 636 638 639 646 647 651 653 666 672 699 709 725 733 735 737 752 757 759 760 782 805 806 826 843 868 876 877 896 913 941 951 960 964 990 1001 1004 1011 1013 1054 1069 1130 1132 1134 1139 1158 1203 1204 1222 1232 1236 1259 1263 1278 1282 1286 1326 1329 1330 1335 1336 1350 
48 56 57 105 127 128 137 141 157 160 162 170 171 188 191 192 236 264 268 281 371 391 393 428 434 436 437 460 477 486 487 496 512 528 530 542 552 556 564 571 595 616 623 624 634 656 657 673 675 676 691 692 698 706 715 718 723 775 801 809 884 885 894 895 966 969 982 1006 1060 1068 1107 1108 1135 1141 1170 1177 1233 1234 1241 1277 1290 1302 1306 1317 
4 10 11 44 53 100 117 131 140 167 216 243 265 295 316 325 326 370 392 394 395 439 445 461 466 471 490 491 514 515 523 540 541 543 570 618 621 635 683 694 696 714 743 755 758 764 794 796 797 800 818 849 857 889 937 946 975 976 1005 1034 1053 1079 1091 1092 1102 1103 1122 1123 1140 1200 1216 1226 1252 1333 1349 
0 1 12 15 22 34 36 42 64 94 169 174 208 212 220 238 240 259 267 272 273 304 305 324 327 356 360 381 388 398 415 421 464 475 526 573 599 606 608 626 627 650 652 726 736 751 787 803 821 844 893 902 903 948 954 957 968 1025 1047 1058 1081 1090 1124 1129 1198 1230 1248 1294 1303 1332 
38 77 82 108 110 126 163 180 221 227 228 237 288 289 290 294 352 362 368 397 400 418 431 432 463 474 495 520 531 532 539 671 697 704 707 738 763 784 825 833 834 897 932 933 945 988 1022 1023 1024 1048 1052 1076 1077 1117 1151 1181 1199 1207 1210 1218 1219 1223 1257 1293 1314 1315 1328 
8 9 17 72 93 96 187 202 203 211 213 217 229 248 262 263 293 317 318 319 345 353 378 389 426 435 440 441 476 478 492 497 509 510 560 563 566 605 622 632 637 677 678 689 739 753 754 766 783 799 828 866 915 981 987 996 1031 1038 1082 1114 1142 1175 1289 1291 1322 1323 
30 49 50 218 241 261 350 413 479 493 507 555 588 717 724 727 812 836 873 881 978 986 1033 1040 1070 1071 1086 1136 1150 1153 1167 1187 1197 1205 1209 1212 1262 1275 1292 1310 1313 1316 1339 1340 1341 
5 18 33 45 47 70 71 98 123 129 130 133 146 152 158 254 287 301 302 357 358 425 446 551 577 579 648 665 693 719 748 798 820 829 855 867 891 892 980 1094 1238 1239 1256 1312 
41 75 76 101 154 215 225 226 258 307 314 369 382 384 386 387 409 498 549 561 562 582 604 756 835 883 991 1002 1003 1029 1044 1046 1056 1085 1087 1088 1089 1169 1188 1214 1258 1324 
16 78 132 205 274 275 411 457 488 489 576 609 610 625 661 662 700 779 780 861 879 989 1021 1035 1041 1101 1118 1201 1235 1287 1327 1338 
13 63 144 153 201 210 219 252 269 342 344 355 438 443 504 538 569 869 871 872 898 979 1037 1050 1051 1063 1075 1105 1202 1217 1301 
116 299 300 328 405 501 536 537 567 600 601 612 613 713 750 777 785 905 911 1057 1109 1115 1156 1211 1254 1295 1299 1319 1343 1344 1346 
231 232 482 554 641 642 679 680 734 773 810 830 924 927 928 1019 1042 1084 1144 1155 1164 1165 1176 1253 1267 1268 1288 1305 1331 
3 23 85 86 118 139 581 591 645 710 741 842 942 977 1000 1009 1010 1026 1027 1116 1173 1183 1185 1191 1195 1296 1297 1300 
19 27 122 134 179 253 365 372 427 470 553 572 590 596 658 659 669 701 722 742 778 845 856 931 936 1100 1242 
2 21 120 138 186 214 257 338 375 385 444 451 548 578 594 670 789 860 870 901 934 967 1062 1143 1166 1171 
31 32 189 234 280 309 320 340 430 433 508 705 770 776 846 847 859 888 890 943 953 970 1213 1229 1271 
26 39 60 142 143 181 223 271 332 417 459 534 550 614 747 848 1067 1072 1080 1163 1186 1264 1337 1347 
91 92 147 166 194 343 422 559 654 682 685 774 880 906 907 955 1045 1065 1083 1093 1099 1110 1246 
24 43 80 242 245 277 286 452 480 684 729 807 808 858 929 1008 1172 1215 1279 1298 
364 399 420 449 450 505 513 687 974 994 1020 1149 1193 1194 1227 1228 1240 1260 1276 1320 
165 230 266 279 334 414 442 630 631 703 746 814 816 863 878 921 940 1055 1192 
89 90 177 185 222 278 333 472 524 822 985 992 1152 1224 1225 1243 1311 1351 
81 284 310 311 483 500 655 852 874 882 886 887 919 965 1017 1131 1280 
59 198 270 297 298 335 494 499 533 535 633 817 958 973 1148 1265 
164 312 313 423 469 521 522 690 761 762 793 938 1014 1016 1128 1285 
339 359 416 455 481 592 823 839 840 853 862 935 993 1098 1147 1161 
235 292 351 574 575 580 583 767 854 1012 1113 1125 1133 1162 1345 
115 285 341 346 408 649 795 864 962 963 1032 1112 1269 1272 
51 173 315 597 790 802 983 1095 1104 1146 1180 1342 
106 145 175 176 233 260 348 771 819 914 1208 1270 
453 768 769 910 917 918 939 1179 1190 1274 1284 1304 
52 95 125 151 730 772 831 949 950 1111 1255 
99 159 183 199 373 374 519 702 926 1074 1096 
209 246 247 296 383 558 813 999 1036 1178 1281 
97 244 366 410 454 744 944 1028 
102 103 104 168 197 251 904 1121 
390 586 587 731 837 838 916 1283 
330 331 517 518 920 1018 1184 
363 462 668 708 841 959 
