0 1 12 13 22 23 32 36 37 42 43 44 48 53 54 55 59 63 64 65 66 75 79 83 86 87 88 93 94 108 111 112 149 151 155 174 189 195 200 205 208 212 218 219 220 234 235 242 245 250 255 256 257 259 269 272 277 278 285 296 303 304 305 306 307 308 309 321 322 327 339 340 341 349 353 355 360 361 374 375 379 381 388 398 403 415 416 421 443 467 468 473 475 502 503 504 508 526 573 588 594 599 608 625 626 627 656 681 688 724 728 736 751 770 786 798 803 812 867 873 890 899 926 936 942 952 953 980 993 997 1029 1061 1070 1071 1106 1122 1137 1138 1147 1159 1160 1167 1168 1187 1213 1234 1247 1248 1270 1272 1306 1310 1315 1325 1349 
6 7 16 24 25 34 35 40 41 58 67 73 74 76 80 81 84 85 113 123 132 142 147 148 150 157 168 169 177 190 227 291 314 315 328 329 346 366 382 384 401 402 408 412 422 424 457 464 466 484 488 489 516 519 531 545 546 547 574 576 584 585 586 593 607 612 613 629 630 631 663 667 668 675 686 700 738 745 758 772 775 779 780 788 790 791 792 807 814 832 836 837 838 843 844 854 865 874 875 883 886 900 911 948 961 986 994 1012 1024 1032 1041 1054 1058 1078 1085 1089 1094 1098 1100 1102 1109 1111 1117 1118 1124 1125 1131 1149 1150 1157 1162 1166 1179 1193 1197 1202 1220 1221 1232 1237 1240 1252 1253 1260 1261 1271 1273 1283 1294 1295 1332 1333 1350 
10 47 51 52 56 57 69 70 71 72 99 100 103 104 120 125 126 131 135 156 158 160 172 173 196 197 228 236 237 238 239 248 251 268 275 288 294 295 352 358 359 378 394 425 428 429 430 434 442 446 461 462 463 471 472 495 496 497 501 523 534 540 541 552 595 605 640 648 653 665 672 676 697 703 706 727 742 746 747 748 752 757 763 785 794 801 815 825 827 841 851 855 861 863 892 897 904 905 922 927 933 941 943 951 971 976 979 982 991 992 996 1008 1020 1021 1022 1023 1031 1048 1060 1064 1073 1088 1103 1133 1141 1170 1173 1177 1194 1195 1206 1210 1223 1233 1243 1285 1289 1300 1305 
8 9 20 101 102 124 146 187 188 202 203 211 216 217 221 229 230 246 247 252 262 263 276 319 320 332 333 334 345 354 357 365 399 431 435 440 441 476 491 492 505 550 551 558 560 561 592 622 632 635 698 733 735 753 754 756 766 783 823 852 860 862 870 935 975 981 987 995 1002 1036 1038 1067 1087 1121 1129 1188 1281 1324 
28 29 49 50 60 117 139 181 182 185 186 316 317 370 371 372 373 444 445 465 479 532 636 659 660 666 671 683 699 755 764 782 810 822 849 937 960 964 965 983 984 1005 1019 1034 1066 1092 1104 1132 1140 1161 1199 1216 1222 1229 1282 1314 1342 1354 
11 107 118 119 140 167 179 207 284 290 324 391 392 395 400 413 423 448 485 499 500 520 570 589 615 628 652 714 726 797 800 804 889 946 947 957 1042 1044 1045 1079 1211 1212 1348 
2 3 21 105 106 109 110 176 223 224 233 260 261 347 348 393 419 420 437 512 571 597 634 715 771 809 819 901 915 974 1068 1083 1139 1142 1143 1183 1208 1275 1290 1302 1347 
27 46 68 82 121 122 134 141 166 194 253 289 323 414 426 427 451 452 494 572 590 637 639 655 658 669 704 744 778 795 835 845 856 931 934 967 1007 1231 1276 
4 5 26 30 33 45 97 98 130 133 152 161 180 243 244 254 271 279 301 302 453 454 498 577 598 619 687 693 802 818 910 932 944 985 1175 1320 
127 128 136 137 170 171 191 192 264 265 460 477 478 486 487 542 564 616 623 624 691 692 710 721 1107 1108 1112 1135 1241 
258 293 318 338 350 356 367 383 548 549 557 582 583 604 609 696 869 893 940 978 1039 1086 1116 1178 1209 1269 
77 144 145 175 201 209 210 281 282 330 331 517 518 569 591 898 914 1046 1050 1051 1052 1063 1075 1105 
299 300 368 506 537 684 685 702 729 749 750 765 781 817 1172 1215 1264 1298 1307 1308 1319 1346 
38 39 232 404 405 713 760 919 1062 1115 1181 1207 1224 1225 1254 1278 1279 1299 1343 1344 
14 15 115 267 326 396 513 596 649 743 913 968 1004 1025 1090 1153 1230 1242 1303 
509 515 524 555 567 568 645 739 740 741 884 885 956 977 1013 1059 1152 1277 1351 
153 154 225 226 369 386 387 510 600 601 799 903 1003 1056 1057 1258 
646 647 805 806 826 868 906 907 1134 1158 1246 1263 1266 1326 1335 1336 
91 92 213 214 397 447 458 474 556 581 610 773 1040 1136 1328 
162 163 389 390 417 418 538 707 708 719 720 820 945 1093 1186 
312 313 469 521 522 554 633 690 789 1014 1016 1055 1128 1163 1165 
364 411 614 731 808 864 879 880 887 1065 1082 1155 1235 1287 1288 
206 249 342 514 643 644 732 811 848 857 1145 1182 1189 1198 
31 231 409 507 527 528 539 657 718 840 923 969 1096 
61 62 266 651 876 877 896 990 1001 1011 1259 1318 1330 
183 184 336 337 565 611 709 759 1069 1130 1204 1236 1329 
215 310 311 325 362 438 439 459 562 654 882 894 1028 
164 165 406 407 580 761 762 793 816 878 1244 1245 
283 529 530 664 694 695 839 859 930 999 1035 1317 
535 536 871 872 998 1037 1148 1154 1169 1265 1301 1321 
116 480 730 831 949 950 1015 1047 1203 1228 1286 
432 673 674 701 705 722 723 921 938 1043 1196 
482 483 641 642 734 829 830 924 928 1084 1144 
95 96 204 490 563 578 579 866 1114 1146 
193 376 470 511 821 925 972 1030 1049 1072 
198 199 270 297 298 335 533 958 959 973 
78 493 661 662 774 918 970 989 1101 
292 575 767 902 988 1091 1113 1345 
650 725 796 824 912 1119 1120 1201 
178 351 784 954 1076 1077 1080 
280 620 846 847 888 1097 1192 
18 19 553 559 566 787 
89 90 222 920 1110 1311 
240 241 273 274 385 929 
286 287 682 858 908 1249 
433 525 602 603 1081 1262 
638 737 1017 1018 1099 1280 
1009 1010 1185 1191 1296 1297 
129 606 891 1238 1239 
377 455 456 670 1214 
587 1074 1217 1256 1293 
677 678 776 777 828 
711 712 842 1026 1027 
769 1190 1274 1284 1316 
17 410 850 1291 
138 881 1171 1184 
436 689 895 1006 
449 450 1156 1255 
679 680 1164 1331 
768 917 939 1304 
833 834 1151 1257 
916 1053 1123 1200 
114 813 909 
159 1000 1176 
343 344 481 
363 380 966 
617 618 1205 
621 716 717 
853 1033 1292 
955 1327 1338 
1126 1127 1174 
1218 1219 1312 
