9 27 31 44 46 60 64 77 100 117 141 152 157 178 181 182 185 186 215 217 236 238 265 268 275 279 281 282 295 310 316 317 345 358 359 370 372 373 380 391 409 417 425 427 428 434 435 444 445 459 462 479 494 523 527 532 534 535 536 543 545 551 552 553 572 589 590 612 618 631 634 639 653 654 655 658 663 665 666 671 672 673 674 676 718 722 725 726 734 744 756 764 770 782 784 785 790 793 794 816 818 822 839 840 855 856 870 871 878 899 911 916 917 918 920 931 933 938 943 948 953 954 958 964 965 970 984 988 1019 1021 1024 1034 1053 1054 1066 1076 1091 1095 1096 1123 1128 1141 1148 1180 1181 1186 1196 1199 1200 1205 1218 1219 1225 1243 1244 1245 1247 1261 1271 1277 1293 1301 1304 1312 
1 12 13 22 23 32 34 36 40 42 43 53 55 59 66 69 86 87 93 94 111 119 130 148 149 156 165 174 189 195 208 212 219 220 234 235 245 250 252 255 257 258 259 269 272 277 278 280 296 303 305 306 308 309 320 322 325 327 339 340 349 350 352 353 355 360 361 362 366 374 381 388 392 403 406 410 414 421 433 438 440 467 468 475 501 502 503 504 508 513 515 516 526 570 573 575 588 591 594 599 600 604 606 608 619 626 627 635 645 649 780 792 817 845 854 863 867 875 877 891 908 909 936 937 960 979 997 1012 1023 1035 1058 1078 1081 1106 1147 1157 1162 1187 1213 1217 1238 1239 1260 1266 1273 1282 1309 1315 1331 1332 1334 1348 
47 48 56 61 62 73 106 109 115 140 147 176 188 191 224 233 237 260 266 313 348 393 394 404 408 416 418 419 431 432 436 447 458 460 471 485 487 512 539 542 584 614 624 646 647 648 651 656 696 701 715 721 723 742 757 771 800 803 805 806 808 809 823 826 841 868 874 876 879 880 894 895 896 905 932 946 969 974 990 996 1001 1006 1011 1039 1065 1068 1077 1079 1082 1083 1100 1108 1112 1124 1134 1135 1177 1203 1207 1208 1223 1233 1234 1246 1259 1263 1270 1275 1276 1286 1290 1302 1306 1313 1326 1328 1330 1335 1336 1339 
6 29 35 57 74 123 125 128 137 144 145 150 151 160 166 171 177 190 197 205 230 248 314 318 333 357 376 377 401 402 420 424 426 437 449 450 472 476 478 486 519 530 540 547 555 563 564 566 579 585 602 607 616 623 632 660 668 686 689 692 710 712 727 791 852 866 886 887 914 915 921 925 949 959 985 987 991 1002 1007 1030 1043 1107 1109 1142 1168 1170 1179 1184 1194 1201 1216 1226 1241 1255 1256 1285 1289 1310 1320 1327 1338 1354 
3 19 67 80 101 102 107 108 113 114 131 167 168 173 179 183 184 187 202 203 228 247 251 264 284 286 298 324 332 337 346 375 382 384 385 387 389 415 461 463 525 531 550 558 561 562 611 613 620 630 650 652 691 709 717 733 749 754 776 813 825 833 834 843 846 847 860 888 906 907 940 957 967 981 994 1029 1036 1044 1045 1046 1059 1062 1069 1085 1088 1089 1097 1130 1149 1150 1151 1171 1192 1204 1236 1257 1281 1314 
24 25 58 63 91 95 110 122 136 139 164 175 193 194 200 213 214 273 299 312 321 328 330 469 470 484 511 517 518 521 529 537 546 610 629 657 664 667 684 685 690 703 729 740 745 781 798 801 807 810 827 865 869 872 884 885 898 903 929 930 952 955 972 977 983 999 1009 1010 1014 1016 1026 1027 1037 1038 1049 1055 1074 1080 1086 1094 1116 1136 1139 1156 1163 1185 1191 1202 1215 1279 1296 1297 1298 1307 1308 1319 
4 20 21 30 33 65 70 88 97 112 124 129 134 135 155 158 169 172 180 204 239 244 256 261 263 271 288 291 294 301 302 323 334 354 356 368 379 395 413 429 499 505 520 598 615 636 687 693 711 724 732 735 737 765 778 789 802 804 842 881 889 901 922 923 934 941 998 1008 1020 1032 1070 1073 1093 1114 1143 1154 1158 1167 1183 1189 1195 1198 1228 1231 1252 1278 1300 1325 
5 7 10 11 26 39 75 76 81 82 83 92 126 132 133 138 142 143 161 162 163 206 223 285 307 329 336 347 371 383 390 396 397 400 457 464 474 477 488 489 500 556 559 569 578 581 582 593 595 601 625 688 694 698 704 707 728 759 763 779 795 820 835 859 897 945 947 951 980 1041 1050 1060 1067 1104 1118 1122 1129 1131 1145 1159 1206 1317 1329 1337 1342 1347 1349 
0 18 37 38 51 52 68 104 146 170 221 227 287 293 338 363 367 442 448 495 498 548 549 583 609 640 670 682 697 713 714 738 758 786 787 788 814 858 893 919 971 978 992 1018 1022 1048 1052 1087 1098 1099 1115 1117 1146 1214 1220 1237 1249 1253 1254 1267 1268 1280 1295 
28 45 50 71 96 120 231 232 378 446 465 496 507 528 592 622 633 638 677 678 679 680 708 746 747 748 752 769 773 777 815 862 873 892 927 939 976 1033 1061 1092 1113 1132 1153 1155 1160 1164 1165 1173 1176 1190 1193 1197 1209 1210 1224 1274 1284 1288 1305 1316 1340 1341 
41 49 72 89 90 103 196 222 254 451 482 483 497 522 524 541 554 603 637 641 642 675 705 706 761 762 774 829 830 849 882 904 924 928 961 982 1031 1042 1084 1105 1121 1140 1144 1166 1175 1178 1229 1232 1264 1311 1322 1323 1344 1350 1351 
14 15 16 17 78 98 127 243 267 274 319 326 341 365 405 423 439 453 454 491 557 565 571 596 597 659 683 699 743 766 768 783 910 913 944 968 1004 1025 1028 1051 1090 1161 1230 1235 1242 1303 
79 218 276 292 304 407 430 443 493 574 580 617 661 662 669 736 767 821 836 861 890 986 989 995 1072 1101 1102 1110 1125 1133 1221 1272 1287 1294 1345 
105 116 240 241 242 398 455 456 466 490 492 509 510 544 567 739 741 775 799 824 828 844 912 1013 1040 1071 1119 1120 1137 1152 1211 1299 1333 1343 
159 262 342 351 422 576 621 695 700 716 719 720 730 772 831 832 853 902 926 935 950 966 993 1015 1057 1111 1138 1222 1240 1248 1262 1292 
84 85 153 154 201 210 225 226 300 369 386 412 473 506 702 750 942 956 962 963 1003 1047 1056 1063 1075 1169 1258 1265 1269 1321 1346 
118 121 192 211 216 229 253 283 290 331 411 441 452 480 560 568 586 587 605 731 753 755 864 883 975 1000 1005 1103 1212 1318 
2 54 207 209 246 249 311 315 364 514 643 644 681 811 812 819 837 838 848 857 900 1182 1188 1283 1324 
8 99 198 199 270 289 297 335 343 344 399 481 533 538 577 628 751 760 973 1017 1064 1172 1227 
796 797 850 851 1291 
