18 48 56 57 71 105 123 127 128 137 141 146 152 158 160 162 167 170 171 188 191 192 207 250 264 268 281 287 358 391 393 407 425 428 429 434 437 446 460 477 486 487 496 497 499 512 528 530 542 552 556 564 571 579 616 623 624 634 656 665 691 692 714 715 718 719 748 775 796 797 801 809 836 850 851 867 889 891 892 947 961 966 969 979 996 1068 1073 1079 1107 1108 1124 1135 1140 1177 1181 1207 1217 1218 1219 1223 1234 1241 1256 1290 1302 1306 1312 1317 
13 20 37 46 65 82 88 97 110 111 112 118 119 135 155 172 195 200 204 205 224 239 248 249 255 256 303 308 321 349 354 355 361 362 367 379 380 392 395 406 468 474 511 531 544 570 581 589 598 602 615 617 619 628 629 643 644 645 673 676 710 711 721 723 728 732 737 773 786 804 811 815 827 884 912 951 952 977 995 997 998 1000 1032 1042 1060 1077 1097 1136 1137 1138 1154 1159 1160 1167 1168 1170 1201 1206 1233 1277 1321 1325 1328 
4 10 11 17 44 70 98 100 116 117 129 130 131 140 206 243 254 291 316 326 346 359 389 409 438 439 445 448 461 466 490 491 514 515 523 541 543 554 561 562 567 618 621 671 683 694 741 743 755 777 785 790 794 800 825 829 849 857 862 927 946 964 976 991 993 1005 1015 1024 1028 1029 1034 1043 1046 1053 1085 1092 1095 1102 1122 1123 1176 1180 1200 1202 1211 1216 1238 1239 1252 1281 1291 1314 1333 1349 
8 12 47 72 93 96 124 187 203 211 213 217 229 262 263 317 318 319 332 345 353 378 426 435 440 441 476 478 492 502 540 550 560 563 566 605 622 632 637 739 753 754 764 783 792 798 821 855 915 980 981 987 1031 1082 1094 1114 1142 1175 1244 1245 1261 1272 1289 1322 1323 
6 7 35 41 58 66 73 74 76 80 95 101 151 154 177 215 246 307 314 329 369 382 384 386 484 545 546 547 558 585 607 663 686 689 745 756 772 813 865 866 875 883 894 895 959 1003 1044 1056 1088 1089 1106 1111 1163 1192 1214 1249 1255 1258 1327 
0 1 15 22 34 36 42 64 169 174 208 212 220 226 238 267 272 305 327 360 381 388 398 421 433 475 508 526 573 588 599 608 626 627 635 674 705 736 787 788 803 890 948 957 968 1025 1058 1081 1090 1198 1230 1294 1303 1332 
5 33 45 133 231 232 301 302 339 370 416 449 450 455 481 482 577 592 641 642 659 679 680 693 734 820 823 830 839 840 853 924 928 935 1019 1084 1098 1144 1147 1155 1161 1164 1165 1226 1227 1253 1267 1268 1288 1305 1320 1331 
9 106 145 157 165 175 176 233 244 260 266 275 279 334 348 366 397 410 414 442 501 593 609 610 612 613 630 631 633 703 713 744 746 771 816 819 863 878 911 914 940 982 1055 1109 1115 1156 1208 1254 1270 1295 1299 1343 
25 26 29 53 68 69 94 121 190 193 259 296 306 356 376 377 383 401 402 415 419 424 456 467 485 506 516 527 568 604 650 696 751 844 893 923 972 975 986 1012 1030 1038 1039 1049 1080 1125 1145 1152 1162 1178 1318 
51 186 315 385 452 479 480 493 507 509 510 534 555 586 597 727 740 799 837 838 854 860 873 881 885 956 1033 1059 1078 1146 1150 1153 1157 1186 1209 1262 1283 1284 1292 1316 1340 1341 
107 113 114 184 276 282 322 323 324 336 337 396 458 525 565 583 603 606 611 652 653 667 709 717 726 733 752 759 760 960 1069 1130 1132 1139 1204 1222 1236 1282 1329 
31 32 189 221 227 228 234 237 289 309 320 340 394 403 418 539 594 704 707 770 814 835 897 932 933 943 945 953 970 1006 1022 1023 1048 1199 1213 1271 
19 23 27 85 86 122 134 179 253 365 372 427 470 553 559 572 590 639 658 669 699 701 722 742 778 845 856 931 936 942 1004 1100 1195 1196 1300 
16 39 78 132 142 143 223 240 274 405 411 457 488 489 576 625 661 662 700 779 780 861 989 1035 1041 1072 1101 1118 1235 1264 1337 1347 
81 89 90 99 159 183 185 199 222 278 284 373 374 519 524 657 702 852 874 886 887 919 926 1017 1074 1096 1099 1131 1280 1311 1351 
3 139 144 153 201 210 219 252 269 344 443 569 591 638 869 898 1009 1010 1026 1051 1063 1075 1105 1116 1173 1183 1185 1191 1296 1297 
28 61 62 84 109 465 646 647 651 672 735 805 806 826 868 876 877 896 990 1001 1011 1134 1203 1259 1263 1286 1326 1330 1335 1336 
24 43 230 242 245 257 258 277 286 338 454 498 548 549 582 684 729 807 808 858 921 929 944 1008 1172 1215 1269 1279 1298 
59 198 241 261 270 297 298 335 413 459 494 495 533 535 810 817 842 958 973 992 1027 1224 1225 1243 1275 1313 1339 
120 138 280 375 387 620 670 677 678 720 750 776 789 828 846 847 859 888 934 967 1062 1171 1229 1346 
235 273 292 351 404 574 575 580 767 843 902 903 954 1013 1047 1076 1091 1113 1133 1232 1237 1278 1345 1350 
14 364 399 420 505 513 596 687 766 913 974 994 1020 1050 1064 1149 1158 1193 1194 1228 1240 1242 1260 
40 83 115 178 285 341 347 408 430 471 584 595 649 688 712 791 795 864 879 925 962 963 1112 
54 91 92 147 166 194 343 654 682 757 774 880 906 907 1002 1045 1065 1083 1087 1093 1110 1231 1246 
150 156 182 196 197 283 333 357 472 551 636 648 666 725 822 824 904 905 922 985 1054 1119 1120 
55 79 136 148 149 325 412 473 503 660 749 781 899 1066 1247 1266 1273 1307 1309 1334 1348 1354 
30 49 50 75 202 218 350 464 724 812 978 1040 1070 1071 1086 1129 1187 1197 1205 1248 1310 
77 87 108 161 173 180 352 431 432 532 765 784 802 909 983 1007 1061 1293 1308 1315 
38 125 214 216 288 295 368 520 738 758 833 834 937 988 1021 1052 1103 1151 1257 
164 312 313 423 469 521 522 557 690 761 762 793 938 1014 1016 1128 1285 
168 225 299 300 328 422 536 537 600 601 685 955 1057 1121 1169 1319 1338 
52 529 664 695 716 730 831 832 848 930 949 950 1067 
63 304 342 504 681 871 872 1037 1148 1182 1189 1265 1301 
126 163 290 293 294 400 463 640 697 763 971 1117 1210 
265 453 768 769 818 910 917 918 939 1179 1190 1274 1304 
60 181 271 390 417 587 614 731 747 916 941 1212 
236 371 436 447 538 675 698 984 1104 1141 1342 
2 21 444 451 578 870 901 1143 1166 1276 
67 102 103 104 251 908 1220 1221 1287 
310 311 483 500 655 706 882 965 1344 
209 247 782 900 999 1036 1188 1324 
330 331 517 518 920 1018 1184 
363 462 668 708 841 
