48 56 57 105 127 128 137 162 170 171 191 192 264 281 391 393 460 486 487 512 542 564 571 595 616 623 624 656 657 691 692 715 775 809 966 969 1107 1108 1124 1135 1177 1234 1241 1290 1302 1306 
8 9 93 187 202 203 211 217 229 248 262 317 318 319 345 378 426 435 440 441 476 492 540 560 566 622 753 754 766 783 915 981 987 996 1031 1082 1142 1289 
4 44 100 117 131 140 167 316 326 392 445 466 471 490 514 515 523 543 618 743 755 794 800 849 889 964 976 1005 1034 1053 1102 1123 1200 1333 
0 1 15 22 34 36 42 174 208 212 220 238 272 327 360 381 388 421 438 475 573 599 608 627 736 787 803 957 1332 
5 33 45 70 98 129 130 133 244 254 301 302 454 577 693 820 829 944 1238 1239 
16 132 274 405 411 457 488 489 576 625 700 779 780 861 879 1035 1041 1118 1235 1287 
7 58 67 73 74 329 484 516 545 546 667 745 865 900 908 1237 1249 
61 62 84 646 651 672 876 877 896 990 1001 1011 1203 1259 1286 1330 1335 
14 107 336 337 396 525 603 611 733 759 913 982 1236 1278 1329 
24 43 242 245 277 684 685 729 929 955 1008 1172 1215 1279 1298 
27 122 134 427 470 572 590 658 669 742 778 845 856 931 1100 
40 144 153 201 210 269 321 443 569 869 898 1051 1063 1075 1105 
10 11 206 207 395 448 694 796 797 857 947 1015 1122 1349 
18 123 146 152 158 287 358 425 462 665 708 719 867 1312 
59 198 270 297 298 335 422 533 535 817 958 973 1148 1265 
148 149 412 503 695 749 781 832 899 936 1247 1266 1273 1348 
479 493 507 555 727 873 1033 1136 1150 1153 1209 1262 1292 1316 
6 29 177 190 376 401 568 585 607 663 686 875 1106 
31 32 64 189 234 309 340 718 770 943 953 970 1213 
164 312 313 423 469 521 522 690 938 1014 1016 1128 1285 
231 232 482 641 642 734 830 924 928 1019 1084 1144 1155 
49 50 218 219 350 361 403 588 812 1040 1086 1197 
165 279 334 442 630 631 703 746 814 816 863 1055 
241 261 413 495 717 724 810 842 1027 1070 1167 1275 
299 300 328 536 537 600 601 750 1057 1156 1319 1346 
3 139 370 591 638 737 741 1026 1116 1173 1183 
91 92 343 559 654 682 774 906 907 1045 1246 
453 768 769 917 918 939 1179 1190 1274 1284 1304 
157 501 713 905 1109 1115 1254 1295 1299 1343 
20 112 200 308 511 615 811 1198 1325 
99 159 199 374 519 702 926 1074 1096 
138 444 594 670 789 881 934 967 1171 
193 377 402 456 527 621 923 1030 1049 
280 433 508 776 846 847 859 888 1229 
399 505 839 840 853 862 935 974 1228 
13 63 252 344 871 872 1037 1301 
38 738 833 834 988 1052 1151 1257 
41 76 215 369 384 756 1214 1258 
141 160 268 434 496 528 552 801 
147 166 194 880 1065 1083 1093 1110 
150 182 283 636 666 725 941 1054 
154 225 226 386 387 1003 1056 1169 
175 176 233 260 348 771 819 1208 
290 293 294 463 640 697 971 1117 
292 351 574 575 767 1113 1133 1345 
78 142 661 662 989 1101 1264 
184 239 602 709 1069 1130 1204 
221 227 228 1022 1023 1048 1199 
247 529 558 664 930 999 1036 
258 498 549 582 604 1159 1160 
276 458 760 960 1132 1222 1282 
330 331 517 518 920 1018 1184 
406 407 468 617 912 1137 1138 
509 510 677 678 739 799 828 
2 21 451 901 1143 1166 
23 85 86 942 1195 1300 
30 978 1071 1187 1205 1310 
46 135 204 325 764 1168 
81 284 852 886 887 1131 
95 125 151 772 1111 1255 
96 263 478 563 632 1114 
102 103 104 197 251 904 
108 180 352 532 784 1315 
113 114 282 322 752 1139 
115 596 868 1112 1263 1336 
119 324 650 824 1119 1120 
124 502 792 1244 1245 1261 
237 418 539 897 932 933 
267 968 1025 1090 1230 1303 
307 883 1088 1089 1327 1338 
647 805 806 1158 1276 1326 
671 704 707 825 835 1314 
673 676 723 1060 1170 1233 
679 680 1164 1165 1288 1305 
740 854 956 1059 1078 1157 
1009 1010 1185 1191 1296 1297 
1181 1207 1218 1219 1223 1328 
25 306 415 467 844 
26 459 848 1080 1163 
39 223 1067 1072 1347 
51 315 597 790 1146 
52 730 831 949 950 
54 249 644 732 1182 
60 332 417 614 747 
71 72 497 748 1175 
80 286 807 808 858 
89 90 222 278 1311 
118 645 952 977 1000 
126 163 400 763 1210 
155 547 681 711 1189 
173 802 983 1104 1342 
185 255 524 1152 1351 
195 224 305 354 815 
236 371 436 698 1141 
259 356 751 893 1038 
285 341 408 649 1272 
310 311 483 655 882 
339 416 481 823 1147 
349 827 998 1154 1321 
357 550 551 648 855 
364 420 513 1149 1240 
382 409 561 562 991 
404 843 1013 1232 1350 
554 773 927 1042 1176 
586 587 837 838 1283 
765 1007 1061 1307 1308 
17 389 850 1291 
19 179 553 722 
35 660 922 1354 
47 798 980 1094 
68 485 1039 1145 
87 161 909 1231 
106 145 914 1270 
110 362 474 531 
111 250 598 995 
156 196 951 992 
181 271 534 1186 
205 689 866 1201 
240 273 903 954 
246 813 1029 1281 
266 414 878 940 
275 609 610 1021 
288 368 520 1024 
333 472 822 985 
363 668 841 959 
366 744 836 986 
390 731 916 1212 
429 430 961 1064 
464 477 1129 1248 
567 777 785 1211 
593 612 613 911 
643 721 728 1206 
712 791 925 972 
12 304 821 
28 465 735 
53 696 975 
55 79 1066 
75 619 786 
82 1076 1077 
94 394 1079 
97 410 1028 
101 314 1044 
109 826 1134 
120 375 1062 
136 473 557 
169 1058 1294 
183 373 659 
186 385 860 
188 437 1068 
257 338 548 
265 818 910 
289 397 945 
291 1032 1043 
296 383 1178 
303 355 367 
320 526 1271 
323 583 653 
347 584 688 
446 891 892 
449 450 1320 
461 683 1216 
530 556 1317 
565 1050 1242 
606 652 726 
628 629 720 
639 699 1004 
674 788 1196 
687 994 1020 
757 1002 1087 
761 762 793 
795 864 962 
874 919 1017 
884 885 1277 
894 895 1006 
902 1047 1091 
946 1092 1252 
1046 1085 1202 
1193 1194 1260 
1224 1225 1243 
