1 12 13 22 23 32 34 36 40 42 43 53 55 63 66 69 86 87 93 94 111 119 130 148 149 165 174 189 195 208 212 219 220 234 235 239 245 250 255 257 258 259 269 272 277 278 296 303 305 306 308 309 320 322 325 327 339 340 349 350 352 353 355 360 361 362 366 374 381 388 392 403 406 414 421 433 457 467 468 475 502 503 508 513 515 516 526 570 573 588 591 594 599 600 606 608 619 626 627 645 649 650 724 765 770 792 817 845 867 872 875 877 891 908 909 936 937 953 979 997 1012 1023 1037 1058 1106 1147 1162 1187 1213 1217 1238 1239 1260 1266 1273 1282 1315 1332 1348 
20 30 33 70 82 88 97 124 135 155 158 172 180 204 207 256 263 268 271 288 291 294 301 334 354 356 394 395 415 429 598 615 628 636 687 693 711 722 737 804 889 922 998 1073 1094 1103 1114 1154 1167 1189 1206 1210 1325 
44 100 178 182 185 186 209 265 282 317 373 391 445 543 589 618 665 666 674 768 782 784 790 793 822 916 933 948 954 964 970 988 1034 1053 1054 1066 1076 1091 1123 1141 1196 1199 1200 1205 1243 1271 
48 56 118 140 167 191 206 233 393 418 447 460 485 499 500 542 624 648 656 714 715 726 742 803 809 920 946 947 969 996 1039 1079 1124 1135 1177 1223 1234 1270 1290 1302 1306 
57 128 137 171 248 264 318 420 426 437 476 478 486 530 540 564 566 602 616 623 691 692 710 764 866 915 987 1046 1107 1142 1194 1241 1289 1310 
98 101 215 252 310 311 345 423 435 438 439 459 494 552 558 590 639 654 655 658 699 744 756 778 802 813 1028 1036 
7 126 129 138 336 390 396 397 474 556 561 578 581 582 707 728 748 759 820 945 951 980 1159 1328 1329 
45 120 378 446 496 528 622 708 746 747 752 763 773 815 816 892 1160 1173 1193 1244 1245 1261 
31 46 141 238 275 409 410 425 428 434 527 534 539 545 634 653 672 718 785 899 1096 
84 85 153 201 210 412 473 506 531 702 942 956 1052 1063 1075 1321 
24 427 452 480 517 671 704 779 781 856 929 1215 1307 1308 
83 132 307 375 400 520 601 652 835 906 907 957 1044 1045 
106 176 188 224 260 313 348 419 512 771 974 1068 1208 1275 
139 164 469 470 511 521 690 972 1014 1026 1027 1049 1055 1116 
154 225 386 695 716 730 831 832 950 1003 1015 1056 1057 1228 
0 37 104 293 323 338 367 498 548 549 583 609 978 
14 15 267 565 913 968 1004 1025 1050 1090 1230 1242 1303 
18 405 713 788 919 1018 1062 1098 1115 1237 1254 1278 1295 
107 108 187 203 298 389 550 611 733 754 860 981 1236 
152 295 358 359 462 523 757 794 910 1181 1218 1219 1312 
198 270 297 335 533 535 536 871 958 973 1148 1265 1301 
369 509 510 739 740 750 799 828 1078 1157 1299 1343 1346 
524 660 675 774 849 961 1166 1216 1229 1232 1350 1351 1354 
5 81 284 285 347 488 489 593 595 688 1118 1131 
47 147 166 471 798 808 879 880 1065 1082 1083 1093 
254 482 483 641 642 829 830 924 928 1084 1105 1144 
6 29 76 190 376 401 585 607 686 927 1043 
61 62 646 874 876 990 1001 1011 1100 1318 1330 
290 330 331 518 605 731 755 975 1000 1005 1212 
79 430 443 574 580 673 890 1060 1072 1110 
240 273 299 328 537 729 903 1016 1258 1319 
8 27 60 163 289 316 332 417 572 
103 197 541 705 706 882 982 1031 1344 
105 116 398 466 490 775 1070 1071 1333 
113 114 202 292 324 464 477 525 1129 
211 216 217 229 253 283 441 560 753 
276 493 661 662 836 918 986 989 1101 
329 484 667 865 900 983 1188 1249 1324 
769 777 862 873 976 1136 1153 1190 1316 
3 382 384 385 749 843 1088 1089 
4 133 244 302 453 454 944 1195 
52 221 227 442 758 814 992 1048 
68 640 670 893 971 1022 1133 1214 
96 231 232 507 633 638 1209 1224 
357 555 579 632 725 1020 1184 1256 
387 620 717 776 846 847 1097 1192 
647 805 806 1134 1158 1276 1326 1336 
679 680 1155 1164 1165 1288 1305 1331 
65 379 505 732 881 923 934 
73 266 404 651 800 896 1077 
183 184 337 709 1069 1130 1204 
343 344 481 538 577 751 760 
479 734 839 840 917 1019 1304 
629 801 807 869 898 1038 1202 
9 21 279 901 1143 1183 
25 91 121 213 214 610 
59 280 504 575 635 1081 
142 223 1067 1108 1264 1347 
319 365 659 766 783 1161 
371 698 1104 1122 1342 1349 
529 664 780 930 1033 1035 
884 885 952 977 999 1277 
1009 1010 1185 1191 1296 1297 
11 694 767 1145 1345 
16 78 274 326 1235 
50 261 413 842 1314 
64 532 631 943 1247 
89 90 222 1140 1311 
102 168 251 723 1059 
109 487 826 1259 1335 
115 868 1112 1246 1263 
125 151 949 1109 1255 
146 287 682 786 787 
160 161 402 897 1030 
192 411 568 864 883 
218 669 995 1102 1125 
241 492 854 1013 1152 
249 681 811 812 857 
300 962 963 1047 1269 
436 841 894 895 1006 
449 450 1226 1227 1320 
567 824 912 1119 1120 
612 613 630 911 1171 
684 685 955 1279 1298 
833 834 1150 1151 1257 
10 127 461 683 
26 67 859 1317 
28 71 465 735 
38 145 738 1280 
41 522 904 1021 
54 644 848 1182 
74 123 727 1002 
95 122 703 745 
112 169 226 1169 
136 193 1074 1156 
156 157 878 1128 
162 700 719 720 
177 424 668 959 
196 554 1042 1178 
205 1201 1327 1338 
246 383 1029 1281 
281 444 870 914 
304 736 821 1272 
351 621 902 1240 
370 380 676 984 
372 551 855 965 
399 1017 1064 1172 
407 617 861 1294 
455 456 741 1040 
458 557 584 1007 
472 547 939 1179 
495 697 1117 1253 
519 852 886 887 
712 791 823 925 
796 797 850 851 
853 935 1262 1292 
2 514 819 
17 243 1291 
19 179 562 
35 314 689 
49 603 762 
51 1087 1146 
58 200 1139 
72 497 1175 
92 559 1099 
117 553 931 
134 1198 1231 
159 262 926 
170 363 364 
194 657 827 
228 247 967 
230 921 1168 
237 818 932 
242 544 1211 
333 985 991 
342 576 772 
408 701 905 
416 696 721 
422 586 587 
431 432 1233 
440 604 1085 
448 795 858 
463 940 994 
571 596 597 
789 941 1300 
837 838 1283 
966 993 1111 
1008 1032 1252 
1138 1222 1248 
1220 1221 1287 
