0 11 23 30 31 37 39 40 42 51 59 61 64 84 85 86 88 102 189 198 199 212 223 234 235 270 280 285 297 298 309 315 335 339 340 341 347 360 368 376 387 408 412 433 457 464 471 507 508 509 533 535 544 555 573 584 586 597 607 608 620 626 634 635 649 672 677 678 688 694 705 724 740 741 767 770 776 795 803 817 827 828 832 837 838 846 847 853 854 859 861 864 876 877 888 890 942 943 948 953 956 959 962 970 973 978 994 998 1011 1020 1024 1059 1071 1072 1078 1097 1100 1129 1148 1150 1154 1157 1187 1193 1194 1195 1205 1213 1229 1248 1259 1260 1283 1310 1321 1345 1347 
13 20 22 47 54 65 72 75 78 82 93 95 96 110 111 112 124 132 142 143 155 195 200 204 205 213 224 237 248 250 255 256 275 303 305 308 317 318 321 327 349 353 354 355 361 362 367 375 378 379 380 388 392 398 424 428 474 488 489 502 506 511 531 547 566 580 583 589 598 605 609 610 619 625 637 643 661 662 676 702 706 721 722 728 732 739 773 786 792 798 811 835 855 866 915 919 980 987 989 995 996 1002 1031 1046 1077 1081 1082 1094 1101 1115 1136 1146 1163 1188 1201 1206 1244 1245 1254 1261 1264 1278 1289 1300 1322 1323 1325 1337 1343 
2 18 21 25 66 68 69 97 121 123 152 165 172 174 177 190 193 221 244 259 266 269 272 279 296 306 323 334 356 366 377 383 402 407 409 410 414 415 419 442 443 451 456 467 470 485 516 527 576 578 585 630 631 650 663 665 686 703 744 746 747 751 815 816 836 844 850 851 863 867 868 870 875 878 893 901 921 923 925 940 972 986 1028 1030 1032 1038 1039 1049 1055 1073 1075 1106 1112 1143 1145 1178 1181 1192 1207 1218 1219 1223 1263 1328 1336 
4 10 44 46 116 117 118 119 131 135 140 167 206 207 214 216 249 253 265 291 295 316 325 346 365 372 389 394 395 416 429 430 431 432 438 439 445 447 448 461 466 490 514 515 541 543 570 615 618 639 645 683 689 699 701 714 743 755 758 764 790 797 800 804 818 849 889 894 895 937 946 947 951 952 961 976 977 984 997 1005 1015 1034 1041 1042 1043 1053 1064 1079 1091 1092 1095 1102 1103 1104 1123 1140 1147 1180 1196 1200 1203 1216 1252 1333 1342 
16 32 49 50 103 104 109 150 156 157 186 196 197 218 219 240 251 274 292 350 351 357 385 397 404 411 444 450 452 472 479 493 494 499 523 529 546 550 551 574 575 581 588 593 594 612 613 633 636 646 648 651 664 695 700 710 713 727 779 780 789 810 812 826 843 860 873 879 881 904 905 911 930 967 982 1000 1012 1013 1021 1033 1035 1040 1076 1086 1109 1113 1118 1125 1133 1134 1162 1175 1197 1209 1232 1235 1237 1262 1292 1295 1299 1316 1350 
48 56 57 71 87 105 127 128 137 141 160 161 162 170 171 188 191 192 239 243 264 268 281 320 391 393 434 437 446 454 460 477 478 486 487 496 501 512 526 528 530 542 552 556 564 567 571 595 602 616 623 624 656 673 691 692 715 718 723 748 775 777 785 801 809 891 892 898 909 944 958 966 969 979 1060 1068 1069 1107 1108 1124 1135 1170 1177 1217 1231 1233 1234 1241 1271 1290 1302 1306 1317 
8 9 14 28 62 125 138 187 203 211 229 262 319 359 364 399 406 420 435 440 441 449 455 465 468 481 491 492 505 513 540 560 592 596 617 622 628 629 647 670 720 735 753 754 766 783 805 806 823 839 840 862 896 912 913 934 935 974 981 990 993 1001 1004 1050 1098 1137 1138 1149 1158 1161 1226 1227 1228 1240 1253 1267 1268 1276 1285 1286 1320 1326 1330 1331 1335 
1 15 34 36 63 83 120 154 178 201 220 225 238 267 273 299 300 304 328 342 344 386 401 421 422 425 504 536 537 600 601 627 652 674 681 711 719 726 736 750 787 788 791 842 869 871 872 902 903 954 955 957 964 968 1003 1025 1027 1037 1044 1047 1056 1057 1062 1090 1153 1156 1160 1166 1169 1171 1189 1230 1236 1258 1265 1301 1303 1319 1327 1332 1338 1340 1341 1346 
3 12 19 27 94 107 113 114 122 134 139 179 184 263 276 282 322 336 337 345 370 396 426 427 458 525 553 559 563 565 572 590 591 603 606 611 638 644 653 658 667 669 709 712 733 737 742 752 759 760 778 821 845 856 931 936 960 1009 1010 1026 1070 1116 1130 1132 1139 1142 1173 1183 1185 1191 1198 1204 1222 1242 1272 1282 1296 1297 1329 1344 
17 26 52 53 60 81 89 90 98 100 169 181 182 185 222 226 241 261 271 278 284 310 311 332 333 390 413 417 459 469 483 495 497 500 524 562 587 614 655 657 660 696 716 717 730 731 822 831 848 852 874 882 886 887 916 941 949 950 965 975 985 992 1017 1058 1067 1080 1131 1167 1212 1224 1225 1243 1275 1291 1294 1313 1318 1339 1351 1354 
6 29 35 76 101 115 151 153 159 209 215 217 231 232 246 247 252 283 307 314 369 382 384 480 482 534 554 558 561 568 621 632 641 642 666 679 680 734 756 782 813 830 883 884 885 922 924 927 928 991 999 1014 1019 1029 1036 1051 1054 1084 1085 1088 1089 1111 1114 1144 1152 1155 1164 1165 1176 1182 1202 1211 1255 1277 1281 1288 1304 1305 
5 33 45 70 77 108 126 129 130 133 163 180 194 227 228 254 288 289 290 293 294 301 302 352 400 403 418 463 532 539 577 640 687 693 697 704 707 763 765 784 814 820 897 932 933 945 971 1006 1007 1022 1023 1048 1061 1093 1117 1199 1210 1238 1239 1293 1308 1312 1315 
7 55 58 73 74 79 99 136 148 149 183 208 326 329 373 374 381 453 473 475 484 503 510 519 545 557 599 659 745 749 768 769 781 794 799 865 899 900 910 917 918 926 939 1066 1074 1096 1179 1186 1190 1247 1249 1266 1273 1274 1284 1307 1309 1324 1334 1348 
67 91 92 147 164 166 168 202 236 312 313 324 343 371 423 436 520 521 522 538 654 675 682 685 690 698 738 761 762 772 774 793 829 833 834 857 880 906 907 908 938 1016 1045 1065 1083 1110 1121 1122 1128 1141 1151 1220 1221 1246 1257 1287 1311 1349 
24 43 80 230 242 245 257 258 277 286 338 476 498 548 549 582 604 671 684 729 807 808 825 858 929 963 1008 1159 1172 1215 1269 1279 1298 1314 
38 106 144 145 175 176 210 233 260 330 331 348 405 517 518 569 771 819 914 920 988 1018 1052 1063 1099 1105 1184 1208 1270 1280 
41 146 158 173 287 358 363 462 579 668 708 725 757 796 802 824 841 983 1087 1119 1120 1168 1214 1256 
