0 1 15 22 34 36 37 40 59 83 84 136 142 143 148 149 178 201 208 212 220 238 272 285 304 305 327 339 341 342 347 360 368 376 377 381 382 387 388 408 421 430 433 467 470 471 473 475 503 507 508 509 510 535 544 555 557 573 584 593 599 608 612 627 649 652 672 677 678 688 725 736 740 749 765 770 776 781 787 791 799 803 828 832 846 853 854 869 876 877 899 911 953 956 972 1007 1011 1030 1044 1049 1059 1061 1078 1089 1148 1157 1198 1203 1229 1236 1247 1264 1266 1273 1307 1308 1309 1332 1334 1337 1348 
3 14 16 28 62 103 104 107 113 114 139 144 150 184 193 196 197 209 210 247 251 269 281 282 283 298 322 323 326 336 337 357 370 396 405 411 443 458 465 472 523 525 529 551 565 569 583 591 603 611 615 636 638 648 653 664 666 667 695 700 712 717 733 735 737 752 759 760 779 780 782 794 855 896 904 905 914 930 960 990 999 1001 1009 1010 1021 1026 1033 1035 1046 1050 1052 1054 1063 1075 1103 1105 1116 1118 1132 1139 1173 1175 1183 1185 1191 1210 1222 1242 1262 1278 1282 1286 1292 1296 1297 1329 1330 1344 
4 10 11 44 94 115 116 118 119 131 140 155 167 206 207 216 249 291 295 346 365 392 394 395 416 429 432 438 445 447 448 461 466 490 514 515 541 543 547 570 596 607 618 626 643 644 645 650 659 683 689 694 699 701 714 722 728 732 741 743 755 758 773 790 796 797 800 802 804 824 849 857 889 937 946 947 948 951 952 961 976 977 983 984 997 1004 1005 1015 1032 1034 1041 1042 1043 1053 1064 1079 1088 1091 1092 1095 1102 1104 1119 1120 1122 1123 1140 1147 1163 1180 1200 1206 1216 1252 1259 1333 1342 1349 
39 48 51 56 57 105 109 127 128 137 141 162 170 171 191 192 223 252 264 268 315 366 391 393 409 434 446 460 477 486 487 496 501 504 512 528 530 534 542 556 561 562 564 567 571 595 597 616 623 624 656 691 692 715 775 777 785 801 809 826 898 966 969 991 1072 1085 1107 1108 1109 1124 1135 1177 1186 1202 1211 1233 1234 1241 1290 1302 1306 1317 1347 
8 9 102 187 203 211 217 229 262 267 276 319 332 345 359 364 399 420 435 440 441 455 492 505 513 550 558 560 592 622 646 647 753 754 766 783 805 806 823 839 840 862 913 935 968 974 981 993 994 1020 1025 1090 1098 1134 1149 1158 1161 1193 1194 1230 1237 1240 1253 1260 1267 1268 1276 1303 1326 1331 1335 1336 
45 47 70 71 72 88 93 135 146 158 198 213 237 248 254 287 297 318 325 335 378 389 424 431 491 506 533 540 566 579 602 605 707 739 748 764 798 814 817 892 915 934 959 973 979 980 987 996 1031 1082 1094 1115 1168 1170 1217 1226 1254 1256 1285 1289 1300 1312 1343 
26 53 60 89 90 98 100 163 181 182 185 222 240 241 261 271 274 278 290 296 316 333 383 390 413 417 459 469 495 497 524 614 620 660 696 731 822 842 879 916 941 975 985 986 1000 1027 1080 1178 1212 1224 1225 1235 1243 1311 1318 1351 1354 
2 69 91 165 175 176 214 233 260 266 317 334 343 348 414 419 428 442 494 576 594 630 631 654 682 703 746 771 774 816 819 850 851 863 868 878 891 906 907 921 940 967 1012 1045 1055 1073 1112 1113 1125 1133 1162 1208 1246 1263 
19 23 24 27 43 61 85 86 117 122 134 179 242 245 253 277 372 426 427 452 553 572 590 639 658 669 671 684 704 729 742 744 778 825 835 845 856 929 931 936 942 1008 1100 1142 1172 1195 1215 1279 1298 
32 49 154 273 324 350 351 386 397 404 464 479 493 546 581 588 613 651 710 713 723 727 812 843 873 881 902 903 954 1003 1013 1040 1047 1056 1129 1136 1153 1197 1209 1232 1248 1258 1295 1299 1316 1340 1341 1350 
13 20 54 65 66 75 96 111 124 195 200 204 205 250 255 256 308 321 349 361 488 489 502 511 589 619 786 792 811 847 866 888 995 1002 1097 1146 1188 1192 1201 1244 1245 1261 1325 
6 35 41 76 95 101 125 151 153 215 246 307 314 369 384 439 478 480 621 632 635 730 756 757 813 831 883 922 925 950 1029 1036 1051 1087 1111 1114 1182 1214 1228 1265 1281 
18 25 68 121 123 152 160 172 174 177 180 190 221 306 402 407 415 456 485 516 527 585 586 663 665 686 747 815 836 837 838 844 867 875 923 1039 1106 1145 1283 
30 126 173 289 293 294 330 331 358 400 463 517 518 640 697 724 726 820 920 971 978 1018 1022 1070 1071 1117 1184 1187 1205 1310 
5 21 33 97 129 133 244 265 279 301 302 410 451 453 454 577 578 687 693 818 870 901 910 944 1028 1143 
225 299 300 328 425 449 450 536 537 600 601 719 750 962 963 1057 1086 1156 1169 1227 1255 1269 1319 1320 1346 
7 58 73 74 99 183 199 270 329 373 374 484 519 545 702 745 865 900 926 1074 1096 1249 1324 
231 232 444 482 641 642 679 680 734 810 830 924 928 1019 1084 1144 1155 1164 1165 1288 1304 1305 
55 79 310 362 403 539 768 769 897 917 918 932 933 939 945 1066 1179 1190 1213 1274 1284 
67 147 164 166 194 423 520 761 762 793 880 908 957 1065 1083 1093 1110 1220 1221 1231 1287 
80 230 286 476 498 549 582 604 795 807 808 827 858 864 998 1024 1154 1159 1160 1167 1321 
31 42 46 64 189 218 219 234 309 320 340 457 526 634 718 861 943 970 1271 
38 106 145 227 228 288 418 894 895 988 992 1006 1023 1048 1199 1270 1275 1313 1339 
188 239 353 437 552 637 709 767 884 885 958 1068 1069 1130 1204 1277 1322 1323 1345 
29 159 312 313 521 522 554 568 673 690 789 927 938 1014 1016 1128 1152 1176 
110 132 186 224 354 375 379 380 385 474 481 531 598 625 676 706 721 860 
50 235 292 406 412 468 574 575 580 617 705 890 912 1060 1137 1138 1314 
81 284 483 500 655 657 852 874 882 886 887 919 965 1017 1131 1280 
236 371 436 538 675 698 738 772 833 834 1141 1150 1151 1257 
12 130 156 157 263 563 606 821 982 1238 1239 1272 
17 120 243 257 258 280 338 548 859 1062 1171 1291 
78 275 303 355 367 609 610 661 662 989 1101 
259 356 751 893 1038 1181 1207 1218 1219 1223 1328 
77 87 108 161 352 532 784 909 1293 1315 
52 112 169 226 311 716 848 949 1067 
63 344 681 871 872 1037 1166 1189 1301 
82 92 398 559 1076 1077 1081 1099 
138 499 628 629 633 670 711 720 
168 202 685 829 1058 1121 1294 
363 462 668 708 763 841 
401 674 788 964 1196 
422 587 955 1327 1338 
