6 7 16 24 25 34 35 40 41 58 67 73 74 76 80 81 84 85 113 123 132 142 143 147 148 150 157 164 165 168 169 177 178 190 227 291 292 314 315 328 329 346 351 366 382 384 401 402 406 408 412 414 422 424 464 466 484 488 509 515 516 519 524 531 535 545 546 547 555 567 568 574 575 576 580 584 585 586 593 607 612 613 629 630 631 645 657 663 667 668 675 686 689 700 738 739 740 741 745 758 772 775 779 780 784 788 791 792 793 807 814 816 832 833 834 836 837 838 843 844 846 854 865 874 875 878 883 884 885 886 900 902 911 948 954 955 956 961 967 977 986 988 994 1006 1011 1012 1013 1024 1032 1041 1054 1058 1059 1076 1077 1078 1080 1085 1089 1091 1094 1098 1100 1102 1109 1111 1113 1117 1118 1124 1125 1131 1149 1150 1151 1152 1157 1162 1166 1171 1175 1179 1188 1193 1197 1202 1220 1221 1232 1236 1237 1240 1244 1245 1252 1257 1260 1261 1271 1273 1277 1283 1287 1294 1295 1318 1324 1327 1332 1333 1337 1338 1343 1350 1351 
0 1 12 13 22 23 32 36 37 42 43 44 48 53 54 55 59 63 64 65 66 75 79 83 86 87 88 93 94 95 96 108 111 112 149 155 174 189 195 200 204 205 208 212 218 219 220 234 235 242 245 250 255 256 257 259 269 272 277 278 285 296 303 304 305 306 307 308 309 321 322 327 339 340 341 349 353 355 360 361 374 375 379 381 388 398 403 407 415 416 421 443 457 467 468 473 475 489 490 502 503 504 508 526 563 573 578 579 588 594 599 608 625 626 627 656 681 688 724 728 736 751 770 786 790 798 803 812 866 867 873 877 890 899 926 936 942 952 953 980 993 997 1002 1029 1061 1070 1071 1095 1106 1114 1122 1137 1138 1146 1147 1159 1160 1167 1168 1180 1187 1213 1234 1247 1248 1270 1272 1306 1310 1315 1325 1349 
4 5 11 26 27 30 33 45 46 68 82 91 92 97 98 107 118 119 121 122 133 134 140 141 152 161 166 167 179 180 193 194 207 213 214 222 232 243 244 253 254 271 279 284 289 290 301 302 323 324 343 376 391 392 395 397 400 413 423 426 427 436 447 448 451 452 453 454 458 470 474 481 485 494 498 499 500 511 520 556 570 572 577 581 589 590 598 610 615 619 628 637 639 652 655 658 669 687 693 704 712 713 714 726 744 773 778 795 797 800 802 804 818 821 827 835 845 856 889 910 925 931 932 944 946 947 951 957 972 985 1007 1030 1040 1042 1044 1045 1049 1072 1079 1115 1136 1212 1218 1219 1231 1254 1276 1299 1312 1320 1322 1323 1344 1348 
10 31 47 56 57 69 70 71 72 99 100 103 104 120 125 126 131 135 156 158 159 160 172 173 196 197 231 236 237 238 239 248 251 268 275 288 294 295 352 358 359 377 378 394 409 410 425 428 429 430 434 446 455 456 461 462 471 472 495 496 497 501 523 527 528 534 539 541 552 595 605 648 653 665 670 672 676 703 706 718 727 742 746 747 748 752 757 767 785 794 801 815 825 840 841 850 851 861 863 892 897 904 905 922 923 927 933 941 943 969 976 979 982 991 996 1008 1020 1021 1031 1060 1064 1073 1088 1096 1103 1133 1141 1173 1177 1194 1195 1206 1210 1214 1223 1233 1243 1253 1267 1268 1289 1291 1300 1328 1345 
17 28 29 38 39 49 50 60 89 90 117 138 139 181 182 185 186 312 313 316 317 370 371 372 373 404 405 444 445 465 469 479 521 522 532 554 587 617 618 633 636 659 660 666 671 683 690 699 720 737 755 760 761 764 768 782 789 810 822 849 881 919 920 937 939 960 964 965 983 984 1000 1005 1009 1010 1014 1016 1017 1018 1019 1034 1055 1062 1066 1074 1092 1099 1104 1110 1128 1132 1140 1161 1163 1165 1176 1181 1184 1185 1191 1199 1205 1207 1216 1217 1222 1224 1225 1229 1256 1278 1279 1280 1282 1288 1293 1296 1297 1311 1314 1342 1354 
8 9 20 101 102 124 146 187 188 202 203 211 216 217 221 229 230 246 247 252 262 263 276 280 319 320 331 332 333 334 345 354 357 365 399 431 435 440 441 476 491 492 505 550 551 558 560 561 592 622 632 635 698 733 735 753 754 756 766 783 823 852 860 862 870 888 898 934 935 975 981 987 995 1036 1038 1067 1087 1097 1121 1129 1192 1211 1281 
2 3 21 105 106 109 110 127 128 136 137 170 171 176 191 192 223 224 233 260 261 264 265 347 348 393 419 420 437 460 477 478 486 487 512 542 564 571 597 616 623 624 634 691 692 710 715 721 771 809 819 901 915 974 1068 1083 1107 1108 1112 1135 1139 1142 1143 1183 1208 1241 1275 1290 1302 1313 1339 1347 
14 15 61 62 115 116 183 184 266 267 326 337 396 480 513 596 611 620 621 646 647 649 651 709 716 717 730 743 759 805 806 826 831 868 876 896 906 907 913 949 950 963 968 990 1004 1015 1025 1047 1069 1090 1130 1134 1153 1158 1204 1228 1230 1242 1246 1259 1263 1266 1303 1309 1326 1330 1334 1335 1336 1340 1341 
18 19 153 154 225 226 299 300 368 369 386 387 482 483 506 510 536 537 553 559 566 600 601 641 642 677 678 684 685 702 729 734 749 750 765 776 777 781 787 799 817 828 829 830 871 872 903 924 928 998 1003 1037 1056 1057 1084 1144 1148 1154 1169 1172 1215 1258 1264 1265 1298 1301 1307 1308 1319 1321 1346 
151 206 215 249 286 287 310 311 318 325 342 362 363 380 438 439 459 514 540 562 643 644 654 682 711 732 811 842 848 855 857 858 882 894 908 966 1026 1027 1028 1145 1170 1182 1189 1198 1209 1226 1227 1249 1285 1304 
78 336 364 411 493 614 661 662 679 680 731 769 774 808 847 864 879 880 887 917 918 962 970 989 1065 1082 1101 1155 1164 1190 1235 1274 1284 1305 1316 1329 1331 
51 52 228 258 293 338 350 356 367 383 442 463 548 549 557 582 583 604 609 640 696 697 869 893 895 940 971 978 992 1022 1023 1039 1048 1178 1269 
77 129 130 144 145 175 201 209 210 281 282 330 344 507 517 518 565 569 591 606 638 891 914 1001 1046 1050 1051 1052 1063 1075 1105 1203 1238 1239 1286 
162 163 389 390 417 418 538 650 707 708 725 763 796 820 824 912 945 1093 1119 1120 1186 1201 
283 433 525 529 530 602 603 664 694 695 762 839 853 859 930 999 1033 1035 1081 1262 1292 1317 
432 449 450 673 674 701 705 719 722 723 921 938 1043 1086 1116 1156 1196 1255 
198 199 270 297 298 335 533 958 959 973 
240 241 273 274 385 929 
543 544 916 1053 1123 1200 
114 813 909 
1126 1127 1174 
