48 56 57 105 127 128 137 162 170 171 191 264 281 366 391 393 407 460 486 487 504 512 542 564 571 595 616 623 624 656 692 715 775 809 867 898 966 969 1107 1108 1124 1135 1177 1234 1241 1290 1302 1306 
0 1 15 22 34 36 42 64 208 212 220 238 360 381 388 421 438 526 573 599 608 627 736 787 803 957 1198 1236 1332 
4 44 131 140 445 466 490 514 515 543 618 689 743 755 790 800 849 894 895 976 1034 1053 1102 1123 1200 1333 
13 20 54 95 96 112 195 200 204 205 224 250 255 305 308 354 428 502 511 619 786 811 1146 1201 1325 1327 
8 72 93 202 213 248 263 317 318 319 378 435 558 566 739 766 855 915 987 996 1031 1082 1289 1299 1300 
27 61 122 134 345 426 427 572 590 658 669 735 742 778 845 856 931 1100 1142 
165 266 279 334 414 442 630 631 703 746 816 863 878 921 940 1055 1112 
14 107 187 336 337 396 525 565 603 611 667 712 733 759 913 1329 
49 50 218 350 588 812 873 881 1033 1040 1086 1153 1197 1292 1316 
126 163 180 290 293 294 463 640 691 697 763 971 1093 1117 1210 
217 231 232 482 641 642 734 830 924 928 1019 1084 1144 1155 1304 
193 377 402 456 470 516 527 621 832 923 925 972 1030 1049 
299 300 328 450 536 537 600 601 750 1057 1156 1169 1319 1346 
24 43 242 245 277 684 729 929 1008 1172 1215 1298 
81 185 284 524 657 852 874 886 919 1017 1131 1351 
132 457 488 489 576 625 779 780 861 1035 1041 1118 
141 160 243 268 434 454 496 528 552 718 801 944 
148 149 412 475 503 781 899 936 1247 1266 1273 1348 
164 166 312 313 400 423 521 522 690 938 1016 1128 
203 211 262 440 441 492 560 622 753 754 783 981 
241 261 413 495 717 724 810 842 1027 1070 1167 1275 
364 399 420 513 647 974 1050 1149 1240 1276 1326 1335 
6 35 177 246 585 660 663 686 875 1106 1354 
368 387 424 506 520 620 776 846 847 888 1229 
91 92 324 343 654 682 906 907 1045 1246 
7 58 73 74 329 484 545 745 865 
63 252 344 871 872 979 1037 1217 1301 
115 276 458 760 960 1132 1222 1259 1282 
206 207 249 395 448 644 797 947 1015 
214 295 370 431 699 758 764 937 1004 
258 361 498 549 582 604 963 1269 1279 
259 272 356 383 415 650 751 893 1038 
26 45 133 158 497 579 820 1256 
70 129 130 194 254 1238 1239 1312 
84 507 555 672 876 877 1011 1150 
175 176 233 260 348 771 819 1208 
198 199 270 297 335 533 959 973 
292 574 575 767 1012 1113 1133 1345 
679 680 1164 1165 1253 1288 1305 1331 
2 3 591 638 737 1173 1183 
18 123 152 174 221 665 836 
30 436 978 1071 1187 1205 1310 
31 32 234 309 634 953 970 
40 347 376 430 471 584 688 
78 142 610 661 662 989 1101 
99 374 519 702 926 1074 1096 
102 740 854 956 1059 1078 1157 
109 501 546 713 826 1109 1295 
119 167 541 570 615 951 1042 
138 139 670 789 934 1026 1116 
150 156 196 636 666 905 1054 
173 288 397 802 983 1104 1342 
247 529 664 695 930 999 1036 
310 311 483 562 655 882 887 
330 331 517 518 920 1018 1184 
351 404 651 843 1013 1232 1350 
382 409 561 991 1029 1211 1281 
453 768 769 939 1190 1274 1284 
646 805 806 868 1134 1263 1336 
673 676 706 723 1060 1170 1233 
5 33 301 302 577 693 
23 85 86 744 942 1195 
39 223 683 1072 1216 1347 
52 716 730 831 949 950 
59 298 535 817 853 1148 
60 100 332 417 459 614 
71 446 605 748 891 892 
108 352 432 532 784 1315 
113 114 282 322 752 1139 
144 210 569 914 1063 1105 
146 230 287 858 1168 1249 
147 774 880 1065 1083 1110 
192 411 700 782 1221 1287 
227 228 1006 1023 1048 1199 
237 418 539 897 932 933 
267 968 1025 1090 1230 1303 
273 902 903 954 1047 1091 
365 596 659 701 1196 1242 
406 468 617 912 1137 1138 
738 772 833 834 1151 1257 
765 866 1007 1061 1307 1308 
1009 1010 1185 1191 1296 1297 
1181 1207 1218 1219 1223 1328 
19 179 553 559 722 
25 172 306 467 844 
28 62 465 1001 1330 
47 327 798 980 1094 
68 485 815 1039 1145 
75 464 477 1129 1248 
88 280 491 859 1097 
89 90 222 278 1311 
101 314 480 813 1044 
103 104 197 472 904 
111 256 349 598 995 
116 291 346 1043 1203 
118 645 952 977 1000 
120 375 1062 1166 1171 
124 792 1244 1245 1261 
154 225 386 1056 1258 
285 341 408 649 1272 
315 586 837 838 1283 
321 1002 1159 1160 1188 
390 587 731 916 1212 
422 685 829 955 1338 
509 510 677 678 828 
643 728 773 1136 1206 
827 998 1024 1154 1321 
11 607 694 741 
12 563 606 821 
16 405 523 1175 
21 451 901 1143 
41 215 756 1214 
65 379 589 732 
76 153 307 1051 
87 161 909 1231 
117 253 372 1005 
169 226 848 1067 
182 333 822 985 
189 340 770 943 
219 269 443 1075 
235 580 583 1278 
236 371 698 1141 
239 602 958 1069 
240 274 879 1235 
357 550 551 648 
369 384 1003 1265 
416 481 823 1147 
433 508 705 890 
444 531 594 967 
567 777 785 1152 
796 824 1119 1120 
839 840 862 935 
850 851 1073 1291 
992 1224 1225 1243 
17 469 941 
37 339 544 
38 988 1052 
46 135 325 
53 696 975 
55 79 1066 
82 835 1077 
83 178 791 
94 394 1079 
97 1028 1032 
98 986 1080 
106 145 1270 
110 362 474 
136 473 557 
151 1111 1255 
159 554 927 
186 385 860 
188 437 1068 
209 900 1324 
229 283 922 
257 338 548 
265 818 910 
275 609 1021 
286 807 808 
303 355 367 
304 342 652 
363 668 841 
398 1081 1262 
403 945 1213 
429 961 1064 
449 1227 1320 
452 534 1186 
462 708 725 
478 632 1114 
479 613 727 
499 711 1158 
530 556 1317 
540 1226 1285 
593 612 911 
628 629 720 
671 825 1314 
681 1182 1189 
687 994 1020 
704 707 814 
761 762 793 
795 864 962 
857 1122 1349 
883 1088 1089 
884 885 1277 
896 990 1286 
917 918 1179 
946 1092 1252 
1046 1085 1202 
1115 1254 1343 
1193 1194 1260 
