39 48 56 57 105 127 128 137 162 170 171 191 192 223 264 366 391 393 446 460 477 486 487 504 512 542 564 571 595 616 623 624 656 691 692 715 775 809 898 966 969 1072 1107 1108 1124 1135 1177 1234 1241 1290 1302 1306 1347 
8 9 102 187 203 211 217 229 262 276 319 332 345 399 435 440 441 492 505 550 558 560 622 753 754 766 783 823 839 840 862 935 974 981 
0 1 15 22 34 36 208 212 220 238 272 305 327 360 381 388 421 467 475 573 599 608 627 736 787 803 1198 1236 1332 
4 44 131 140 432 438 445 466 490 514 515 543 618 689 743 755 790 800 849 976 1005 1034 1053 1091 1102 1123 1200 1333 
13 20 54 75 96 111 195 200 204 205 250 255 256 308 349 361 488 502 511 619 786 811 866 995 1146 1201 1325 
3 14 139 184 281 282 336 337 370 396 591 611 638 759 914 1026 1046 1116 1173 1183 1210 1329 
72 93 237 248 318 378 540 566 602 739 915 987 996 1031 1082 1170 1226 1285 1289 1300 
24 43 242 245 277 452 671 684 729 929 1008 1172 1215 1279 1298 
165 266 414 442 576 630 816 850 851 863 878 940 1073 1113 1133 
27 122 426 572 590 639 658 669 778 845 856 931 936 1142 
206 207 249 448 643 644 714 728 732 796 797 947 1015 1140 
21 97 244 279 302 410 451 453 454 901 944 1028 1143 
225 299 300 328 536 537 600 601 750 1057 1169 1319 1346 
231 482 641 642 734 830 924 928 1019 1084 1144 1155 1304 
41 76 215 369 384 478 632 756 925 1114 1214 1265 
55 79 768 769 917 918 939 1066 1179 1190 1274 1284 
10 295 394 395 461 683 802 889 983 1079 1216 
40 368 382 387 471 677 678 776 846 1089 1229 
81 284 657 852 874 886 887 919 1017 1131 1280 
99 183 199 270 373 374 519 702 926 1074 1096 
118 119 167 541 570 645 951 952 977 1041 1042 
141 268 434 496 501 528 567 777 785 801 1233 
148 149 503 749 781 832 899 1247 1266 1273 1348 
529 664 695 779 780 930 1033 1035 1118 1262 1292 
7 58 73 74 329 484 545 745 900 1324 
50 406 412 468 574 617 912 1137 1138 1314 
126 173 293 294 400 463 640 697 971 1117 
154 273 386 902 903 954 1003 1047 1056 1258 
312 313 521 522 673 690 789 938 1016 1128 
2 175 176 233 260 348 771 819 1208 
18 123 152 174 221 407 665 836 867 
53 241 261 413 495 842 1027 1212 1224 
91 343 654 682 774 906 907 1045 1246 
107 525 603 667 712 717 733 1278 1344 
26 60 100 271 417 459 497 614 
30 724 978 1070 1071 1187 1205 1310 
31 46 189 340 634 718 943 970 
42 64 218 219 234 309 457 861 
69 214 419 494 594 891 967 1012 
94 115 650 824 1088 1119 1120 1259 
113 114 322 615 737 752 1103 1139 
164 166 423 520 761 762 793 957 
181 185 278 524 660 1243 1351 1354 
198 297 335 424 506 533 959 973 
227 228 288 418 992 1023 1048 1199 
317 334 428 631 703 746 921 1055 
351 404 651 723 843 1013 1232 1350 
479 493 727 873 1136 1153 1209 1316 
5 33 133 301 577 687 693 
16 251 326 405 523 794 1175 
32 397 546 613 713 1295 1299 
49 350 588 812 881 1040 1197 
63 681 871 872 1037 1189 1301 
80 230 286 476 807 808 858 
188 437 552 884 885 1068 1277 
330 331 517 518 920 1018 1184 
449 450 1086 1156 1227 1255 1320 
507 509 510 555 725 799 828 
513 913 994 1020 1149 1240 1335 
893 1181 1207 1218 1219 1223 1328 
23 85 86 744 942 1195 
25 121 172 306 415 844 
28 62 465 735 1001 1330 
78 610 661 662 989 1101 
84 672 876 877 1011 1203 
103 104 197 472 904 1021 
144 210 569 1052 1063 1105 
160 402 456 516 527 923 
177 585 663 686 875 1106 
239 767 958 1069 1130 1345 
267 968 1025 1090 1230 1303 
376 377 470 972 1030 1049 
458 760 960 1132 1222 1282 
498 549 582 604 1159 1160 
740 854 956 1059 1078 1157 
827 998 1024 1154 1167 1321 
1009 1010 1185 1191 1296 1297 
6 246 813 1029 1281 
59 341 535 853 1148 
61 134 427 742 1100 
68 485 815 1039 1145 
71 748 892 979 1217 
92 398 559 1081 1099 
101 314 480 621 1182 
108 352 532 784 1315 
110 474 531 676 706 
116 291 346 1032 1043 
124 792 1244 1245 1261 
132 224 354 375 625 
147 880 1065 1083 1110 
150 196 298 636 905 
182 333 822 985 1225 
236 371 436 698 1141 
409 561 562 991 1211 
416 429 961 1064 1147 
646 647 1134 1276 1326 
680 1164 1165 1288 1305 
765 1007 1061 1307 1308 
833 834 1150 1151 1257 
11 607 694 741 
45 70 254 1312 
47 798 980 1094 
83 178 791 1044 
89 90 222 1311 
95 125 151 1111 
98 986 1080 1318 
106 145 1270 1275 
135 325 389 817 
209 247 782 999 
240 274 879 1235 
257 258 338 548 
259 356 751 1038 
290 696 975 1000 
321 489 1002 1188 
324 464 1129 1248 
347 430 584 688 
357 551 648 855 
365 596 659 701 
390 620 731 916 
433 508 770 953 
447 984 1104 1342 
539 897 932 933 
586 837 838 1283 
730 831 950 1228 
805 806 1158 1336 
12 821 1272 
17 243 1291 
19 179 553 
29 568 1152 
37 339 544 
51 315 597 
52 716 949 
82 1076 1077 
87 161 909 
88 491 934 
109 826 1109 
112 169 226 
117 253 372 
120 1062 1171 
129 578 870 
130 1238 1239 
136 473 557 
138 670 720 
146 287 1168 
155 392 1206 
156 157 982 
158 579 1256 
159 554 927 
180 190 747 
186 385 860 
193 411 700 
194 1093 1231 
216 758 937 
252 1085 1202 
263 563 606 
265 818 910 
269 443 1075 
283 666 1054 
285 408 649 
289 820 1022 
296 383 1178 
303 355 367 
304 342 652 
310 362 1213 
311 848 1067 
320 526 1271 
323 583 653 
363 668 841 
379 380 721 
439 635 1036 
462 708 763 
483 655 882 
530 556 1317 
565 1050 1242 
593 612 911 
628 629 711 
674 788 1196 
685 829 1121 
704 825 835 
705 890 1060 
847 888 1097 
857 1122 1349 
868 1112 1263 
894 895 1006 
896 990 1286 
946 1092 1252 
955 1327 1338 
962 963 1269 
1098 1161 1237 
1115 1254 1343 
1193 1194 1260 
1220 1221 1287 
