18 48 56 57 71 87 97 105 109 123 127 128 137 141 152 157 160 161 162 170 171 174 188 191 221 239 243 244 264 268 281 299 300 328 391 393 397 407 409 410 425 434 437 446 450 454 460 486 487 496 501 512 528 530 536 537 542 546 552 556 564 567 571 593 595 600 601 602 605 612 616 623 624 646 656 665 692 713 715 718 719 748 750 775 777 785 801 809 826 836 867 891 892 909 911 944 958 966 969 979 1028 1032 1057 1068 1069 1107 1108 1109 1124 1134 1135 1156 1169 1177 1217 1231 1234 1241 1290 1295 1299 1302 1306 1317 1319 1346 
0 1 11 15 22 34 36 40 61 83 84 88 102 120 177 178 201 208 212 220 238 280 285 320 341 347 360 368 375 376 381 387 388 408 421 422 430 464 471 477 491 507 509 516 526 547 555 573 584 585 599 607 608 620 627 649 663 672 677 678 686 688 694 736 740 741 767 776 787 791 803 828 846 847 854 859 869 875 876 877 888 955 956 957 1011 1059 1062 1078 1097 1100 1106 1125 1129 1150 1153 1157 1162 1163 1166 1171 1229 1236 1248 1259 1271 1272 1332 1338 1340 1341 1345 
4 10 44 46 116 117 118 119 131 135 140 167 204 206 207 214 216 249 253 291 295 316 325 326 346 358 365 372 389 395 429 431 438 445 447 448 461 466 490 514 515 541 543 570 596 615 618 639 659 683 689 699 701 714 726 743 755 758 764 765 790 794 796 797 800 804 849 866 889 894 895 937 946 947 951 961 976 984 997 1004 1005 1007 1015 1021 1034 1041 1042 1043 1053 1061 1064 1091 1092 1095 1102 1103 1104 1123 1140 1180 1196 1200 1203 1216 1242 1252 1307 1308 1333 1342 
3 14 16 103 104 107 113 114 115 139 150 156 187 196 197 251 267 276 282 322 336 337 357 370 396 405 458 472 523 525 529 550 551 565 581 591 603 611 636 638 648 653 664 667 709 710 712 733 737 752 759 760 779 780 904 905 913 930 960 968 982 1000 1009 1010 1025 1026 1035 1090 1116 1118 1132 1139 1173 1175 1183 1185 1191 1204 1222 1230 1282 1296 1297 1303 1329 1344 
13 20 54 65 75 95 96 110 111 112 132 195 200 205 224 250 255 256 305 308 321 349 354 361 362 379 380 428 474 488 489 511 589 598 619 625 644 673 676 706 721 723 732 786 811 995 1002 1060 1146 1160 1170 1188 1201 1233 1325 1327 
24 43 68 80 242 245 257 258 273 277 286 292 338 351 404 476 485 498 548 549 574 575 582 604 651 684 729 807 808 815 843 858 902 903 929 954 963 1008 1012 1013 1039 1047 1076 1113 1133 1145 1159 1172 1215 1232 1237 1269 1279 1298 1350 
41 76 101 151 153 154 215 225 252 307 314 344 366 369 382 384 386 478 480 504 561 621 632 756 813 883 898 991 1003 1029 1044 1046 1051 1056 1085 1088 1089 1111 1114 1182 1202 1211 1214 1255 1258 1281 
8 203 211 262 319 359 364 399 420 435 440 441 492 505 513 540 560 622 647 753 754 766 783 839 840 862 935 974 981 993 994 1020 1050 1149 1193 1194 1226 1227 1228 1240 1260 1276 1285 1326 1335 
19 27 28 62 94 122 134 179 304 342 345 394 426 427 465 553 559 572 590 652 658 669 735 742 778 845 856 896 931 936 990 1001 1079 1142 1198 1286 1330 
30 31 32 37 42 64 189 234 235 309 339 340 433 439 457 508 544 626 634 635 705 724 770 861 890 943 948 953 970 978 1070 1071 1187 1205 1213 1310 
47 72 93 124 213 237 248 317 318 327 353 378 502 566 637 739 792 798 855 915 980 987 996 1031 1082 1094 1115 1244 1245 1254 1261 1289 1300 1322 1323 1343 
29 159 217 231 312 313 482 521 522 554 568 641 642 671 690 734 810 825 830 924 927 928 938 1014 1016 1019 1084 1128 1144 1152 1176 1304 1314 
49 50 138 186 218 350 385 444 452 479 493 534 588 594 613 670 727 789 812 860 873 881 934 967 1033 1040 1086 1186 1197 1209 1262 1292 1316 
81 89 90 185 222 278 284 310 311 483 500 524 562 655 657 852 874 882 886 887 965 992 1017 1131 1224 1225 1243 1311 1351 
23 59 85 86 198 199 270 297 298 335 533 535 744 795 817 827 853 864 942 959 962 973 998 1024 1148 1154 1195 1321 
17 121 182 192 193 323 333 377 402 411 456 469 470 527 666 700 782 822 923 925 941 972 985 1030 1049 1054 
26 53 98 241 261 296 383 413 459 495 497 696 717 842 975 986 1027 1080 1167 1178 1275 1313 1318 1339 
55 79 136 148 149 412 473 475 503 510 557 660 749 781 799 899 1066 1247 1266 1273 1309 1334 1348 1354 
165 266 279 334 414 442 576 630 631 703 746 816 850 851 863 868 878 921 940 1055 1073 1112 1263 1291 
106 144 145 175 176 210 233 260 330 331 348 517 518 569 771 819 920 1018 1063 1105 1184 1208 1270 
9 125 126 163 194 290 293 294 400 463 640 691 697 763 971 1093 1117 1210 1253 1267 1268 
78 142 143 275 303 355 367 609 610 661 662 738 772 833 834 989 1101 1151 1257 1264 1337 
38 77 108 173 180 288 352 432 532 757 784 802 983 988 1052 1087 1099 1280 1293 1315 
63 494 499 633 681 711 805 806 857 871 872 1037 1122 1158 1189 1265 1301 1336 1349 
227 228 289 403 418 539 704 707 814 835 897 932 933 945 1006 1022 1023 1048 1199 
7 58 67 73 74 287 329 484 545 745 865 900 908 1220 1221 1249 1287 1324 
25 66 172 219 259 269 272 306 356 415 443 467 650 844 914 1038 1075 1192 
5 33 45 70 129 130 133 254 301 302 577 687 693 820 1238 1239 1312 
60 100 181 240 271 274 332 390 417 587 614 731 879 916 1212 1235 
91 92 147 324 343 654 682 774 880 906 907 1045 1065 1083 1110 1246 
164 166 230 236 371 423 436 520 538 675 698 761 762 793 1141 
52 169 226 695 716 730 831 832 848 949 950 1058 1067 1294 
265 453 768 769 818 910 917 918 939 1179 1190 1274 1284 
6 35 209 229 246 247 283 558 922 999 1036 
39 51 223 315 586 597 837 838 1072 1283 1347 
82 155 392 398 580 583 919 1077 1081 1278 
99 183 184 373 374 519 926 1074 1096 1130 
416 449 455 481 592 823 1098 1147 1161 1320 
232 679 680 1155 1164 1165 1288 1305 1331 
363 462 668 708 725 824 841 1119 1120 
406 468 617 628 629 720 912 1137 1138 
751 893 1181 1207 1218 1219 1223 1328 
2 21 451 578 870 901 1143 
643 722 728 773 1136 1206 
645 884 885 952 977 1277 
12 263 563 606 821 
146 158 579 1168 1256 
168 202 685 829 1121 
69 190 419 747 
401 674 788 964 
424 506 531 702 
