48 56 57 105 127 128 137 158 162 167 170 171 191 192 207 264 281 391 393 429 460 477 486 487 499 512 542 564 571 579 616 623 624 656 691 692 714 715 775 796 797 809 850 851 867 889 947 961 966 969 996 1073 1079 1107 1108 1124 1135 1140 1177 1234 1241 1256 1290 1302 1306 
13 20 46 65 82 88 97 112 119 135 155 172 195 200 204 205 239 248 249 256 308 321 361 379 380 392 395 511 570 581 589 602 615 628 629 710 711 732 737 804 811 951 952 997 1032 1042 1077 1097 1159 1160 1168 1201 1325 
44 100 117 131 140 291 316 326 438 445 466 490 514 515 523 541 543 618 743 755 790 794 800 849 964 976 1005 1024 1034 1043 1053 1102 1123 1200 1333 
0 1 15 22 34 36 42 64 174 208 212 220 238 272 305 327 360 381 388 421 475 526 573 588 599 608 627 736 787 803 957 1198 1332 
8 72 93 317 318 378 426 476 540 566 739 764 855 915 987 1031 1082 1142 1175 1289 
187 203 211 217 229 262 319 332 345 435 440 441 492 550 560 622 753 754 783 981 
231 232 370 482 641 642 659 734 830 839 840 924 928 1019 1084 1144 1155 
6 35 41 80 215 246 384 558 585 607 663 686 756 875 1106 1214 
27 122 134 427 470 572 590 658 669 742 778 845 856 931 936 1100 
107 184 336 396 525 565 603 611 667 717 733 759 1069 1130 1236 1329 
136 148 149 412 473 503 660 749 781 899 1247 1266 1273 1307 1348 1354 
61 62 84 651 672 876 877 896 990 1001 1011 1203 1259 1286 1330 
76 154 307 369 382 386 883 1003 1056 1088 1089 1258 1327 
16 132 405 457 488 489 576 625 779 861 1041 1118 
24 43 242 245 277 684 729 929 1008 1172 1215 1298 
106 145 175 176 233 260 348 771 819 914 1208 1270 
164 312 313 469 521 522 690 938 1014 1016 1128 1285 
193 376 377 401 402 456 516 527 923 972 1030 1049 
7 58 73 74 329 484 545 546 745 865 1249 
31 32 189 234 309 340 770 943 953 970 1213 
59 198 270 297 298 335 533 535 817 958 973 
68 259 356 383 485 604 751 893 1038 1039 1145 
141 160 268 428 434 496 528 552 634 718 801 
225 299 300 328 536 537 600 601 1057 1169 1319 
9 165 266 279 414 442 630 816 878 940 
63 681 871 872 1037 1148 1182 1189 1265 1301 
87 108 161 180 352 431 432 784 909 1315 
91 92 343 654 682 774 906 907 1045 1246 
109 646 647 806 826 868 1134 1263 1326 1335 
5 33 45 133 301 302 577 693 820 
99 159 199 374 519 702 926 1074 1096 
144 153 201 210 569 869 1051 1063 1105 
147 166 194 880 1065 1083 1093 1110 1231 
182 333 472 725 822 824 985 1119 1120 
280 387 620 776 846 847 859 888 1229 
3 139 591 638 1026 1116 1173 1183 
4 70 129 130 254 829 1238 1239 
30 724 978 1070 1071 1187 1205 1310 
38 738 833 834 988 1052 1151 1257 
49 50 218 350 812 1040 1086 1197 
51 315 586 597 837 838 1146 1283 
78 240 274 661 662 989 1101 1235 
221 227 228 1006 1022 1023 1048 1199 
241 261 413 495 810 842 1027 1275 
258 454 498 549 582 944 1269 1279 
290 293 294 463 640 697 971 1117 
292 351 574 575 767 1113 1133 1345 
334 501 631 633 703 746 1055 1109 
397 713 1115 1156 1254 1295 1299 1343 
2 21 451 901 1143 1166 1276 
25 94 306 415 467 650 844 
150 156 196 197 636 904 905 
276 458 760 960 1132 1222 1282 
330 331 517 518 920 1018 1184 
453 768 769 939 1179 1190 1274 
643 644 721 728 773 1136 1206 
740 854 885 956 1059 1078 1157 
852 874 886 887 919 1017 1131 
18 123 152 407 665 836 
23 85 86 942 1195 1300 
40 347 430 471 584 688 
71 446 497 748 891 892 
81 185 284 524 657 1351 
96 263 478 563 632 1114 
113 114 282 322 752 1139 
124 502 792 1244 1245 1261 
138 670 720 789 934 967 
157 593 612 613 911 982 
237 418 539 897 932 933 
267 968 1025 1090 1230 1303 
273 902 903 954 1047 1091 
349 827 998 1154 1167 1321 
364 420 513 1050 1149 1240 
406 468 617 912 1137 1138 
409 561 562 991 1029 1281 
673 676 723 1060 1170 1233 
873 881 1033 1153 1262 1292 
1009 1010 1185 1191 1296 1297 
14 596 913 1158 1242 
19 179 553 559 722 
60 417 614 747 941 
75 202 464 1129 1248 
89 90 222 278 1311 
95 151 772 1111 1255 
110 362 474 531 1328 
126 163 400 763 1210 
219 252 344 443 898 
224 354 619 786 815 
236 371 436 698 1141 
289 403 704 835 945 
310 311 483 655 882 
339 416 481 823 1147 
389 461 683 1216 1291 
390 587 731 916 1212 
404 843 1013 1232 1350 
433 508 635 705 890 
449 450 1226 1227 1320 
479 507 555 727 1150 
677 678 750 828 1346 
795 864 879 962 963 
10 857 1122 1349 
11 621 694 741 
39 223 1072 1347 
47 798 980 1094 
54 757 1002 1087 
55 79 325 1066 
101 314 813 1044 
102 103 104 251 
111 255 598 995 
118 645 977 1000 
120 375 1062 1171 
146 250 287 358 
169 226 1058 1294 
206 448 946 1015 
283 666 922 1054 
285 341 408 649 
286 807 808 858 
324 606 652 726 
422 685 955 1338 
447 984 1104 1342 
493 1209 1284 1316 
529 664 695 930 
567 777 785 1211 
689 866 894 895 
730 831 832 950 
765 1007 1061 1308 
992 1224 1225 1243 
1164 1165 1288 1305 
1181 1207 1218 1223 
12 821 1272 
17 243 491 
26 986 1080 
28 465 735 
29 568 1152 
52 716 949 
53 696 975 
69 419 1012 
77 532 1293 
83 178 595 
98 439 1028 
125 216 1103 
173 802 983 
186 385 860 
188 437 1068 
190 424 506 
209 782 900 
214 295 1021 
235 580 1278 
247 999 1036 
257 338 548 
265 818 910 
275 609 610 
288 368 520 
303 355 367 
304 342 504 
320 594 1271 
323 583 653 
337 709 1204 
357 551 648 
359 862 993 
363 668 841 
365 701 1196 
366 744 863 
394 707 814 
399 974 1064 
444 578 870 
505 766 1228 
509 510 799 
530 556 1317 
554 927 1176 
592 1098 1161 
639 699 1004 
671 825 1314 
679 680 1331 
687 994 1020 
712 791 925 
761 762 793 
917 918 1304 
1046 1085 1202 
1193 1194 1260 
1220 1221 1287 
