1 12 13 22 23 32 34 36 40 42 43 53 55 59 63 66 69 86 87 93 94 111 119 130 148 149 165 174 189 195 208 212 219 220 234 235 245 250 252 255 257 258 259 269 272 277 278 280 296 303 305 306 308 309 320 322 325 327 339 340 349 350 352 353 355 360 361 362 366 374 381 388 392 403 406 414 421 433 438 467 468 475 502 503 508 513 515 516 526 570 573 588 591 594 599 600 606 608 619 626 627 645 649 650 724 765 792 845 867 872 875 877 891 908 909 936 937 953 979 997 1012 1023 1037 1058 1106 1147 1187 1213 1217 1238 1239 1260 1266 1273 1282 1315 1332 1348 
4 26 30 33 70 88 97 124 133 134 135 155 158 172 204 207 244 256 271 294 301 302 334 356 394 395 429 453 454 598 615 636 687 693 711 722 737 778 859 889 998 1020 1070 1073 1094 1103 1114 1154 1167 1189 1195 1317 
44 100 178 182 185 186 209 265 282 317 373 391 445 543 589 618 665 666 674 768 782 784 790 793 822 916 933 948 954 964 970 988 1034 1053 1054 1066 1076 1091 1123 1141 1196 1199 1200 1205 1243 
57 128 137 171 248 318 420 426 437 476 478 486 530 540 564 566 602 616 623 692 710 764 817 866 915 987 1046 1107 1142 1194 1206 1241 1289 1310 
48 56 191 233 393 418 460 542 624 648 656 714 715 742 803 809 969 996 1124 1135 1177 1223 1234 1270 1290 1302 1306 
7 126 129 138 288 336 390 396 397 474 556 561 578 581 582 707 728 748 759 820 945 951 980 1159 1328 1329 
5 75 81 82 83 132 284 285 307 347 375 457 488 489 569 593 595 601 652 688 835 1044 1118 1131 
25 91 154 213 214 225 273 299 328 329 386 484 537 610 729 903 1003 1056 1258 1319 
139 164 312 469 470 511 521 690 938 972 1014 1016 1026 1027 1049 1055 1116 
101 215 345 435 459 494 558 590 655 658 744 756 770 917 1036 1304 
9 98 237 279 310 311 423 439 539 654 699 818 932 944 1028 
58 95 122 200 667 703 745 865 900 983 1139 1188 1237 1249 1324 
84 85 153 201 210 412 473 506 702 942 956 1052 1063 1075 1321 
24 240 427 517 671 704 779 781 825 856 929 1215 1307 1308 
45 378 446 496 528 622 746 747 752 763 773 815 892 1173 
106 176 188 224 260 313 348 419 512 771 974 1068 1208 1275 
107 108 187 203 298 332 389 550 611 733 754 860 981 1236 
14 15 267 565 913 968 1004 1025 1050 1090 1230 1242 1303 
524 660 675 774 849 961 1166 1216 1229 1232 1350 1351 1354 
646 647 805 806 868 1134 1158 1246 1263 1276 1326 1335 1336 
18 405 713 788 919 1018 1062 1098 1115 1254 1278 1295 
47 147 166 471 798 808 879 880 1065 1082 1083 1093 
198 270 297 335 533 535 536 871 958 973 1148 1301 
254 482 483 641 642 829 830 924 928 1084 1105 1144 
342 351 576 621 772 902 966 993 1111 1222 1240 1248 
0 37 104 338 367 498 548 549 583 609 978 
141 238 268 434 534 545 653 672 785 1210 
152 295 358 359 462 523 757 794 910 1181 
177 424 519 585 668 686 852 886 887 959 
276 493 661 662 836 918 986 989 1101 1221 
3 76 382 384 385 749 843 1088 1089 
6 29 190 376 401 450 607 921 1043 
16 78 274 326 501 625 960 1041 1235 
20 21 180 415 901 1143 1183 1198 1325 
54 249 644 681 811 812 848 857 1182 
211 216 217 229 253 283 441 560 753 
46 275 409 410 425 527 718 1096 
61 62 876 896 1001 1100 1259 1330 
68 383 640 670 893 971 1022 1214 
96 231 232 507 633 638 1209 1224 
103 197 541 705 706 882 982 1031 
105 116 398 466 490 775 1071 1333 
113 114 202 324 464 477 525 1129 
120 708 816 1160 1193 1244 1245 1261 
146 287 448 682 786 787 795 858 
239 291 292 323 767 922 1133 1345 
293 442 495 697 758 814 1117 1253 
387 620 717 776 846 847 1097 1192 
677 678 777 862 873 976 1136 1153 
679 680 1155 1164 1165 1288 1305 1331 
695 716 730 832 950 1015 1057 1228 
35 205 314 689 1201 1327 1338 
64 428 532 631 634 943 1247 
183 184 337 709 1069 1130 1204 
343 344 481 538 577 751 760 
357 555 579 632 725 1184 1256 
629 801 807 869 898 1038 1202 
28 50 71 465 735 1314 
39 142 223 1067 1225 1347 
73 266 404 651 800 1077 
140 447 485 946 1039 1079 
319 365 659 766 783 1161 
371 698 1104 1122 1342 1349 
400 906 907 957 1045 1231 
408 431 432 701 905 1233 
529 664 930 952 977 999 
739 740 1078 1157 1299 1343 
1009 1010 1185 1191 1296 1297 
52 221 227 992 1048 
65 263 379 732 804 
79 443 574 580 1110 
89 90 222 1140 1311 
102 168 251 723 1059 
125 151 949 1109 1255 
218 669 995 1102 1125 
241 492 854 1013 1152 
261 413 810 842 1086 
264 463 691 940 994 
300 962 963 1047 1269 
354 458 557 584 1007 
369 750 799 1265 1346 
399 1017 1064 1172 1280 
430 673 890 1060 1072 
436 841 894 895 1006 
479 734 839 840 1019 
567 824 912 1119 1120 
612 613 630 911 1171 
684 685 955 1279 1298 
769 1190 1274 1284 1316 
833 834 1150 1151 1257 
10 461 552 802 
27 60 163 417 
41 522 904 1021 
74 123 727 1002 
112 169 226 1169 
136 193 1074 1156 
159 262 926 1138 
162 700 719 720 
196 554 1042 1178 
206 499 500 947 
246 813 1029 1281 
304 736 821 1272 
346 411 864 883 
370 380 676 984 
407 617 861 1294 
416 696 721 1108 
449 1226 1227 1320 
455 456 741 1040 
472 547 939 1179 
504 575 635 1081 
505 881 923 934 
568 731 755 1212 
712 791 823 925 
780 1033 1035 1162 
796 797 850 851 
853 935 1262 1292 
2 514 819 
11 694 1145 
17 243 1291 
19 179 562 
31 899 1271 
38 145 738 
49 603 762 
51 1087 1146 
72 497 1175 
92 559 1099 
99 199 628 
109 487 826 
110 175 914 
117 553 931 
156 157 878 
160 402 1030 
170 363 364 
192 290 975 
194 657 827 
242 544 1211 
281 444 870 
316 572 639 
330 331 518 
333 985 991 
368 520 1024 
372 551 965 
440 604 1085 
452 480 605 
509 510 828 
571 596 597 
789 941 1300 
837 838 1283 
874 990 1011 
884 885 1277 
1008 1032 1252 
1080 1163 1318 
1092 1176 1197 
1218 1219 1312 
