48 56 57 71 105 116 127 128 137 141 154 157 160 162 170 171 188 191 192 225 226 239 264 268 281 291 299 300 328 346 386 387 391 393 397 434 437 446 460 486 487 496 497 501 512 528 536 537 542 552 564 567 571 593 600 601 602 612 613 616 623 624 656 657 677 678 691 692 713 715 748 750 775 776 777 785 801 809 828 884 891 892 911 966 969 1003 1032 1043 1056 1057 1068 1107 1108 1109 1115 1124 1135 1156 1169 1177 1211 1234 1241 1254 1277 1290 1295 1299 1302 1306 1319 1343 1346 
20 37 45 54 65 70 75 82 87 88 96 97 111 112 119 124 135 155 161 195 200 204 205 224 249 256 288 303 308 321 349 354 355 361 367 379 380 429 464 477 502 511 544 584 589 598 615 619 628 629 643 644 673 676 681 711 720 721 723 728 732 765 786 792 804 811 815 827 909 952 961 995 997 998 1007 1060 1077 1097 1129 1146 1154 1159 1160 1168 1170 1182 1189 1201 1206 1233 1244 1245 1248 1261 1307 1308 1321 1325 
4 10 11 17 44 55 79 100 117 129 130 131 140 167 206 207 216 243 254 265 295 316 325 359 389 392 395 445 447 448 461 466 490 491 514 515 541 543 554 570 618 621 683 694 714 741 743 755 758 773 790 794 796 797 800 818 829 849 857 889 910 927 937 946 947 976 984 993 1005 1015 1034 1042 1053 1064 1066 1091 1092 1095 1102 1103 1122 1123 1140 1176 1180 1200 1216 1238 1239 1252 1291 1333 1349 
6 7 29 35 40 58 67 68 69 73 74 83 148 149 177 178 190 193 296 329 368 376 377 383 401 402 412 419 424 456 471 484 485 503 506 516 527 545 546 547 568 585 607 659 660 663 667 686 695 696 712 740 745 749 781 791 832 854 865 875 885 899 908 923 925 956 972 975 1024 1030 1039 1049 1059 1078 1106 1145 1157 1178 1220 1221 1247 1249 1266 1273 1309 1334 1348 1354 
30 49 50 218 235 241 261 273 292 350 351 404 413 479 493 495 507 555 574 575 580 588 617 717 724 727 757 767 810 812 842 843 873 881 902 903 954 978 992 1013 1027 1033 1040 1047 1070 1071 1076 1086 1113 1133 1136 1137 1138 1150 1153 1167 1187 1197 1205 1209 1224 1225 1232 1237 1243 1275 1292 1310 1313 1316 1339 1340 1341 1345 1350 
0 1 15 22 25 34 36 42 53 94 121 169 174 208 212 220 238 259 267 272 305 306 324 327 356 360 381 388 394 398 415 421 438 467 475 520 573 599 606 608 627 650 652 674 726 736 751 787 788 803 893 957 968 1025 1038 1058 1079 1081 1090 1198 1230 1262 1294 1303 1318 1332 
8 9 12 47 72 93 187 202 203 211 213 217 229 248 262 263 317 318 319 345 353 378 426 435 440 441 476 478 492 509 510 540 560 563 566 605 622 632 637 689 739 753 754 764 766 783 798 799 821 855 866 915 980 981 987 996 1031 1082 1094 1114 1142 1175 1289 1322 1323 
14 231 232 364 370 399 420 482 505 513 565 596 641 642 679 680 687 734 830 839 840 853 862 913 924 928 935 974 994 1019 1020 1050 1084 1144 1149 1155 1164 1165 1193 1194 1228 1240 1242 1253 1260 1267 1268 1288 1305 1331 
3 107 113 114 139 172 184 276 282 322 336 337 396 458 525 591 603 611 638 653 709 733 737 752 759 760 960 982 1009 1010 1026 1069 1116 1130 1132 1139 1173 1183 1185 1191 1204 1222 1236 1278 1282 1296 1297 1329 
5 33 110 118 126 133 136 163 244 290 293 294 301 302 362 400 454 463 473 474 530 531 556 577 581 640 645 693 697 707 710 763 814 820 944 951 971 977 1000 1117 1181 1207 1210 1218 1219 1223 1317 1328 
76 99 101 159 183 199 215 246 307 314 369 373 374 382 384 409 519 558 561 562 702 756 813 883 926 991 1029 1036 1044 1046 1074 1085 1088 1089 1096 1202 1258 1281 1327 
26 39 51 60 142 143 223 315 332 390 417 459 586 587 597 614 706 731 747 837 838 848 916 941 1067 1072 1080 1163 1212 1264 1283 1337 1344 1347 
13 63 144 153 201 210 219 252 269 304 342 344 365 443 504 569 701 869 871 872 898 914 979 1037 1051 1063 1075 1105 1148 1196 1217 1265 1301 
2 21 120 138 186 214 240 257 338 375 385 444 451 548 578 594 670 671 789 825 860 870 901 934 967 1062 1143 1166 1171 1276 1314 
19 23 27 85 86 122 134 179 253 372 427 470 553 572 590 639 658 669 699 722 742 778 845 856 931 936 942 1004 1100 1195 1300 
28 61 62 84 109 465 646 647 651 672 735 805 806 826 868 876 877 896 990 1001 1011 1134 1158 1203 1259 1263 1286 1326 1330 1335 1336 
16 78 102 103 104 132 251 274 326 405 411 457 488 489 523 576 625 661 662 700 779 780 861 989 1035 1041 1101 1118 1235 1287 
66 165 266 275 279 334 366 410 414 442 609 610 630 631 703 744 746 816 844 850 851 863 878 940 986 1021 1055 1073 1192 
150 156 182 196 197 283 333 357 472 550 551 636 648 666 725 822 824 904 905 922 964 985 1054 1119 1120 
38 77 108 173 180 352 431 432 532 738 784 802 833 834 983 988 1052 1061 1104 1151 1257 1293 1315 1342 
31 32 46 64 189 234 309 320 340 428 526 626 634 718 770 943 948 953 970 1213 1271 
164 166 194 312 313 423 469 521 522 557 690 761 762 793 938 1014 1016 1093 1128 1231 1285 
91 92 147 343 422 559 654 682 685 774 880 906 907 955 1045 1065 1083 1110 1246 1338 
18 123 146 152 158 250 287 358 406 407 425 579 665 719 836 867 912 1256 1312 
24 43 80 230 242 245 277 286 684 729 807 808 858 921 929 1008 1172 1215 1298 
221 227 228 237 289 403 418 539 704 835 897 932 933 945 1022 1023 1048 1199 
59 198 270 297 298 335 494 499 533 535 633 817 958 973 1012 1125 1162 
98 280 310 311 430 433 439 508 635 705 846 847 859 888 890 1028 1229 
81 284 483 500 655 852 874 882 886 887 919 965 1017 1099 1131 1280 
115 285 341 347 408 595 649 688 795 864 879 962 963 1112 1272 
339 416 449 450 455 481 592 823 1098 1147 1161 1226 1227 1320 
52 95 125 151 620 716 730 772 831 949 950 1111 1255 
89 90 168 185 222 255 278 468 524 1121 1152 1311 1351 
106 145 175 176 233 260 348 771 819 1208 1270 
453 768 769 917 918 939 1179 1190 1274 1284 1304 
209 247 323 529 583 664 782 900 930 999 
236 371 436 538 675 698 894 895 1006 1141 
258 498 549 582 604 1269 1279 
330 331 517 518 920 1018 1184 
41 1002 1087 1188 1214 1324 
181 271 452 480 534 1186 
363 462 668 708 841 959 
