1 12 13 22 23 32 34 36 37 40 42 43 53 59 63 66 69 86 87 88 93 94 111 142 148 149 155 165 189 195 208 212 219 220 234 235 245 250 255 256 257 259 269 277 278 280 296 303 305 308 309 320 322 325 327 339 340 349 350 352 353 354 355 360 361 362 366 374 381 388 392 403 406 414 421 440 467 468 475 489 501 502 503 504 513 515 516 526 570 573 586 588 591 594 599 600 604 608 619 625 626 627 645 647 649 724 765 792 798 817 845 867 872 875 877 891 909 936 937 960 979 997 1012 1037 1038 1050 1081 1094 1106 1147 1162 1187 1189 1213 1217 1260 1266 1273 1276 1282 1315 1326 1331 1332 1348 
48 56 118 140 167 191 206 207 233 393 400 418 460 499 500 520 542 603 624 648 656 714 715 742 803 809 906 907 946 947 957 969 996 1042 1045 1079 1124 1135 1177 1223 1234 1290 1302 1306 
7 75 81 82 83 132 138 285 336 347 375 390 396 397 464 474 477 488 556 569 578 581 582 652 688 728 748 759 820 1044 1129 1131 1159 1328 1329 
44 129 178 185 317 372 373 391 438 445 462 543 618 665 666 768 784 793 916 933 954 970 988 1034 1053 1066 1076 1091 1123 1141 1200 1237 1271 
57 237 248 272 318 338 420 437 478 530 566 602 710 869 915 940 987 1046 1194 1206 1241 1289 1300 1310 
39 127 128 137 171 223 486 564 616 623 683 692 1107 1108 1225 1347 
20 31 46 275 409 415 428 527 539 634 718 899 953 1096 1325 
45 72 378 446 496 528 622 746 747 752 763 773 815 892 1173 
106 176 188 224 260 313 348 419 512 771 974 1068 1208 1270 1275 
593 612 769 777 791 862 873 911 939 976 1153 1190 1274 1284 1316 
16 276 493 494 589 661 662 836 918 967 986 989 1101 1221 
18 38 145 405 546 713 788 919 1018 1062 1098 1278 1280 1295 
154 225 386 695 716 730 831 832 950 1003 1015 1056 1057 1228 
254 482 483 606 641 642 829 830 924 928 1084 1105 1144 1239 
19 179 310 311 426 459 562 590 654 655 744 778 1142 
47 147 274 471 808 879 880 1065 1082 1083 1155 1235 1288 
84 85 201 300 412 473 506 531 702 942 956 1075 1321 
107 108 187 203 284 332 389 550 668 733 754 860 981 
24 427 517 671 704 779 781 856 929 1215 1307 1308 
103 197 540 541 630 705 706 882 982 1031 1226 1285 
30 33 172 271 301 302 395 429 687 693 737 
62 266 646 876 896 990 1011 1259 1286 1330 1335 
126 293 442 495 640 697 758 951 971 1117 1253 
141 238 268 425 434 534 545 653 672 785 1210 
177 314 424 519 585 686 852 874 886 887 959 
105 116 398 466 490 775 1070 1071 1203 1333 
160 161 190 215 239 243 756 897 958 1069 
181 524 660 675 849 961 1166 1216 1351 1354 
304 342 576 738 772 966 993 1111 1222 1248 
3 382 384 385 650 749 843 1088 1089 
10 133 180 288 461 552 802 1175 1277 
14 15 267 565 611 913 968 1236 1242 
64 532 631 806 868 1112 1134 1246 1263 
96 231 232 507 633 638 679 680 1209 
99 198 199 270 297 335 533 628 973 
119 217 457 575 635 734 1019 1041 1304 
152 174 221 295 359 394 523 757 794 
273 299 328 537 729 903 1014 1016 1319 
436 447 485 689 841 894 895 1006 1039 
535 536 853 871 1148 1169 1262 1292 1301 
58 95 122 200 745 1136 1139 1146 
120 708 816 1160 1193 1244 1245 1261 
136 193 469 470 511 972 1049 1074 
211 216 229 283 441 560 753 922 
368 387 620 677 678 717 776 846 
370 380 479 613 676 839 840 984 
509 510 555 725 799 828 1020 1184 
11 291 292 607 694 767 1345 
27 60 100 281 417 444 870 
68 670 835 1022 1133 1214 1238 
139 164 878 1026 1027 1055 1116 
168 202 435 558 561 1058 1281 
182 290 331 731 755 975 1212 
192 369 411 782 864 883 1265 
329 472 484 547 917 1163 1179 
343 344 481 538 577 751 760 
407 617 736 821 861 1272 1294 
0 104 548 549 609 978 
26 383 497 859 985 1317 
89 90 222 637 1140 1311 
113 114 282 525 615 1103 
153 307 601 750 1258 1346 
240 241 492 854 1013 1152 
312 521 690 789 938 941 
371 698 1104 1122 1342 1349 
529 664 780 930 1033 1035 
796 797 824 851 1119 1120 
1009 1010 1185 1191 1296 1297 
17 244 410 850 1291 
21 279 901 1143 1183 
25 91 213 214 610 
29 76 927 1170 1176 
61 376 1001 1100 1318 
65 263 379 732 804 
73 404 651 800 1077 
79 443 574 580 1110 
115 458 584 866 1007 
135 204 674 1114 1305 
146 287 682 786 787 
150 151 377 1118 1255 
186 822 964 1054 1199 
218 669 995 1102 1125 
401 450 921 1043 1196 
430 673 890 1060 1072 
505 881 923 934 1171 
629 801 807 898 1202 
684 1164 1165 1279 1298 
739 740 1078 1157 1299 
770 998 1024 1154 1167 
833 834 1150 1151 1257 
884 885 952 977 999 
2 514 644 819 
6 35 246 1182 
28 50 71 465 
41 522 904 1021 
49 451 761 762 
51 52 227 1087 
78 367 498 583 
97 158 356 889 
101 480 813 1029 
102 319 766 1059 
109 487 826 1109 
110 175 321 330 
130 823 925 932 
162 700 719 720 
163 316 572 639 
166 908 1220 1287 
242 324 544 1211 
261 413 842 1224 
294 334 598 1093 
326 699 1004 1028 
357 579 632 1256 
358 518 726 920 
365 659 783 1161 
399 1017 1064 1172 
408 432 701 1233 
453 454 910 944 
455 456 741 1040 
685 955 1121 1338 
774 1229 1232 1350 
943 948 1205 1247 
962 963 1047 1269 
1025 1090 1230 1303 
4 70 1195 
5 595 827 
9 125 1023 
55 945 1186 
67 251 723 
74 123 727 
80 173 476 
92 559 1099 
98 439 1080 
112 169 226 
117 553 931 
121 253 1005 
124 722 980 
134 735 1198 
144 563 914 
159 1000 1156 
170 363 364 
183 184 1130 
194 657 1231 
196 554 1178 
205 1201 1327 
210 1052 1063 
249 811 812 
252 1036 1085 
262 926 1138 
264 265 818 
298 636 905 
306 433 508 
315 643 790 
323 402 1030 
337 709 1204 
346 825 1314 
416 696 721 
448 795 858 
449 1227 1320 
452 568 605 
463 691 994 
571 596 597 
667 703 983 
711 712 1158 
837 838 1283 
847 1097 1192 
863 1073 1113 
893 1181 1218 
902 935 1240 
992 1048 1243 
1002 1188 1324 
1008 1032 1252 
1092 1132 1197 
1115 1254 1343 
