0 1 12 13 22 23 32 36 37 42 43 44 48 53 54 55 59 63 64 65 66 75 79 83 86 87 88 93 94 108 111 112 149 155 174 189 195 200 205 208 212 218 219 220 234 235 242 245 250 255 256 257 259 269 272 277 278 285 296 303 304 305 306 307 308 309 321 322 327 339 340 341 349 353 355 360 361 374 375 379 381 388 398 403 415 416 421 443 467 468 473 475 502 503 504 508 526 573 588 594 599 608 625 626 627 649 656 681 688 724 728 736 751 770 786 798 803 812 866 867 873 890 899 926 936 952 953 980 993 997 1029 1061 1070 1071 1106 1137 1138 1147 1159 1160 1167 1168 1187 1213 1234 1247 1248 1270 1272 1306 1310 1315 1325 
6 7 24 25 34 35 40 41 58 67 73 74 76 80 81 84 85 113 123 132 142 147 148 150 157 165 168 169 177 178 190 227 291 314 315 328 329 346 366 382 384 401 402 408 412 422 424 457 464 466 484 488 515 516 519 524 531 545 546 547 555 576 584 585 586 593 607 612 613 629 630 663 667 668 686 700 738 745 758 772 775 788 790 791 792 793 807 832 833 834 836 837 838 843 854 865 874 875 883 886 887 900 911 942 948 955 986 994 1012 1024 1032 1058 1078 1085 1089 1094 1098 1102 1109 1111 1124 1125 1131 1139 1149 1150 1151 1193 1197 1202 1220 1221 1237 1240 1252 1257 1260 1261 1271 1273 1283 1287 1294 1295 1327 1332 1333 1338 1351 
8 9 20 101 102 124 146 187 188 202 203 211 216 217 221 229 230 246 247 252 262 263 276 319 320 332 333 334 344 345 354 357 365 399 431 435 440 441 476 491 492 505 550 551 558 560 561 592 619 622 632 635 698 733 735 753 754 756 766 783 813 823 852 860 862 870 935 975 981 987 995 1002 1036 1038 1067 1087 1121 1129 1281 
10 31 56 69 70 120 125 126 131 135 158 160 172 173 231 236 237 248 268 288 294 295 352 394 409 428 429 430 434 442 461 463 495 527 534 539 595 640 648 697 718 742 747 827 840 841 851 861 863 897 933 941 951 969 971 976 992 996 1008 1020 1023 1064 1073 1088 1096 1103 1117 1141 1177 1194 1195 1223 1233 1243 1289 1300 1305 
153 154 225 226 299 300 368 369 386 387 506 509 510 535 536 537 600 601 702 749 750 765 781 799 817 828 871 872 903 998 1003 1037 1056 1057 1148 1154 1169 1258 1264 1265 1301 1307 1308 1319 1321 1346 
2 3 21 105 106 109 110 176 223 224 233 260 261 347 348 393 419 420 437 512 571 597 634 715 771 809 819 901 915 974 1068 1083 1135 1142 1143 1183 1208 1275 1290 1302 1347 
4 5 26 30 33 45 97 98 130 133 152 161 180 243 244 254 271 279 301 302 447 453 454 485 498 577 598 687 693 802 818 910 932 944 985 1175 1218 1219 1312 
68 82 107 140 166 167 179 284 290 324 391 400 413 423 427 499 520 606 628 652 726 835 957 1007 1044 1045 1211 1212 1231 1348 
127 128 136 137 170 171 191 192 264 265 460 477 478 486 487 542 564 616 623 624 691 692 710 721 1107 1108 1112 1241 
14 15 115 267 326 336 396 513 565 591 596 611 743 759 913 968 1004 1025 1050 1090 1153 1230 1236 1242 1276 1303 1329 
27 46 121 122 134 141 253 289 426 451 452 494 572 590 637 639 655 658 669 704 744 778 795 845 856 931 
71 72 238 239 378 446 496 497 501 552 605 653 672 746 748 752 763 785 801 815 855 892 979 991 1173 1210 
151 258 293 318 338 350 356 367 383 548 549 557 582 583 604 609 696 869 893 940 978 1039 1178 1269 
57 103 104 156 196 197 251 472 540 541 676 703 706 727 904 905 922 982 1031 1060 1170 1226 1285 
17 162 163 389 390 410 417 418 538 707 708 719 720 820 850 945 1093 1186 1291 
206 249 342 363 380 514 643 644 732 811 848 857 966 1122 1145 1182 1189 1198 1349 
61 62 266 651 826 876 877 896 990 1001 1011 1100 1203 1209 1259 1286 1318 1330 
77 144 145 175 201 209 210 281 282 569 898 914 1046 1051 1052 1063 1075 1105 
47 99 100 275 358 359 425 462 471 523 665 757 794 927 943 1021 1253 
29 139 370 371 405 444 659 671 699 764 810 937 984 1019 1278 
91 92 213 214 397 474 528 556 581 610 773 1040 1136 1328 
164 406 407 414 580 631 761 762 814 816 844 878 1244 1245 
312 313 469 521 522 554 633 690 789 1014 1016 1055 1128 1163 
28 38 50 404 465 532 737 919 1017 1062 1099 1224 1280 
364 411 614 731 808 864 879 880 962 1065 1082 1207 1235 
181 182 186 636 638 666 782 822 849 964 1054 1181 
193 194 323 376 470 511 821 925 972 1030 1049 1072 
215 310 311 325 362 438 439 459 562 654 882 1028 
283 529 530 664 694 695 839 859 930 999 1035 1317 
432 450 673 674 701 705 722 723 921 938 1043 1196 
646 647 805 806 868 1134 1158 1263 1266 1326 1335 1336 
118 207 395 448 500 714 797 889 946 947 1079 
482 483 641 642 734 829 830 924 928 1084 1144 
567 568 739 740 741 885 956 1013 1059 1152 1157 
78 493 661 662 918 970 989 1101 1284 1316 
116 480 730 831 949 950 963 1015 1047 1228 
117 316 317 372 373 445 755 1005 1034 1066 
198 199 270 297 298 335 533 958 959 973 
11 119 392 570 589 615 800 804 1042 
95 96 204 490 563 578 579 1114 1146 
292 574 575 767 902 1113 1133 1345 
377 455 456 657 670 923 1206 1214 
650 725 796 824 912 1119 1120 1201 
768 769 917 939 1179 1190 1274 1304 
16 489 779 780 1041 1118 1162 
60 479 587 1074 1217 1256 1293 
183 184 337 709 1069 1130 1204 
330 331 517 518 920 1018 1184 
684 685 729 1172 1215 1279 1298 
18 19 553 559 566 787 
89 90 222 1110 1140 1311 
240 241 273 274 385 929 
280 846 847 888 1097 1192 
286 287 682 858 908 1249 
351 784 954 1076 1077 1080 
433 525 602 603 1081 1262 
458 760 960 1132 1222 1282 
660 683 1092 1216 1229 1354 
675 774 961 1166 1232 1350 
1009 1010 1185 1191 1296 1297 
51 52 228 1022 1048 
129 507 891 1238 1239 
138 881 934 967 1171 
185 965 1161 1165 1288 
436 689 894 895 1006 
679 680 1155 1164 1331 
711 712 842 1026 1027 
49 617 618 1205 
232 713 1299 1344 
620 621 716 717 
645 977 988 1091 
677 678 776 777 
916 1053 1123 1200 
39 1199 1225 
159 1000 1176 
449 1156 1255 
853 1033 1292 
906 907 1246 
983 1104 1342 
1115 1254 1343 
1126 1127 1174 
