1 12 13 22 23 32 34 36 40 42 43 53 55 59 63 66 69 86 87 93 94 111 119 130 148 149 174 189 195 208 212 219 220 234 235 245 250 255 257 258 259 269 272 277 278 280 296 303 305 306 308 309 320 322 325 327 339 340 349 350 352 353 355 360 361 362 366 374 381 388 392 403 406 414 421 433 440 467 468 475 501 502 503 504 508 513 515 516 526 570 573 588 591 594 599 600 604 606 608 619 626 627 645 649 650 765 792 845 867 872 875 877 891 908 909 936 937 953 960 997 1012 1023 1037 1058 1081 1106 1147 1162 1187 1213 1238 1239 1260 1266 1273 1282 1315 1332 1348 
44 100 129 178 185 391 479 543 589 618 665 666 734 784 790 839 840 916 933 948 954 970 988 1019 1024 1053 1076 1091 1123 1141 1200 1205 1243 
26 30 33 97 133 158 172 207 244 271 294 301 302 334 395 429 453 454 598 636 687 693 778 820 859 889 944 985 1020 1073 1317 
5 75 81 82 83 132 284 285 307 347 375 457 464 477 488 489 569 593 595 601 625 652 688 835 1041 1044 1118 1129 1131 
47 70 88 147 152 239 291 295 323 354 358 359 394 458 462 471 523 757 794 798 808 879 880 922 1065 1082 1083 1094 
48 56 162 191 233 393 418 460 542 624 648 656 715 742 803 809 969 996 1124 1135 1177 1223 1234 1270 1290 1302 1306 1328 
31 46 141 238 268 275 409 425 428 434 527 534 539 545 634 653 672 718 785 899 943 1021 1096 1247 1271 
98 101 215 243 310 311 345 423 435 439 459 494 552 558 590 654 655 658 744 756 770 917 918 1028 1304 
7 126 138 288 336 390 396 397 474 556 561 578 581 582 707 728 748 759 945 951 980 1181 1218 1329 
57 145 248 318 420 426 437 476 530 540 566 602 710 764 915 987 1142 1194 1241 1289 1310 
24 427 452 480 517 639 684 685 704 779 781 856 929 955 1215 1279 1298 
84 85 153 201 210 225 300 412 473 506 702 942 956 1052 1063 1075 1321 
45 378 446 496 528 622 746 747 752 763 773 815 892 1173 1210 
107 108 187 203 298 332 389 550 611 733 754 860 981 1236 1278 
106 176 188 224 260 313 348 419 512 771 974 1068 1208 1275 
677 678 769 777 862 873 939 976 1136 1153 1190 1274 1284 1316 
128 137 171 264 265 486 564 616 623 692 818 910 1107 
0 37 104 293 356 367 498 548 549 583 609 978 
10 11 206 371 499 500 694 698 947 1122 1145 1349 
25 91 213 214 328 329 484 537 610 729 1016 1319 
198 270 297 335 533 535 536 871 958 973 1148 1301 
254 482 483 641 642 829 830 924 928 1084 1105 1144 
14 15 267 565 571 596 597 913 968 1050 1242 
177 424 519 585 607 668 686 852 886 887 959 
95 122 667 703 745 865 983 1104 1249 1342 
154 369 386 750 799 1003 1056 1258 1265 1346 
211 216 217 229 253 283 441 560 753 1103 
400 469 470 511 906 907 957 972 1045 1049 
524 675 774 849 961 1166 1229 1232 1350 1351 
529 664 884 885 930 952 977 999 1159 1277 
567 740 824 854 912 1078 1119 1120 1152 1157 
3 76 382 384 385 749 843 1088 1089 
18 713 714 788 1098 1115 1237 1254 1295 
20 21 180 415 901 1143 1183 1198 1325 
54 249 644 681 811 812 848 857 1182 
61 62 876 896 1001 1100 1259 1330 
68 338 640 670 893 971 1022 1214 
96 231 232 507 633 638 1209 1224 
103 197 541 705 706 882 982 1031 
105 116 398 466 490 775 1071 1333 
117 317 373 445 768 931 1034 1066 
120 708 816 1160 1193 1244 1245 1261 
139 164 521 1014 1026 1027 1055 1116 
182 186 282 793 822 964 1054 1199 
319 365 491 659 766 783 1051 1161 
342 576 772 966 993 1111 1222 1248 
357 478 555 579 632 725 1184 1256 
387 620 717 776 846 847 1097 1192 
679 680 1155 1164 1165 1288 1305 1331 
125 150 151 377 949 1109 1255 
183 184 337 709 1069 1130 1204 
205 314 689 866 1201 1327 1338 
343 344 481 538 577 751 760 
6 29 190 376 401 1043 
16 17 78 274 405 1235 
27 60 281 417 444 870 
39 142 223 1067 1225 1347 
65 263 379 732 804 1114 
73 266 404 651 800 1077 
115 806 868 1112 1246 1263 
140 447 485 946 1039 1079 
261 413 724 810 842 1086 
399 1017 1018 1064 1172 1280 
493 661 662 986 989 1101 
509 510 739 828 1299 1343 
575 635 780 1033 1035 1036 
612 712 791 823 911 925 
1009 1010 1185 1191 1296 1297 
28 50 71 465 1314 
35 660 1216 1220 1354 
49 451 603 761 762 
52 221 227 992 1048 
79 443 574 580 1110 
89 90 222 1140 1311 
102 168 251 723 1059 
113 114 202 324 525 
118 290 605 975 1000 
146 287 682 786 787 
218 669 995 1102 1125 
246 383 813 1029 1281 
407 617 861 1272 1294 
436 841 894 895 1006 
449 450 1226 1227 1320 
646 647 1134 1276 1326 
730 950 1015 1057 1228 
833 834 1150 1151 1257 
74 123 727 1002 
109 487 826 1335 
112 169 226 1169 
121 671 1005 1318 
135 204 674 817 
136 193 1074 1156 
155 615 737 1206 
159 262 926 1138 
165 442 758 814 
196 554 1042 1178 
209 900 1188 1324 
252 438 979 1217 
276 836 1221 1287 
292 767 1133 1345 
299 553 722 1196 
351 621 902 1240 
370 380 676 984 
416 696 721 1108 
455 456 741 1040 
463 691 940 994 
495 697 1117 1253 
505 881 923 934 
568 731 755 1212 
796 797 850 851 
853 935 1262 1292 
869 898 1038 1202 
962 963 1047 1269 
998 1070 1154 1167 
1025 1090 1230 1303 
2 514 819 
9 279 878 
19 179 562 
38 738 919 
41 522 904 
51 1087 1146 
58 200 1139 
64 532 631 
72 497 1175 
92 559 1099 
99 199 628 
134 735 1231 
156 410 1291 
157 855 1128 
160 402 1030 
163 316 572 
170 363 364 
192 411 782 
194 657 827 
230 921 1168 
240 273 903 
241 492 1013 
242 544 1211 
256 673 1060 
304 736 821 
326 699 1004 
330 331 518 
372 551 965 
408 701 905 
430 890 1072 
431 432 1233 
448 795 858 
472 547 1179 
531 967 1062 
557 584 1007 
613 630 1171 
629 801 807 
690 1080 1163 
695 716 832 
700 719 720 
789 941 1300 
837 838 1283 
874 990 1011 
914 1046 1085 
1008 1032 1252 
1092 1176 1197 
