48 56 57 105 127 128 137 162 170 171 191 192 264 281 391 393 460 477 486 487 512 542 564 571 616 623 624 656 691 692 715 775 809 867 966 969 996 1107 1108 1124 1135 1177 1234 1241 1290 1302 1306 
4 44 100 117 131 140 167 291 316 326 392 438 445 466 490 514 515 523 541 543 618 743 755 790 794 800 849 889 964 976 1005 1024 1034 1042 1043 1053 1102 1123 1200 1333 
13 20 46 82 88 96 112 119 135 155 195 200 204 205 256 288 308 321 361 511 570 581 615 710 711 712 811 951 1077 1097 1158 1160 1201 1325 
0 1 15 22 34 36 42 64 208 212 220 238 360 381 388 421 526 573 599 608 627 736 787 803 957 1198 1332 
61 62 84 109 646 647 651 672 806 826 868 876 877 896 990 1001 1011 1134 1203 1259 1263 1286 1326 1330 1335 
8 93 202 248 317 318 319 378 426 476 540 566 739 766 855 915 987 1031 1082 1142 1289 
158 206 207 395 429 448 579 796 797 850 851 947 961 1015 1073 1256 
187 203 211 217 229 262 435 440 441 492 560 622 753 754 783 981 
16 132 405 457 488 489 576 625 779 780 861 1035 1041 1118 
76 153 154 225 307 369 386 883 1003 1056 1088 1089 1258 1327 
106 145 175 176 233 260 348 569 771 819 914 1105 1208 1270 
25 172 177 272 306 415 467 585 650 663 686 875 1106 
24 43 242 245 277 684 729 929 1008 1172 1215 1298 
27 122 345 572 590 658 669 778 845 856 931 936 
148 149 305 475 503 749 781 899 1247 1266 1273 1348 
231 232 482 641 642 734 830 924 928 1019 1084 1144 
299 300 328 536 537 600 601 962 1057 1156 1169 1319 
31 32 189 234 309 340 770 943 953 970 1213 
59 198 270 297 298 335 533 535 817 958 973 
141 160 268 428 434 496 528 552 634 718 801 
280 368 387 520 620 776 846 847 859 888 1229 
292 351 574 575 767 1076 1080 1113 1133 1237 1345 
3 139 370 591 638 737 1026 1116 1173 1183 
7 58 73 74 329 484 545 546 745 865 
29 568 740 854 885 956 1059 1078 1152 1157 
49 50 218 219 350 588 812 1040 1086 1197 
103 104 150 156 196 197 472 636 904 905 
5 33 45 133 301 302 577 693 820 
53 241 261 413 495 810 842 1027 1275 
63 252 344 871 872 1037 1148 1265 1301 
81 284 852 874 886 887 919 1017 1131 
91 92 343 654 682 906 907 1045 1246 
99 159 199 374 519 702 926 1074 1096 
164 312 313 521 522 690 938 1016 1128 
259 296 356 383 443 751 893 1038 1178 
529 664 695 716 730 831 832 930 950 
30 724 978 1070 1071 1187 1205 1310 
38 738 833 834 988 1052 1151 1257 
51 315 586 597 837 838 1146 1283 
78 240 274 661 662 989 1101 1235 
107 389 525 603 667 717 733 982 
110 362 474 707 773 814 1136 1328 
113 114 282 322 324 606 752 1139 
144 201 210 869 898 1051 1063 1202 
165 266 414 442 630 816 878 940 
221 227 228 1006 1022 1023 1048 1199 
258 498 549 582 604 1159 1269 1279 
290 293 294 463 640 697 971 1117 
382 397 409 561 991 1029 1211 1281 
509 510 677 678 750 799 828 1346 
679 680 1155 1164 1165 1288 1305 1331 
873 881 1033 1153 1262 1284 1292 1316 
2 21 451 901 1143 1166 1276 
18 123 152 174 407 665 836 
26 60 332 417 459 614 848 
193 376 377 470 972 1030 1049 
273 902 903 954 963 1047 1091 
276 458 760 960 1132 1222 1282 
330 331 517 518 920 1018 1184 
336 565 611 759 1236 1242 1329 
453 768 769 939 1179 1190 1274 
6 35 246 660 813 1354 
9 98 279 454 944 1028 
23 85 86 942 1195 1300 
70 129 130 254 1238 1239 
71 446 497 748 891 892 
87 161 897 909 1231 1320 
124 502 792 1244 1245 1261 
147 774 880 1065 1083 1110 
182 725 824 941 1119 1120 
188 239 437 602 1068 1069 
267 968 1025 1090 1230 1303 
310 311 483 562 655 882 
334 631 703 746 844 1055 
349 827 998 1154 1167 1321 
364 420 513 1050 1149 1240 
404 757 843 1013 1232 1350 
406 468 617 912 1137 1138 
673 676 723 1060 1170 1233 
1009 1010 1185 1191 1296 1297 
1181 1207 1218 1219 1223 1312 
11 607 621 694 741 
19 179 553 559 722 
40 136 412 471 473 
47 327 798 980 1094 
67 908 1220 1221 1287 
80 286 287 858 1249 
89 90 222 278 1311 
95 151 772 1111 1255 
97 244 410 1032 1291 
108 352 432 784 1315 
118 645 952 977 1000 
126 163 400 763 1210 
157 501 713 1109 1299 
185 255 524 657 1351 
236 371 436 698 1141 
237 418 539 932 933 
249 643 644 728 1206 
289 403 704 835 945 
339 416 481 823 1147 
390 587 731 916 1212 
402 456 516 527 923 
422 685 829 955 1338 
479 507 555 727 1150 
765 1007 1061 1307 1308 
839 840 853 862 935 
10 461 683 1216 
39 223 1072 1347 
55 79 325 1066 
65 379 589 732 
68 485 1039 1145 
75 594 619 786 
101 314 652 1044 
120 375 1062 1171 
134 427 742 1100 
169 226 1058 1294 
209 782 900 1324 
235 580 583 1278 
247 558 999 1036 
275 609 610 1021 
283 666 922 1054 
285 341 408 649 
347 430 584 688 
357 550 551 648 
366 744 863 986 
399 974 1064 1227 
401 674 788 1295 
433 508 705 890 
444 531 789 967 
447 984 1104 1342 
593 612 613 911 
689 866 894 895 
992 1224 1225 1243 
1014 1176 1226 1285 
12 821 1272 
14 596 913 
28 465 735 
41 1087 1214 
52 949 1067 
54 1002 1188 
69 419 1012 
77 532 1293 
83 178 595 
94 394 1079 
111 598 995 
125 216 1103 
138 670 934 
146 250 1168 
166 194 1093 
173 802 983 
180 190 747 
183 373 659 
186 385 860 
215 384 756 
224 354 815 
257 338 548 
265 818 910 
303 355 367 
304 342 504 
333 822 985 
337 709 1204 
363 668 841 
365 701 1196 
396 493 1209 
424 506 959 
449 450 592 
464 1129 1248 
478 632 1114 
494 499 633 
530 556 1317 
567 777 785 
628 629 720 
639 699 1004 
671 825 1314 
681 1182 1189 
687 994 1020 
761 762 793 
795 864 879 
857 1122 1349 
917 918 1304 
946 1092 1252 
1115 1254 1343 
1193 1194 1260 
