6 7 24 25 34 35 40 41 58 67 73 74 76 80 81 84 85 113 123 132 142 147 148 150 157 164 165 168 169 177 178 190 227 291 292 314 315 328 329 346 351 366 382 384 401 402 408 412 414 422 424 457 464 466 484 488 516 519 531 535 545 546 547 574 575 576 580 584 585 586 593 607 612 613 629 630 631 663 667 668 675 686 700 738 745 758 761 762 767 772 775 788 790 791 792 793 807 814 816 832 836 837 838 843 844 846 865 874 875 878 883 886 900 902 911 948 955 961 986 994 1012 1024 1032 1054 1058 1080 1085 1089 1094 1098 1100 1102 1109 1111 1113 1117 1124 1125 1131 1149 1162 1166 1193 1197 1202 1220 1221 1232 1237 1240 1244 1245 1252 1260 1261 1271 1273 1283 1294 1295 1327 1332 1333 1338 1345 1350 
0 1 12 13 22 23 32 36 37 42 43 44 48 53 54 55 59 63 64 65 66 75 79 83 86 87 88 93 94 95 96 108 111 112 149 151 155 174 189 195 200 204 205 208 212 218 219 220 234 235 242 245 250 255 256 257 259 269 272 277 278 285 296 303 304 305 306 307 308 309 321 322 327 339 340 341 349 353 355 360 361 374 375 379 381 388 398 403 415 416 421 443 467 468 473 475 490 502 503 504 508 526 563 573 578 579 588 594 599 608 625 626 627 656 681 688 724 728 736 751 770 786 798 803 812 866 867 873 890 899 926 936 942 952 953 980 993 997 1029 1061 1070 1071 1106 1114 1122 1137 1138 1146 1147 1159 1160 1167 1168 1187 1213 1234 1247 1248 1270 1272 1306 1310 1315 1325 1349 
10 31 47 51 52 56 57 69 70 99 100 120 125 126 131 135 158 160 172 173 228 231 236 237 248 268 275 288 294 295 352 358 359 394 409 425 428 429 430 434 442 461 462 463 471 495 523 527 528 534 539 595 640 648 657 665 697 718 742 747 757 794 827 840 841 851 861 863 897 905 923 927 933 941 943 951 969 971 976 982 992 996 1008 1020 1021 1022 1023 1031 1048 1064 1073 1088 1096 1103 1141 1170 1173 1177 1194 1195 1206 1210 1223 1233 1243 1289 1300 1305 
8 9 20 101 102 124 146 187 188 202 203 211 216 217 221 229 230 246 247 252 262 263 276 319 320 332 333 334 345 354 357 365 399 431 435 440 441 476 491 492 505 550 551 558 560 561 592 622 632 635 698 733 735 753 754 756 766 783 823 852 860 862 870 935 975 981 987 995 1002 1036 1038 1067 1087 1121 1129 1188 1281 1324 
14 15 115 183 184 267 326 336 337 396 513 565 596 611 649 709 743 759 805 806 826 868 906 907 913 968 1004 1025 1050 1069 1090 1130 1134 1153 1158 1204 1230 1236 1242 1246 1263 1303 1329 1335 1336 
2 3 21 105 106 109 110 176 223 224 233 260 261 347 348 393 419 420 437 512 571 597 634 715 771 809 819 901 915 974 1068 1083 1139 1142 1143 1183 1208 1275 1290 1302 1347 
4 5 26 30 33 45 97 98 133 152 161 180 243 244 254 271 279 301 302 453 454 498 577 598 687 693 802 818 910 932 944 985 1175 1320 
68 82 107 140 166 167 179 194 284 290 324 400 413 423 427 470 499 520 619 628 652 821 835 925 957 1007 1030 1044 1045 1211 1212 1231 1348 
127 128 136 137 170 171 191 192 264 265 460 477 478 486 487 542 564 616 623 624 691 692 710 721 1107 1108 1112 1135 1241 
27 46 121 122 134 141 253 289 323 426 451 452 494 572 590 637 639 655 658 669 704 744 778 795 845 856 931 1276 
11 118 119 207 391 392 395 448 485 500 570 589 615 714 726 797 800 804 889 934 946 947 967 1042 1079 
71 72 238 239 378 446 496 497 501 552 605 653 672 746 748 752 763 785 801 815 855 892 979 991 
258 293 318 338 350 356 367 383 548 549 557 582 583 604 609 696 869 893 940 978 1039 1178 1209 
38 39 232 404 405 713 737 760 919 1017 1018 1062 1099 1181 1199 1207 1224 1278 1280 1299 1344 
77 144 145 175 201 209 210 281 282 344 569 591 898 914 1046 1051 1052 1063 1075 1105 
153 154 225 226 369 386 387 506 510 600 601 749 799 903 1003 1056 1057 1169 1258 1265 
29 139 186 370 371 444 636 638 659 671 699 764 937 983 984 1104 1132 1282 1342 
509 515 524 555 567 568 739 740 741 854 885 956 1013 1059 1078 1152 1157 1351 
432 449 450 673 674 701 705 722 723 921 938 1043 1086 1116 1156 1196 1255 
61 62 266 646 651 876 877 896 990 1001 1011 1203 1259 1286 1318 1330 
103 104 156 196 197 251 472 540 541 676 703 706 727 904 922 1060 
91 92 213 214 397 447 458 474 556 581 610 773 1040 1136 1328 
162 163 389 390 417 418 538 707 708 719 720 820 945 1093 1186 
312 313 469 521 522 554 633 690 789 1014 1016 1055 1128 1163 1285 
206 249 342 514 643 644 732 811 848 857 1145 1182 1189 1198 
181 182 660 666 683 822 849 1092 1216 1222 1225 1229 1354 
364 411 614 731 808 864 879 880 887 1065 1082 1235 1287 
117 316 317 372 373 445 755 964 965 1005 1034 1066 
215 310 311 325 362 438 439 459 562 654 882 1028 
283 529 530 664 694 695 839 859 930 999 1035 1317 
28 60 185 465 479 532 782 810 960 1019 1161 
368 684 685 702 765 781 817 1172 1298 1307 1308 
482 483 641 642 734 829 830 924 928 1084 1144 
116 480 730 831 949 950 963 1015 1047 1228 
198 199 270 297 298 335 533 958 959 973 
78 493 661 662 774 970 989 1101 
650 725 796 824 912 1119 1120 1201 
18 19 299 553 559 566 787 
89 90 222 920 1110 1140 1311 
129 130 507 606 891 1238 1239 
300 537 729 962 1215 1269 1319 
679 680 1155 1164 1253 1288 1331 
750 828 998 1154 1264 1321 1346 
769 939 1179 1190 1274 1284 1316 
16 489 779 780 1041 1118 
49 50 617 618 1205 1314 
193 376 511 972 1049 1072 
240 241 273 274 385 929 
286 287 682 858 908 1249 
433 525 602 603 1081 1262 
536 871 872 1037 1148 1301 
645 884 977 988 1091 1277 
1009 1010 1185 1191 1296 1297 
280 847 888 1097 1192 
330 331 517 518 1184 
377 455 456 670 1214 
436 689 894 895 1006 
587 1074 1217 1256 1293 
711 712 842 1026 1027 
833 834 1150 1151 1257 
17 410 850 1291 
620 621 716 717 
677 678 776 777 
768 917 918 1304 
784 954 1076 1077 
916 1053 1123 1200 
114 813 909 
138 881 1171 
159 1000 1176 
363 380 966 
647 1266 1326 
853 1033 1292 
1115 1254 1343 
1126 1127 1174 
1218 1219 1312 
