4 10 11 44 46 100 108 110 116 117 118 119 131 135 140 167 173 204 206 207 214 216 243 291 295 346 352 358 359 362 365 389 394 395 429 431 432 445 447 448 461 466 474 490 514 515 523 531 532 541 543 570 596 607 615 618 645 659 683 689 694 699 701 707 714 726 741 743 755 758 764 765 784 790 794 796 797 800 802 814 849 850 851 857 866 889 894 895 937 946 947 951 952 961 976 977 983 984 993 1004 1005 1007 1015 1024 1034 1042 1043 1053 1061 1073 1079 1092 1095 1102 1103 1104 1122 1123 1140 1180 1196 1200 1216 1252 1275 1291 1307 1308 1313 1315 1328 1333 1339 1342 1349 
48 56 57 71 105 127 128 137 141 154 157 160 162 170 171 188 191 225 239 264 268 281 299 300 328 386 391 393 397 437 446 460 486 487 496 501 512 528 530 536 537 542 552 556 564 567 571 600 601 602 605 616 623 624 656 692 715 718 748 750 775 777 785 801 809 867 891 892 966 969 1003 1056 1057 1068 1069 1107 1108 1135 1169 1177 1234 1241 1290 1302 1306 1317 1319 1346 
8 12 47 72 80 93 124 146 166 202 203 211 213 217 230 248 258 262 263 286 287 317 318 319 327 378 435 440 441 454 476 478 492 498 549 558 560 563 566 582 622 632 739 753 754 766 783 792 798 807 808 821 855 858 908 915 944 963 980 981 987 1031 1082 1094 1114 1115 1159 1168 1220 1221 1244 1245 1254 1261 1269 1272 1279 1287 1289 1300 1343 
6 7 35 55 58 67 73 74 79 95 102 103 104 136 148 149 177 209 246 247 251 325 329 412 473 475 484 503 510 529 545 585 660 663 664 667 686 695 745 749 781 782 799 813 832 865 875 899 900 930 959 999 1036 1066 1106 1237 1247 1249 1266 1273 1309 1324 1334 1348 1354 
5 26 33 45 60 70 126 129 130 133 147 158 163 180 194 254 271 290 293 294 301 302 332 390 400 417 434 459 463 497 577 579 587 614 640 691 693 697 731 763 774 820 848 880 916 971 1065 1083 1093 1110 1117 1175 1210 1212 1238 1239 1256 1312 
13 20 38 54 75 111 112 155 195 200 224 249 250 255 256 288 303 305 308 321 354 355 367 380 392 428 502 511 547 598 619 643 644 673 676 702 706 721 723 728 773 786 811 988 995 1002 1052 1060 1136 1160 1163 1170 1188 1206 1233 1325 
0 1 22 34 36 37 42 64 82 83 109 178 208 212 220 238 339 360 381 388 398 421 438 526 544 546 573 599 608 612 613 626 627 674 713 736 787 788 791 803 826 835 911 948 957 1076 1077 1081 1109 1124 1156 1198 1295 1299 1332 
40 84 87 88 161 280 368 376 387 464 471 477 491 520 584 620 646 647 651 672 776 805 806 846 847 859 868 876 877 888 897 909 990 1011 1050 1097 1129 1134 1158 1229 1231 1248 1259 1263 1320 1326 1335 1336 
41 76 101 125 144 151 153 201 210 215 269 307 314 369 382 384 409 561 569 621 756 869 883 898 914 991 1029 1044 1046 1051 1063 1075 1085 1088 1089 1105 1111 1182 1202 1211 1214 1255 1258 1281 
19 27 28 61 62 122 134 179 253 316 345 353 372 426 427 465 553 559 572 590 637 639 653 658 669 722 735 742 778 845 856 896 931 936 1001 1100 1142 1203 1286 1322 1323 1330 
14 15 107 113 114 115 187 267 276 282 322 336 337 396 458 525 565 603 606 611 709 712 733 752 759 760 913 960 968 982 1025 1090 1132 1139 1204 1222 1230 1242 1282 1303 1329 
24 43 68 98 121 193 242 245 277 323 377 402 456 470 485 494 516 527 684 729 815 923 925 929 972 986 1008 1012 1030 1039 1049 1080 1125 1145 1162 1172 1215 1298 1318 
49 50 186 218 219 350 385 452 479 480 507 509 534 555 588 677 678 727 812 828 860 873 881 1033 1040 1086 1150 1153 1186 1197 1262 1284 1292 1316 1340 1341 
16 39 51 96 132 192 205 223 240 274 326 405 411 457 488 489 576 597 625 700 779 780 861 1035 1041 1072 1118 1146 1201 1235 1327 1338 1347 
150 156 196 197 229 273 283 357 404 472 551 636 648 666 757 804 843 902 903 904 905 919 922 954 996 997 1013 1047 1054 1087 1091 1232 1350 
81 99 181 183 184 185 199 284 315 373 374 519 524 586 657 837 838 852 874 886 887 926 1017 1074 1096 1099 1130 1131 1236 1280 1283 1351 
231 232 416 481 482 641 642 679 680 734 823 830 839 840 862 924 928 935 1019 1084 1098 1144 1147 1155 1161 1164 1165 1288 1304 1305 1331 
25 53 69 91 92 172 259 272 296 306 324 356 383 415 419 443 467 650 654 682 696 751 893 906 907 975 1038 1045 1178 1246 
120 138 257 312 313 338 375 444 499 522 548 594 633 670 690 711 789 934 938 967 1016 1062 1128 1166 1171 
3 23 85 86 139 370 581 591 638 710 737 942 1000 1009 1010 1026 1116 1173 1183 1185 1191 1195 1296 1297 
9 66 165 266 279 334 366 414 442 630 631 703 744 746 816 844 863 878 921 940 1055 1112 1192 
30 31 32 189 234 309 320 340 436 634 724 770 943 953 970 978 1070 1071 1187 1205 1213 1271 1310 
29 65 190 379 401 424 506 568 589 732 740 747 854 884 885 956 964 1059 1078 1152 1157 1277 
59 198 270 297 298 335 349 533 535 795 817 827 853 864 879 958 962 973 998 1148 1154 1321 
77 78 142 143 275 609 610 661 662 738 772 833 834 989 1021 1101 1151 1257 1264 1293 1337 1344 
227 228 237 289 403 418 539 671 704 825 932 933 945 1006 1022 1023 1048 1199 1314 
106 145 175 176 233 260 330 331 348 517 518 771 819 920 1018 1184 1208 1270 
364 399 420 505 513 687 974 994 1020 1064 1149 1193 1194 1227 1228 1240 1260 1276 
18 123 152 174 221 407 425 665 719 836 1181 1207 1218 1219 1223 
235 292 351 493 574 575 580 583 767 1113 1133 1209 1278 1345 
63 252 343 344 681 871 872 979 1037 1189 1217 1265 1301 
164 236 371 423 521 538 557 675 698 761 762 793 1141 
241 261 413 495 717 810 842 992 1027 1167 1224 1225 1243 
265 453 768 769 818 910 917 918 939 1179 1190 1274 
17 182 333 469 725 822 824 941 985 1119 1120 
52 169 226 550 716 730 831 949 950 1067 
159 449 450 455 554 592 927 1253 1267 1268 
285 341 347 408 430 593 595 649 688 
406 468 617 628 629 720 912 1137 1138 
89 90 94 222 278 361 604 1311 
168 422 685 829 955 1058 1121 1294 
310 311 483 500 562 655 882 965 
2 21 451 578 870 901 1143 
433 439 508 635 705 890 
97 244 410 1028 1032 
363 462 668 708 841 
540 1014 1176 1226 1285 
304 342 504 652 
