0 1 6 7 14 15 18 22 29 34 35 36 37 40 42 55 58 64 73 74 79 82 83 123 136 148 149 152 177 178 190 193 208 212 220 238 246 267 273 285 303 305 306 315 325 329 339 341 347 355 360 367 368 376 377 381 388 398 401 402 407 408 412 421 424 425 430 456 470 471 473 475 484 503 506 516 526 527 544 545 565 568 573 584 585 586 595 599 608 611 626 627 649 660 663 665 674 686 688 719 720 736 740 745 747 749 781 787 788 791 803 813 835 836 837 838 854 865 875 885 899 902 903 913 923 925 948 954 956 957 959 964 968 972 1025 1030 1047 1049 1059 1066 1076 1077 1078 1081 1090 1106 1152 1157 1198 1230 1236 1242 1247 1266 1273 1283 1303 1309 1332 1334 1348 1354 
48 56 57 105 125 127 128 137 141 154 157 160 162 170 171 188 191 192 214 216 225 239 264 268 281 288 295 299 300 328 337 386 387 391 393 397 428 434 437 452 460 477 480 486 487 496 501 512 528 534 536 537 542 546 552 564 567 571 593 600 601 602 612 613 616 623 624 656 691 692 709 713 715 718 750 758 775 777 785 801 809 867 884 911 937 966 969 1003 1056 1057 1068 1069 1103 1107 1108 1109 1124 1135 1156 1169 1177 1186 1204 1234 1241 1277 1290 1295 1299 1302 1306 1319 1346 
4 10 11 44 70 100 116 117 129 131 140 158 206 207 243 254 265 291 326 346 358 363 365 389 395 429 438 445 448 461 462 466 490 491 514 515 523 543 547 579 596 607 618 659 668 683 689 694 701 708 714 726 741 743 755 765 790 794 796 797 800 818 841 849 850 851 857 866 889 894 895 910 946 947 961 976 1005 1007 1015 1024 1034 1043 1046 1053 1061 1073 1085 1091 1092 1095 1102 1122 1123 1140 1163 1180 1196 1200 1216 1252 1256 1291 1307 1308 1333 1349 
2 8 12 19 21 27 47 72 93 94 122 124 134 144 179 202 213 248 253 263 316 317 318 319 327 345 353 372 378 394 426 427 431 435 451 476 478 502 553 558 559 563 566 572 578 590 605 632 637 639 658 669 699 722 739 742 764 766 778 783 792 798 821 845 855 856 870 901 915 931 936 980 987 1004 1031 1070 1079 1082 1094 1100 1114 1115 1142 1143 1166 1175 1244 1245 1254 1261 1272 1289 1300 1322 1323 1343 
13 20 41 46 54 65 75 96 110 111 112 118 119 135 155 167 195 200 204 205 224 249 250 255 256 266 308 321 349 354 361 362 379 380 392 404 474 511 541 570 581 589 594 598 615 619 643 644 645 673 676 710 721 723 728 732 757 773 786 804 811 815 843 951 952 977 995 996 997 1000 1002 1013 1042 1060 1087 1136 1170 1201 1206 1214 1232 1233 1325 1327 1328 1350 
9 63 66 76 95 97 98 101 115 151 153 165 174 201 215 219 234 244 252 279 304 307 314 334 342 344 366 369 382 384 409 410 414 442 443 504 509 510 561 621 630 631 652 677 678 703 744 746 756 772 799 816 828 844 863 868 869 871 872 878 883 898 940 991 1028 1029 1032 1037 1044 1051 1055 1088 1089 1111 1112 1148 1192 1202 1211 1255 1258 1263 1265 1281 1301 
231 232 359 364 399 406 416 420 449 450 455 468 481 482 505 513 554 592 617 628 629 641 642 679 680 681 687 711 712 734 805 806 823 830 839 840 862 912 924 927 928 935 974 993 994 1019 1020 1064 1084 1098 1137 1138 1144 1147 1149 1155 1158 1161 1164 1165 1182 1189 1193 1194 1227 1228 1240 1253 1260 1267 1268 1276 1288 1305 1331 1336 
5 33 38 45 77 87 108 126 133 161 163 173 180 221 227 228 237 289 290 293 294 301 302 336 352 403 418 432 454 463 530 532 539 556 577 640 693 697 704 707 738 759 763 784 802 814 820 833 834 897 909 932 933 944 945 971 983 988 1006 1022 1023 1048 1052 1117 1151 1199 1210 1257 1293 1315 1317 1320 1329 
30 49 50 53 218 235 241 261 292 350 351 413 464 479 493 495 507 555 574 575 580 583 588 696 717 727 767 810 812 842 873 881 975 978 986 992 1027 1033 1040 1071 1080 1086 1113 1129 1133 1150 1153 1187 1197 1205 1209 1224 1225 1237 1243 1248 1262 1275 1278 1284 1292 1310 1313 1316 1339 1340 1341 1345 
3 71 107 113 114 130 139 187 203 211 217 229 262 276 282 322 323 370 440 441 446 458 492 497 525 560 591 603 606 622 638 653 667 724 733 737 748 752 753 754 760 891 892 960 979 981 982 1009 1010 1026 1116 1132 1139 1173 1183 1185 1191 1217 1222 1238 1239 1282 1296 1297 
17 26 52 60 67 102 103 104 150 156 182 196 197 251 283 332 333 357 390 417 459 469 472 494 499 529 550 551 587 614 633 636 648 664 666 695 716 725 730 731 822 824 831 832 848 904 905 908 916 922 930 941 949 950 985 1054 1067 1119 1120 1212 1220 1221 1287 
25 68 91 92 121 147 166 168 169 172 194 226 259 272 296 324 343 356 383 400 415 422 467 485 520 650 654 682 685 751 774 829 880 893 906 907 955 1038 1039 1045 1058 1065 1083 1093 1110 1121 1145 1178 1181 1207 1218 1219 1223 1231 1246 1294 1311 1312 1318 1338 
23 59 69 85 86 106 145 175 176 198 210 233 260 269 270 297 298 309 335 348 419 533 535 569 771 795 817 819 827 853 864 879 914 942 958 962 963 973 998 1012 1063 1075 1105 1125 1154 1162 1167 1195 1208 1270 1321 
16 39 51 78 132 142 143 209 223 240 247 274 275 405 411 457 488 489 576 597 609 610 625 661 662 700 706 779 780 782 861 900 989 999 1021 1035 1036 1041 1072 1101 1118 1146 1188 1235 1264 1324 1337 1344 1347 
31 32 88 120 138 186 189 280 320 340 375 385 433 439 444 508 531 620 634 635 670 671 705 770 776 789 825 846 847 859 860 888 890 934 943 953 967 970 1062 1097 1171 1213 1229 1271 1314 
81 89 90 99 159 181 183 184 185 199 222 271 278 284 310 311 373 374 483 500 519 524 562 655 657 702 852 874 882 886 887 919 926 965 1017 1074 1096 1099 1130 1131 1280 1351 
24 43 80 146 230 242 245 257 258 277 286 287 338 498 548 549 582 604 684 729 807 808 858 921 929 1008 1159 1160 1168 1172 1215 1249 1269 1279 1298 
164 236 312 313 371 423 436 447 521 522 538 540 557 675 690 698 761 762 793 938 984 1014 1016 1104 1128 1141 1176 1226 1285 1342 
28 61 62 84 109 396 465 646 647 651 672 735 826 876 877 896 990 1001 1011 1050 1134 1203 1259 1286 1326 1330 1335 
453 768 769 917 918 939 1179 1190 1274 1304 
330 331 517 518 920 1018 1184 
