9 27 31 44 46 60 64 77 100 117 141 152 157 178 181 182 185 186 215 217 236 238 265 268 275 279 281 282 295 310 316 317 345 358 359 370 372 373 380 391 409 417 425 427 428 434 435 444 445 459 462 479 494 523 527 532 534 535 536 543 545 551 552 553 572 589 590 612 618 631 634 639 653 654 655 658 663 665 666 671 672 673 674 676 718 722 725 726 734 744 756 764 770 782 784 785 790 793 794 816 818 822 839 840 855 856 870 871 878 899 911 916 917 918 920 931 933 938 943 948 953 954 958 964 965 970 984 988 1019 1021 1024 1034 1053 1054 1066 1076 1091 1095 1096 1123 1128 1141 1148 1180 1181 1186 1196 1199 1200 1205 1218 1219 1225 1243 1244 1245 1247 1261 1271 1277 1293 1301 1304 1312 
1 12 13 22 23 32 34 36 40 42 43 53 55 59 66 69 86 87 93 94 111 119 130 148 149 156 165 174 189 195 208 212 219 220 234 235 245 250 252 255 257 258 259 269 272 277 278 280 296 303 305 306 308 309 320 322 325 327 339 340 349 350 352 353 355 360 361 362 366 374 381 388 392 403 406 410 414 421 433 438 440 467 468 475 501 502 503 504 508 513 515 516 526 570 573 575 588 591 594 599 600 604 606 608 619 626 627 635 645 649 780 792 817 845 854 863 867 875 877 891 908 909 936 937 960 979 997 1012 1023 1035 1058 1078 1081 1106 1147 1157 1162 1187 1213 1217 1238 1239 1260 1266 1273 1282 1309 1315 1331 1332 1334 1348 
47 48 56 61 62 73 106 109 115 140 147 176 188 191 224 233 237 260 266 313 348 393 394 404 408 416 418 419 431 432 436 447 458 460 471 485 487 512 539 542 584 614 624 646 647 648 651 656 696 701 715 721 723 742 757 771 800 803 805 806 808 809 823 826 841 868 874 876 879 880 894 895 896 905 932 946 969 974 990 996 1001 1006 1011 1039 1065 1068 1077 1079 1082 1083 1100 1108 1112 1124 1134 1135 1177 1203 1207 1208 1223 1233 1234 1246 1259 1263 1270 1275 1276 1286 1290 1302 1306 1313 1326 1328 1330 1335 1336 1339 
4 20 21 30 33 65 70 88 97 112 124 129 134 135 155 158 169 172 180 204 239 244 256 261 263 271 288 291 294 301 302 323 334 354 356 368 379 395 413 429 499 505 520 598 615 636 687 693 711 724 732 735 737 765 778 789 802 804 842 881 889 901 922 923 934 941 998 1008 1020 1032 1070 1073 1093 1114 1143 1154 1158 1167 1183 1189 1195 1198 1228 1231 1252 1278 1300 1325 
5 7 10 11 26 39 75 76 81 82 83 92 126 132 133 138 142 143 161 162 163 206 223 285 307 329 336 347 371 383 390 396 397 400 457 464 474 477 488 489 500 556 559 569 578 581 582 593 595 601 625 688 694 698 704 707 728 759 763 779 795 820 835 859 897 945 947 951 980 1041 1050 1060 1067 1104 1118 1122 1129 1131 1145 1159 1206 1317 1329 1337 1342 1347 1349 
0 18 37 38 51 52 68 104 146 170 221 227 287 293 338 363 367 442 448 495 498 548 549 583 609 640 670 682 697 713 714 738 758 786 787 788 814 858 893 919 971 978 992 1018 1022 1048 1052 1087 1098 1099 1115 1117 1146 1214 1220 1237 1249 1253 1254 1267 1268 1280 1295 
3 19 67 101 102 113 114 167 168 179 202 251 264 324 375 382 384 385 415 463 525 561 562 650 652 691 749 813 843 906 907 940 957 994 1029 1044 1045 1046 1059 1085 1088 1089 1281 
57 128 137 144 145 166 171 230 248 318 420 426 437 476 478 486 530 540 563 564 566 602 616 623 692 710 914 915 987 1107 1142 1168 1170 1194 1226 1241 1285 1289 1310 
107 108 183 184 187 203 228 247 284 298 332 337 346 389 461 550 558 611 613 630 709 733 754 825 833 834 860 981 1036 1069 1130 1150 1151 1171 1204 1236 1257 1314 
45 96 120 231 232 378 446 496 507 528 622 633 638 679 680 708 746 747 748 752 773 815 892 1113 1155 1160 1164 1165 1173 1193 1209 1210 1224 1288 1305 
41 72 89 90 103 222 497 522 524 541 637 675 705 706 774 849 882 904 961 982 1031 1121 1140 1166 1175 1229 1232 1264 1311 1322 1323 1344 1350 1351 
136 139 164 193 194 312 469 470 511 521 657 690 810 827 972 1009 1010 1014 1026 1027 1049 1055 1074 1080 1086 1116 1156 1163 1185 1191 1296 1297 
84 85 153 154 201 210 225 226 300 369 386 412 473 506 702 750 942 956 962 963 1003 1047 1056 1063 1075 1169 1258 1265 1269 1321 1346 
118 121 192 211 216 229 253 283 290 331 411 441 452 480 560 568 586 587 605 731 753 755 864 883 975 1000 1005 1103 1212 1318 
24 110 175 321 330 517 518 529 546 664 684 685 740 781 884 885 929 930 952 955 977 999 1215 1279 1298 1307 1308 
28 50 71 465 592 677 678 769 777 862 873 927 939 976 1033 1061 1092 1132 1153 1176 1190 1197 1274 1284 1316 1340 1341 
35 177 205 314 333 424 472 519 547 585 660 668 686 689 852 886 887 959 985 991 1179 1201 1216 1327 1338 1354 
2 54 207 209 246 249 311 315 364 514 643 644 681 811 812 819 837 838 848 857 900 1182 1188 1283 1324 
25 63 91 213 214 273 299 328 537 610 629 729 798 801 807 869 872 898 903 1016 1037 1038 1094 1202 1319 
159 262 342 422 576 695 700 716 719 720 730 772 831 832 926 950 966 993 1015 1057 1111 1138 1222 1248 
6 29 74 123 190 197 357 376 401 449 450 555 579 607 632 727 921 1002 1043 1184 1256 1320 
16 17 78 98 127 243 274 326 405 423 439 453 454 557 683 699 768 910 944 1004 1028 1235 
79 276 292 430 443 493 574 580 661 662 767 836 890 986 989 1072 1101 1110 1133 1221 1287 1345 
80 131 173 286 387 531 620 717 776 846 847 888 967 1062 1097 1149 1192 
8 99 198 199 270 289 297 335 399 533 628 973 1017 1064 1172 1227 
196 254 482 483 554 641 642 829 830 924 928 1042 1084 1105 1144 1178 
105 116 398 455 456 466 490 741 775 844 1040 1071 1137 1333 
14 15 267 341 565 743 913 968 1025 1090 1230 1242 1303 
218 304 407 617 669 736 821 861 995 1102 1125 1272 1294 
240 241 242 492 544 567 824 912 1013 1119 1120 1152 1211 
58 95 122 200 484 667 703 745 865 983 1136 1139 
319 365 491 571 596 597 659 766 783 1051 1161 
160 402 712 791 866 925 1007 1030 
351 621 853 902 935 1240 1262 1292 
125 150 151 377 949 1109 1255 
343 344 481 538 577 751 760 
509 510 739 799 828 1299 1343 
49 451 603 761 762 
796 797 850 851 1291 
