32 48 56 57 71 105 127 128 137 141 157 160 162 167 170 171 188 191 192 225 239 264 268 281 288 299 300 328 368 391 393 397 409 434 437 446 460 477 486 487 496 497 501 512 520 528 529 530 536 537 542 552 556 561 562 564 567 571 593 600 601 602 612 613 616 623 624 656 657 664 691 692 695 713 714 715 718 748 750 775 777 785 801 809 884 891 892 911 930 947 966 969 979 991 1003 1029 1057 1068 1107 1108 1109 1115 1124 1135 1140 1156 1169 1171 1177 1211 1217 1234 1241 1254 1277 1281 1290 1295 1299 1302 1306 1317 1319 1343 1346 
3 10 11 13 20 23 37 46 54 65 82 85 86 87 96 97 111 112 118 119 124 135 155 161 172 195 200 204 205 206 207 249 250 255 256 303 308 321 349 355 361 366 367 379 380 410 428 429 447 448 502 511 544 570 581 589 591 615 619 621 638 643 644 645 693 694 710 721 728 732 737 741 744 765 786 792 796 797 804 811 827 850 851 857 909 942 951 952 961 977 984 986 995 997 998 1000 1015 1042 1064 1077 1104 1122 1146 1154 1159 1160 1168 1173 1183 1195 1201 1206 1231 1244 1245 1261 1300 1308 1321 1325 1342 1349 
6 7 22 25 29 35 40 53 55 58 67 68 69 73 74 79 121 136 148 149 177 190 193 246 259 296 306 309 325 329 356 376 377 383 401 402 412 419 424 456 467 470 473 484 485 503 506 516 527 545 546 547 568 585 604 607 660 663 686 696 740 745 749 751 781 832 844 854 865 875 885 893 899 908 923 956 959 975 1007 1012 1030 1038 1039 1049 1059 1066 1078 1106 1125 1145 1152 1157 1162 1178 1220 1247 1249 1266 1273 1307 1309 1318 1334 1348 1354 
8 12 27 47 72 93 122 187 202 203 211 213 217 229 248 253 262 263 317 318 319 345 353 372 378 426 435 440 441 476 478 492 540 560 563 566 572 590 605 622 632 637 639 658 669 689 699 739 753 754 764 766 778 783 798 821 845 855 856 866 894 895 915 931 936 980 981 987 996 1004 1031 1082 1094 1114 1142 1175 1272 1289 1322 1323 
0 1 15 34 36 42 64 83 115 169 174 178 208 212 220 226 238 267 272 285 305 327 341 347 360 381 388 398 408 421 430 475 526 573 584 588 595 599 606 608 626 627 649 652 674 688 726 736 787 788 795 803 864 879 948 957 962 963 968 1025 1058 1081 1090 1112 1198 1230 1294 1303 1332 
4 44 70 100 116 117 129 130 131 140 254 265 291 316 326 346 438 445 466 471 490 514 515 523 541 543 554 618 671 743 755 790 794 800 818 825 829 849 889 910 927 946 964 976 1005 1024 1032 1034 1043 1046 1053 1085 1092 1095 1102 1123 1176 1180 1200 1202 1238 1239 1252 1314 1333 
30 49 50 218 235 241 261 273 292 350 351 404 413 464 495 574 575 580 724 757 767 810 812 842 843 902 903 919 954 978 992 1013 1027 1040 1047 1070 1071 1076 1086 1091 1113 1129 1133 1167 1187 1197 1205 1224 1225 1232 1237 1243 1248 1275 1310 1313 1339 1345 1350 
26 39 51 60 78 142 143 181 223 240 271 274 315 332 390 417 459 586 587 597 614 661 662 731 747 837 838 848 916 941 989 1067 1072 1080 1101 1163 1212 1235 1264 1283 1337 1347 
14 231 232 359 364 370 399 420 482 505 513 565 596 641 642 687 734 830 839 840 853 862 913 924 928 935 974 993 994 1019 1020 1050 1084 1144 1149 1193 1194 1228 1240 1242 1260 
107 113 114 184 276 282 322 323 336 337 396 458 525 583 603 611 653 667 709 717 733 752 759 760 960 982 1069 1130 1132 1139 1204 1222 1236 1278 1282 1329 
63 134 144 153 201 210 219 252 269 304 342 344 365 427 443 504 569 681 701 742 869 871 872 898 1037 1051 1063 1075 1100 1105 1182 1189 1196 1301 
28 61 62 84 109 465 646 647 651 672 735 805 806 826 868 876 877 896 990 1001 1011 1134 1158 1203 1259 1263 1286 1326 1330 1335 1336 
31 189 221 227 228 234 237 289 320 340 403 418 539 634 704 770 835 897 932 933 943 945 953 970 1006 1022 1023 1048 1199 1213 1271 
106 145 165 175 176 233 260 266 275 334 348 414 442 609 610 630 631 703 746 771 816 819 863 878 914 940 1021 1055 1073 1208 1270 
186 385 452 479 480 493 507 509 510 534 555 677 678 727 799 828 860 873 881 1033 1150 1153 1186 1209 1262 1284 1292 1316 1340 1341 
41 66 75 76 101 215 307 314 369 382 384 712 756 791 813 883 925 972 1002 1044 1087 1088 1089 1188 1192 1214 1258 1327 
59 150 156 196 197 198 270 297 298 335 357 494 499 533 535 550 551 633 636 648 817 904 905 958 973 1148 1265 
5 33 45 110 133 158 224 301 302 354 362 474 531 577 579 598 673 676 723 815 820 1060 1170 1233 1256 
120 138 139 257 338 375 392 444 548 594 670 789 934 967 1009 1010 1026 1062 1116 1185 1191 1296 1297 
16 102 103 104 132 251 405 411 457 488 489 576 625 700 779 780 861 1035 1041 1118 1221 1287 
38 77 108 173 180 352 431 432 532 738 784 802 833 834 983 988 1052 1061 1151 1257 1293 1315 
81 99 159 183 199 284 373 374 519 659 702 852 874 886 887 926 1017 1074 1096 1099 1131 1280 
19 126 163 179 290 293 294 400 463 553 640 697 707 722 763 773 814 971 1117 1136 1210 
91 92 147 343 422 559 654 682 685 774 880 906 907 955 1045 1065 1083 1110 1246 1338 
164 166 194 312 313 423 469 521 522 557 690 761 762 793 938 1014 1016 1093 1128 1285 
18 123 146 152 287 358 407 425 665 719 836 867 1181 1207 1218 1219 1223 1312 1328 
24 43 80 230 242 245 277 286 684 729 807 808 858 921 929 1008 1172 1215 1298 
154 280 386 387 433 439 508 620 635 705 776 846 847 859 888 890 1056 1229 
9 17 98 243 244 279 310 311 389 454 461 683 944 1028 1216 1291 
88 395 406 468 491 617 628 629 711 720 912 1097 1137 1138 
339 416 449 450 455 481 592 823 1098 1147 1161 1226 1227 1320 
182 283 333 472 666 725 822 824 922 985 1054 1119 1120 
52 95 125 151 716 730 772 831 949 950 1111 1255 
679 680 1155 1164 1165 1253 1267 1268 1288 1305 1331 
89 90 168 185 222 278 524 1121 1311 1351 
453 768 769 917 918 939 1179 1190 1274 1304 
2 21 451 578 870 901 1143 1166 1276 
209 247 558 782 900 999 1036 1324 
236 371 436 538 675 698 1141 
330 331 517 518 920 1018 1184 
483 500 655 706 882 965 1344 
94 324 394 415 650 1079 
214 216 295 758 937 1103 
258 498 549 582 1269 1279 
363 462 668 708 841 
