1 12 13 22 23 32 34 36 37 40 42 43 59 63 66 69 86 87 88 93 94 111 119 142 143 148 149 155 165 189 195 208 212 219 220 234 235 245 250 255 256 257 269 277 278 280 291 296 303 305 306 308 309 320 322 325 327 339 340 349 350 352 353 354 355 360 361 362 366 374 381 388 392 403 406 414 421 433 440 457 467 468 475 489 501 502 503 504 508 513 516 526 529 570 573 575 588 591 594 599 600 604 608 619 625 626 627 635 645 647 649 664 724 765 770 780 792 817 845 867 875 877 909 930 936 937 953 960 979 997 1023 1033 1035 1037 1041 1070 1081 1085 1094 1106 1147 1162 1187 1213 1217 1260 1266 1273 1276 1282 1309 1315 1326 1331 1332 1334 1337 1348 
0 18 38 57 68 79 104 144 145 146 166 174 230 237 242 248 254 272 287 293 318 338 367 405 420 437 441 442 443 482 483 495 498 530 544 548 549 563 566 574 580 583 602 606 609 640 641 642 670 682 697 710 713 758 786 787 814 829 830 869 891 893 908 914 915 919 924 928 971 978 987 1012 1018 1022 1046 1062 1084 1105 1110 1117 1133 1144 1168 1181 1194 1206 1211 1214 1218 1219 1220 1238 1239 1241 1253 1267 1268 1278 1280 1287 1310 1312 
4 10 26 30 31 33 47 51 52 67 70 97 126 133 135 147 152 158 167 172 180 204 207 221 227 271 274 288 294 295 301 302 323 326 334 356 359 394 395 423 429 431 439 453 454 461 471 497 523 598 636 687 693 699 707 757 764 778 794 798 802 808 820 859 879 880 889 899 910 944 951 985 992 1008 1028 1032 1048 1065 1073 1082 1083 1087 1093 1146 1175 1195 1235 1252 1305 1317 
44 64 124 178 183 184 185 186 265 317 337 358 372 373 401 445 448 450 462 479 515 518 532 543 551 613 618 630 631 665 666 674 722 726 768 782 784 790 793 795 818 822 855 858 868 916 920 921 933 943 948 954 964 965 970 980 988 1034 1043 1053 1054 1066 1076 1091 1095 1112 1123 1130 1134 1141 1180 1189 1196 1199 1200 1205 1246 1247 1263 1271 
5 48 56 106 115 118 176 188 191 206 224 233 260 264 313 348 393 408 416 418 419 432 458 460 499 500 512 542 584 595 603 624 648 656 696 701 714 715 721 742 771 796 797 803 809 824 827 851 905 946 947 969 974 996 1068 1079 1119 1120 1124 1135 1177 1208 1223 1233 1234 1259 1270 1275 1290 1302 1306 1313 1339 
7 55 75 81 82 83 129 132 138 153 218 284 285 307 336 347 375 383 390 391 396 397 400 430 474 488 556 569 578 581 582 593 601 652 669 673 688 728 748 759 835 881 890 906 907 934 945 957 995 1044 1045 1050 1060 1072 1102 1125 1131 1136 1159 1171 1186 1328 1329 
16 17 19 53 98 130 160 161 179 190 215 239 243 244 252 261 276 310 311 402 410 413 438 459 493 494 552 562 589 654 655 661 662 709 744 756 788 810 823 836 842 850 897 918 925 932 958 967 986 989 1030 1036 1069 1080 1086 1098 1101 1204 1221 1291 1295 
6 35 74 80 107 108 123 139 164 173 177 187 203 228 247 298 314 315 332 333 389 424 476 519 521 550 585 643 668 686 727 733 754 852 860 874 878 886 887 922 959 981 991 1002 1009 1010 1026 1027 1055 1116 1185 1191 1264 1296 1297 1344 
24 49 89 90 136 222 345 426 427 451 452 517 590 637 658 671 684 685 704 761 762 779 781 825 856 884 885 929 952 977 999 1121 1140 1142 1215 1277 1279 1298 1307 1308 1311 1314 1322 1323 
61 62 73 113 114 131 168 196 202 251 266 286 324 376 404 464 477 525 554 614 615 646 651 723 737 800 876 896 990 1001 1011 1042 1058 1077 1100 1103 1114 1129 1178 1207 1318 1330 1335 
25 39 78 91 127 128 137 154 171 213 214 223 225 273 328 386 486 537 564 610 616 623 629 683 692 729 801 807 898 903 1003 1014 1016 1038 1056 1107 1108 1202 1225 1258 1319 1347 
3 29 76 217 299 357 369 382 384 385 478 491 540 555 561 579 632 650 725 734 749 750 799 843 927 1019 1020 1051 1088 1089 1170 1176 1184 1226 1256 1265 1285 1304 1346 
9 20 21 46 125 134 141 238 259 268 275 279 281 409 415 425 428 434 444 527 534 539 545 634 653 672 718 735 785 901 1096 1143 1183 1198 1210 1231 1325 
159 182 192 193 282 290 312 331 346 411 469 470 511 568 605 690 731 755 789 833 834 864 883 938 941 972 975 1000 1049 1074 1150 1151 1156 1212 1257 1289 1300 
2 54 101 170 209 246 249 363 364 435 463 480 514 558 644 681 691 711 712 805 806 811 812 813 819 848 857 940 994 1029 1158 1182 1281 1336 
45 72 96 120 231 232 378 446 496 507 528 622 633 638 679 708 746 747 752 763 773 815 816 863 892 1113 1160 1173 1193 1209 1224 1244 1245 1261 
28 50 71 449 465 557 592 612 677 678 769 777 791 862 866 873 911 939 976 1007 1061 1092 1132 1153 1190 1197 1227 1274 1284 1316 1320 1340 1341 
84 85 201 210 300 368 387 412 473 506 520 531 620 702 717 776 846 847 888 942 962 963 1047 1052 1063 1075 1097 1149 1192 1269 1321 
14 15 267 341 535 536 565 611 743 853 871 872 913 968 998 1004 1024 1025 1090 1148 1154 1167 1230 1236 1242 1262 1292 1301 1303 
41 103 181 197 522 524 541 660 675 705 706 774 849 882 904 961 982 1021 1031 1166 1216 1229 1232 1243 1350 1351 1354 
102 240 241 319 492 509 510 567 739 740 766 828 854 912 956 1013 1059 1078 1115 1152 1157 1254 1299 1343 
162 262 342 351 576 621 700 719 720 738 772 902 926 935 966 993 1111 1138 1222 1240 1248 
99 198 199 270 297 335 343 344 399 481 533 538 577 628 751 760 973 1017 1064 1172 
11 258 292 371 472 547 607 694 698 767 917 1104 1122 1145 1163 1179 1342 1345 1349 
92 105 116 398 455 456 466 490 559 741 775 844 1040 1071 1099 1137 1203 1286 1333 
58 95 122 200 329 484 667 703 745 865 900 983 1139 1188 1237 1249 1324 
140 205 436 447 485 689 841 894 895 955 1006 1039 1201 1327 1338 
422 586 587 695 716 730 831 832 837 838 950 1015 1057 1228 1283 
8 27 60 100 163 289 316 417 572 639 839 840 870 
109 150 151 370 377 380 487 676 826 984 1109 1118 1255 
117 121 211 216 229 253 283 553 560 753 931 1005 
156 157 236 663 680 1128 1155 1164 1165 1288 
65 194 263 379 505 657 732 804 923 
304 407 617 736 821 861 1272 1294 
77 110 175 321 330 546 1293 
365 571 596 597 659 783 1161 
112 169 226 949 1067 1169 
