1 12 13 22 23 32 34 36 40 42 43 53 55 63 66 69 86 87 88 93 94 111 119 148 149 165 169 174 189 195 208 212 219 220 234 235 245 250 252 255 256 257 259 269 277 278 280 296 303 305 306 308 309 320 322 325 327 339 340 349 350 352 353 354 355 360 361 362 366 374 381 388 392 403 406 414 421 433 438 468 475 501 502 503 504 508 513 515 516 526 570 573 588 591 594 599 600 606 608 619 626 627 645 649 792 817 845 863 867 871 872 875 877 908 909 936 937 957 960 979 997 1023 1058 1081 1094 1097 1106 1147 1162 1187 1213 1217 1260 1266 1273 1282 1315 1331 1332 1348 
48 56 118 167 191 206 233 393 418 460 499 500 542 624 648 656 673 714 715 723 726 742 803 809 920 946 947 969 996 1000 1060 1079 1124 1135 1177 1223 1233 1234 1290 1302 1306 1328 
2 8 57 128 137 144 145 171 248 318 420 426 437 476 478 486 530 540 563 564 566 616 623 692 710 914 915 987 1107 1142 1170 1194 1206 1241 1289 1310 
44 100 117 178 185 265 317 372 373 445 543 618 665 666 674 782 784 790 818 916 933 954 970 988 1034 1053 1066 1076 1091 1123 1141 1200 1205 1237 1243 1271 
20 21 31 46 141 160 238 268 275 409 425 428 434 527 545 634 653 672 718 785 839 840 856 899 901 931 953 1096 1143 1183 1325 
26 30 33 97 124 135 155 158 172 204 207 271 301 302 395 429 598 636 687 693 737 765 778 859 889 998 1020 1073 1154 1189 1317 
3 76 154 225 226 369 382 384 385 386 387 531 561 589 749 750 776 843 846 860 967 1003 1029 1056 1088 1089 1169 1258 1281 1346 
75 81 82 83 132 284 285 307 347 457 464 477 488 489 569 593 595 601 625 688 795 1041 1118 1129 1131 
7 138 288 336 390 396 397 474 556 578 581 582 728 748 759 951 980 1159 1329 
10 126 162 163 180 237 290 294 334 400 539 704 707 763 779 932 945 1093 1210 
19 179 215 310 311 459 494 552 562 590 654 655 744 756 917 918 1304 
25 91 213 214 273 299 328 329 467 484 536 537 610 729 903 1319 
146 152 287 295 358 359 394 462 523 757 764 794 1181 1218 1219 1312 
14 15 267 565 571 596 597 913 968 1004 1025 1090 1230 1242 1303 
106 176 188 224 260 313 348 419 512 771 974 1068 1208 1270 1275 
139 164 469 470 511 521 690 1014 1016 1026 1027 1055 1116 1285 
84 85 153 201 300 412 473 506 702 942 956 1075 1321 
0 37 104 258 338 367 498 548 549 583 609 978 
45 378 446 496 528 622 746 747 752 773 815 1173 
105 116 398 455 466 490 741 775 844 1071 1137 1333 
254 482 483 641 642 829 830 924 928 1084 1105 1144 
24 240 684 685 781 929 955 1215 1279 1298 
47 147 471 798 808 879 880 1065 1082 1083 
54 246 249 644 681 811 812 848 857 1182 
68 383 440 604 640 670 893 971 1022 1214 
107 108 187 203 550 611 733 754 981 1236 
524 675 774 849 961 1166 1229 1232 1350 1351 
567 740 824 854 912 1078 1119 1120 1152 1157 
198 270 297 298 335 533 535 958 973 
493 661 662 836 847 986 989 1101 1221 
534 677 678 777 862 873 976 1033 1153 
646 805 806 868 1134 1246 1263 1335 1336 
6 29 190 376 424 585 607 686 
27 60 281 332 391 417 444 870 
51 52 221 227 1006 1048 1087 1146 
92 324 343 559 682 906 907 1045 
96 231 232 507 633 638 1209 1238 
98 243 423 439 454 557 944 1028 
140 436 447 485 841 894 895 1039 
211 216 229 283 441 560 753 1103 
261 413 717 724 810 842 1070 1167 
293 442 495 697 758 814 992 1117 
11 222 529 664 694 930 1145 
18 713 788 1098 1115 1254 1295 
35 314 660 689 1216 1220 1354 
95 122 667 703 745 865 983 
103 541 705 706 882 1031 1226 
319 365 435 659 766 783 1161 
323 402 712 791 925 1030 1049 
509 510 739 799 828 1299 1343 
629 801 807 869 898 1038 1202 
679 680 1155 1164 1165 1288 1305 
16 17 78 274 405 1235 
39 142 223 1067 1225 1347 
61 62 876 896 1259 1330 
65 263 379 732 804 1114 
73 266 404 651 800 1077 
89 90 637 1121 1140 1311 
101 375 652 813 835 1044 
186 793 822 964 1054 1199 
192 331 731 755 975 1212 
264 416 696 721 823 1108 
279 816 878 1244 1245 1261 
289 399 1017 1064 1172 1227 
292 574 767 1110 1133 1345 
357 555 579 632 1184 1256 
371 698 1104 1122 1342 1349 
769 939 1190 1274 1284 1316 
853 902 935 1240 1262 1292 
1009 1010 1185 1191 1296 1297 
59 575 635 780 1035 
110 175 330 517 518 
120 708 1113 1160 1193 
130 891 892 1224 1239 
136 193 972 1074 1156 
218 669 995 1102 1125 
272 356 415 443 650 
315 643 837 838 1283 
342 427 576 1222 1248 
346 671 825 1150 1314 
351 772 966 993 1111 
407 617 861 1272 1294 
408 431 432 701 905 
411 568 864 883 1287 
612 613 630 911 1171 
620 621 695 716 832 
770 943 948 1021 1247 
796 797 850 851 1291 
884 885 952 977 999 
28 50 71 465 
41 522 904 982 
58 200 1136 1139 
64 532 631 1192 
70 112 129 615 
74 123 727 1002 
113 114 202 525 
121 253 1005 1318 
134 735 1198 1231 
151 949 1109 1255 
159 262 926 1138 
196 554 1042 1178 
205 1201 1327 1338 
209 900 1188 1324 
210 491 1051 1063 
228 247 558 1036 
239 602 1069 1277 
242 544 1012 1211 
370 380 676 984 
452 479 480 605 
463 691 940 994 
519 852 886 887 
647 1050 1276 1326 
730 950 1015 1057 
833 834 1151 1257 
962 963 1047 1269 
1037 1148 1265 1301 
5 133 820 
38 738 1052 
49 603 762 
67 168 251 
72 497 1175 
79 580 1278 
80 173 802 
99 199 628 
109 487 826 
131 286 1249 
156 244 410 
157 855 1128 
161 897 1320 
166 230 1168 
170 363 364 
177 668 959 
182 282 725 
183 184 1130 
194 657 827 
197 291 922 
217 734 1019 
241 492 1013 
304 736 821 
316 572 639 
333 985 991 
337 709 1204 
344 538 577 
368 520 1024 
401 921 1043 
430 890 1072 
449 592 1061 
453 768 910 
472 547 1179 
553 722 1196 
700 719 720 
789 941 1300 
874 990 1011 
881 923 934 
1008 1032 1252 
1018 1099 1280 
