1 12 13 20 22 23 32 34 36 37 40 42 43 53 55 59 63 66 69 86 87 88 93 94 111 119 142 143 148 149 155 165 189 195 208 212 219 220 234 235 245 250 255 256 257 259 269 277 278 280 296 303 305 306 308 309 320 322 325 327 339 340 349 350 352 353 355 360 361 362 366 374 381 388 392 403 406 414 415 421 433 440 457 467 468 475 489 501 502 503 504 508 513 515 516 526 570 573 575 586 588 591 594 599 600 604 608 619 626 627 635 645 647 649 724 765 770 780 792 798 817 845 867 872 875 877 909 936 937 945 953 960 979 997 1023 1033 1035 1037 1041 1050 1070 1081 1085 1094 1106 1134 1147 1162 1186 1187 1189 1213 1260 1266 1273 1276 1282 1309 1315 1325 1326 1331 1332 1334 1337 1348 
48 56 61 62 67 73 106 109 115 118 131 140 167 168 176 188 191 196 202 206 224 233 251 260 266 286 292 313 348 376 393 400 404 416 418 419 436 447 458 460 464 477 485 499 500 512 520 542 554 561 584 603 614 624 634 646 648 651 656 689 696 704 714 715 721 723 726 742 771 779 800 803 809 841 876 894 895 896 906 907 920 946 947 957 969 974 990 996 1001 1006 1011 1029 1039 1042 1045 1058 1068 1077 1079 1100 1124 1129 1135 1177 1178 1207 1208 1223 1234 1259 1270 1275 1281 1286 1290 1302 1306 1313 1318 1330 1335 1339 
8 27 44 46 60 64 77 100 124 141 163 178 182 185 186 236 238 264 265 268 275 281 289 316 317 372 373 391 401 409 417 425 427 428 434 444 445 450 462 479 527 532 534 543 545 551 572 613 618 630 631 639 653 663 665 666 672 718 722 768 782 784 785 790 793 818 822 839 840 868 870 916 921 933 943 948 954 964 965 970 980 988 1034 1043 1053 1054 1066 1076 1091 1095 1096 1112 1123 1141 1180 1196 1199 1200 1205 1210 1246 1247 1263 1271 1293 
0 18 38 54 57 68 79 104 113 114 144 145 146 166 230 237 242 254 272 287 293 318 324 338 367 405 420 437 443 448 478 482 483 495 498 525 530 544 548 549 563 566 574 580 583 602 606 609 640 641 642 670 682 697 710 713 786 787 795 829 830 848 858 869 891 893 908 915 919 924 928 971 978 987 1012 1018 1022 1046 1062 1084 1105 1110 1117 1133 1144 1168 1181 1194 1206 1211 1214 1218 1219 1220 1238 1239 1241 1253 1267 1268 1278 1280 1310 1312 
4 5 10 26 30 31 33 47 51 52 70 97 126 129 133 135 147 158 172 174 180 204 207 227 248 271 274 288 294 298 301 302 334 356 358 394 395 408 429 432 442 453 454 461 471 497 589 595 598 615 636 674 687 693 701 707 737 758 802 808 814 820 827 859 879 880 889 899 905 910 944 951 967 992 1008 1032 1048 1065 1073 1082 1083 1087 1093 1103 1114 1146 1175 1195 1233 1235 1243 1252 1305 1317 
9 16 17 19 21 98 125 130 152 160 161 179 190 215 221 239 243 244 252 276 279 295 310 311 323 326 359 402 410 423 426 431 435 438 439 459 493 494 523 539 552 557 558 562 590 654 655 661 662 699 744 756 757 764 778 788 794 836 850 862 866 897 901 918 932 958 986 989 1007 1028 1030 1036 1069 1080 1098 1101 1142 1143 1183 1221 1237 1277 1287 1291 1295 
6 35 74 80 107 108 123 139 164 173 177 187 203 209 228 246 247 249 284 314 315 329 332 333 383 389 424 476 484 519 550 585 643 668 681 686 727 733 754 811 812 837 838 852 857 860 865 874 878 886 887 900 959 981 985 991 1002 1009 1010 1026 1027 1055 1116 1185 1188 1191 1249 1264 1283 1296 1297 1324 1344 
24 117 121 136 159 192 193 211 216 229 253 283 290 291 312 331 346 369 411 441 452 469 470 511 517 521 529 553 560 568 605 664 671 690 731 753 755 781 789 825 833 834 856 864 883 922 929 930 931 938 941 972 975 1000 1003 1005 1038 1049 1074 1150 1151 1156 1212 1215 1257 1265 1289 1300 1307 1308 1314 
7 75 81 82 83 132 138 153 205 218 285 304 307 336 347 354 375 390 396 397 430 474 488 556 569 578 581 582 593 601 625 652 669 673 688 728 748 759 835 890 955 995 1044 1060 1072 1102 1125 1131 1159 1201 1327 1328 1329 1338 
101 162 170 262 342 351 363 364 422 463 480 576 587 621 691 695 700 716 719 720 730 738 772 813 831 832 902 926 935 940 950 966 993 994 1015 1057 1111 1138 1182 1217 1222 1228 1240 1248 1256 
45 72 96 120 231 232 378 446 496 507 528 622 633 638 679 708 711 712 746 747 752 763 773 805 806 815 816 863 892 1113 1158 1160 1173 1193 1209 1224 1244 1245 1261 1336 
3 29 76 217 261 357 382 384 385 413 491 509 510 518 555 579 632 650 725 734 749 799 810 828 842 843 917 927 1019 1051 1086 1088 1089 1170 1176 1184 1285 1304 
25 78 89 90 91 154 213 214 222 225 273 299 328 386 537 610 637 684 685 729 884 885 903 952 977 999 1014 1016 1056 1121 1140 1258 1279 1298 1311 1319 1322 1323 
14 15 183 184 267 337 341 535 536 565 611 709 743 750 853 871 913 968 998 1004 1024 1025 1090 1130 1148 1154 1167 1169 1204 1230 1236 1242 1262 1292 1301 1303 1346 
84 85 201 210 282 300 407 412 473 506 531 617 702 736 821 823 861 914 925 942 956 962 963 1047 1052 1063 1075 1269 1272 1294 1321 
41 103 181 197 522 524 540 541 660 675 705 706 774 849 882 904 961 982 1021 1031 1166 1216 1226 1229 1232 1350 1351 1354 
28 50 71 449 465 592 612 769 777 791 873 911 939 976 1061 1092 1132 1153 1190 1197 1227 1274 1284 1316 1320 1340 1341 
102 240 241 319 492 567 739 740 766 796 797 824 851 854 912 1013 1059 1078 1115 1119 1120 1152 1157 1254 1299 1343 
39 127 128 137 171 223 486 564 616 623 629 683 692 801 807 898 1020 1107 1108 1202 1225 1347 
99 198 199 270 297 335 343 344 399 481 533 538 577 628 751 760 973 1017 1064 1172 
2 49 110 134 175 321 330 345 451 514 546 644 658 735 761 762 819 1198 1231 
92 105 116 398 455 456 466 490 559 741 775 844 1040 1071 1099 1137 1203 1333 
11 258 371 472 547 607 694 698 767 1104 1122 1145 1163 1179 1342 1345 1349 
368 387 620 677 678 717 776 846 847 888 1097 1149 1192 
65 194 263 379 505 657 732 804 881 923 934 1171 
150 151 370 377 380 487 676 826 984 1109 1118 1255 
58 95 122 200 667 703 745 983 1136 1139 
156 157 680 855 1128 1155 1164 1165 1288 
365 571 596 597 659 783 1161 
112 169 226 949 1067 
