6 7 16 24 25 34 35 40 41 58 67 73 74 76 80 81 84 85 113 123 132 142 147 148 150 157 168 169 177 190 201 227 232 291 292 314 315 328 329 344 346 366 382 384 401 402 408 412 422 424 464 466 484 488 509 515 516 519 524 531 535 545 546 547 555 567 568 574 575 584 585 586 593 607 612 613 629 630 657 663 667 668 675 686 689 700 713 738 739 740 741 745 758 775 779 780 788 790 791 792 793 807 832 836 837 838 843 844 846 854 865 874 875 881 883 885 886 900 902 911 948 955 956 967 986 994 1006 1011 1012 1013 1024 1032 1054 1058 1059 1078 1085 1089 1094 1100 1102 1109 1111 1115 1117 1118 1124 1125 1131 1149 1152 1157 1162 1166 1171 1175 1179 1193 1197 1202 1220 1232 1236 1240 1244 1245 1252 1254 1260 1261 1271 1273 1283 1294 1295 1299 1324 1327 1332 1333 1338 1343 1344 1350 1351 
0 1 12 13 22 23 32 36 37 42 43 44 48 53 55 59 63 64 65 66 75 79 83 86 87 88 93 94 108 111 112 174 189 195 200 208 212 218 219 220 234 235 242 245 250 255 256 257 259 269 272 277 278 285 296 303 304 305 306 307 308 309 321 322 327 339 340 341 349 353 355 360 361 374 375 379 381 388 398 403 407 415 416 421 443 457 467 468 473 475 489 502 503 504 508 526 573 588 594 599 608 625 626 627 656 681 688 724 728 736 751 770 786 798 803 812 866 867 873 877 890 899 926 936 942 952 953 980 993 997 1029 1061 1070 1071 1106 1122 1137 1138 1147 1159 1160 1167 1168 1187 1213 1234 1247 1248 1270 1272 1306 1310 1315 1325 1349 
8 9 20 101 102 124 146 187 188 202 203 211 216 217 221 229 230 246 247 252 262 263 276 319 320 331 332 333 334 345 354 357 365 399 431 435 440 441 476 491 492 505 550 551 558 560 561 592 622 632 635 698 733 735 753 754 756 766 783 823 852 860 862 870 934 935 975 981 987 995 1036 1038 1067 1087 1121 1129 1227 1281 
10 69 70 120 135 158 160 172 236 237 238 248 268 352 378 428 429 430 461 496 501 534 552 653 672 746 747 752 785 801 815 825 841 850 851 863 905 933 976 1020 1064 1073 1088 1133 1173 1194 1195 1210 1233 1289 1300 
28 29 38 39 49 50 60 139 186 370 371 373 404 405 444 465 479 532 617 618 636 638 659 660 671 699 737 760 764 782 810 919 937 960 983 984 1017 1019 1062 1092 1104 1132 1165 1224 1278 1279 1282 1314 1342 1354 
153 154 225 226 299 300 368 369 386 387 506 510 536 537 600 601 684 685 702 729 749 750 765 781 799 817 828 903 998 1003 1056 1057 1148 1154 1169 1172 1215 1258 1264 1265 1298 1307 1308 1319 1321 1346 
4 5 26 30 33 45 97 98 133 152 161 180 243 244 254 271 279 301 302 436 447 453 454 481 485 498 577 598 687 693 802 818 910 932 944 985 1320 
2 3 21 105 106 109 110 176 224 233 260 261 347 348 393 419 420 437 512 571 597 634 715 771 809 819 901 915 974 1139 1142 1143 1183 1208 1275 
127 128 136 137 170 171 191 192 223 264 265 460 477 478 486 487 542 564 616 623 624 691 692 710 721 1068 1083 1107 1108 1112 1135 1241 1290 1302 1347 
51 52 56 57 125 126 173 228 288 294 434 442 463 495 595 640 648 697 742 941 971 992 996 1008 1022 1023 1048 1103 1177 1223 1243 1328 
68 82 107 140 166 167 179 284 290 324 343 400 413 423 427 520 628 652 712 835 957 1007 1044 1045 1211 1212 1231 1348 
27 46 121 122 134 141 253 289 426 451 452 494 572 590 637 639 655 658 669 704 744 778 795 845 856 931 1276 
11 118 119 207 222 391 392 395 448 499 500 570 589 615 714 726 797 800 804 889 946 947 951 1042 1079 
258 293 338 350 356 367 383 548 549 557 582 583 604 609 696 869 893 895 940 978 1039 1178 1269 
47 99 100 159 275 295 358 359 394 425 462 471 523 665 757 794 927 943 1021 1205 1253 
77 144 145 175 209 210 281 282 330 517 518 569 914 1046 1051 1052 1063 1075 1105 
336 364 411 614 731 808 864 879 880 887 962 1065 1082 1155 1207 1235 1288 1329 
17 312 313 469 521 522 554 633 690 761 789 1014 1016 1055 1128 1163 
54 95 96 149 155 204 205 490 563 578 579 1002 1114 1146 1188 
89 117 316 317 372 445 755 768 939 964 965 1005 1034 1066 1140 
162 163 389 390 417 418 538 707 708 763 820 945 1093 1186 1291 
61 62 116 266 651 831 876 896 950 990 1203 1266 1286 1330 
91 92 213 214 397 458 474 556 581 610 619 773 1040 1136 
181 182 185 666 683 822 849 1161 1181 1199 1216 1222 1225 1229 
215 310 311 325 362 438 439 459 562 654 882 894 1028 1304 
71 72 239 446 497 605 748 767 855 892 979 991 1345 
103 104 156 196 197 251 472 703 727 904 922 982 1060 
206 249 342 514 643 644 732 811 848 857 1145 1182 1198 
31 231 409 410 527 528 539 718 840 923 969 1096 
164 165 406 414 576 580 631 772 814 816 878 1113 
283 529 530 664 694 695 839 859 930 999 1035 1317 
78 493 661 662 774 847 917 918 970 989 1101 
151 286 287 318 682 858 908 1170 1189 1209 1249 
178 351 784 954 988 1076 1077 1080 1098 1237 1318 
193 323 376 470 511 821 925 972 1030 1049 1072 
432 673 674 701 705 722 723 921 938 1043 1196 
482 483 641 642 734 829 830 924 928 1084 1144 
198 199 270 297 298 335 533 958 959 973 
183 184 337 611 709 759 1069 1130 1204 
646 805 806 868 906 907 1246 1263 1336 
14 267 396 649 743 913 968 1004 
650 725 796 824 912 1119 1120 1201 
129 130 591 606 891 1001 1239 
449 450 719 1086 1116 1156 1255 
18 19 553 559 566 787 
240 241 273 274 385 929 
433 525 602 603 762 1081 
1009 1010 1185 1191 1296 1297 
280 888 898 1097 1192 
377 455 456 670 1214 
565 647 1050 1134 1326 
587 1074 1217 1256 1293 
645 884 977 1091 1277 
679 680 1164 1305 1331 
769 1190 1274 1284 1316 
833 834 1150 1151 1257 
15 326 1153 1242 
90 920 1110 1311 
115 596 826 1259 
480 949 1015 1228 
540 541 1226 1285 
620 621 716 717 
677 678 776 777 
711 842 1026 1027 
853 1033 1262 1292 
871 872 1037 1301 
916 1053 1123 1200 
1025 1090 1230 1303 
114 813 909 
138 720 1184 
363 380 966 
513 1158 1335 
676 706 1031 
730 963 1047 
861 897 1141 
1018 1099 1280 
1126 1127 1174 
1218 1219 1312 
