1 12 13 15 22 23 32 34 36 40 42 43 53 59 63 66 69 86 87 93 94 111 118 119 129 148 149 165 174 189 195 208 212 219 220 234 235 245 250 252 255 256 257 258 259 269 272 277 278 280 296 303 305 306 308 309 310 320 322 327 339 340 349 350 352 353 354 355 360 361 362 366 374 381 388 392 403 406 414 421 433 438 440 457 467 468 475 489 501 502 503 504 508 513 515 516 526 529 570 573 575 588 591 594 599 600 604 608 619 625 626 627 635 645 649 650 664 724 765 770 780 792 798 845 867 872 875 877 908 909 930 936 937 960 967 979 997 1023 1033 1035 1037 1041 1058 1081 1085 1094 1106 1147 1162 1187 1203 1213 1217 1259 1260 1261 1266 1273 1282 1309 1315 1331 1332 1334 1348 
4 10 16 17 26 30 33 47 51 52 65 70 72 82 88 97 124 133 135 147 152 155 158 160 161 172 180 190 204 215 221 227 239 243 244 263 271 274 288 294 295 298 301 302 312 315 323 325 326 334 356 358 359 368 379 394 395 429 453 454 461 462 471 497 505 520 521 523 552 598 615 636 639 643 687 690 693 699 711 712 732 737 756 757 764 778 789 794 802 804 808 817 859 879 880 881 889 910 923 934 938 941 944 951 958 992 998 1008 1024 1032 1048 1064 1065 1070 1073 1080 1082 1083 1087 1093 1103 1114 1146 1154 1158 1163 1167 1168 1175 1189 1195 1235 1252 1291 1300 1305 1317 
20 21 27 31 39 44 46 60 64 77 99 100 134 141 163 178 182 185 186 198 199 211 236 238 265 268 270 275 279 281 282 297 316 317 319 332 335 365 372 373 391 409 410 415 417 425 428 434 435 441 444 445 491 527 532 533 534 539 543 545 560 572 589 590 618 628 631 634 653 659 663 665 666 672 718 735 753 766 768 782 783 784 785 790 793 818 822 839 840 870 899 901 916 933 943 948 953 954 964 970 973 988 1034 1051 1053 1054 1066 1076 1091 1095 1096 1123 1141 1143 1161 1180 1183 1198 1199 1200 1205 1225 1237 1247 1271 1293 1325 
5 48 56 57 61 106 115 128 137 140 166 171 176 188 191 224 230 233 237 248 260 313 318 348 376 393 416 418 419 420 426 436 437 447 460 478 485 486 512 530 540 542 564 566 595 602 603 607 616 623 624 648 656 692 696 710 715 721 726 742 771 803 805 806 809 841 866 868 894 895 897 915 920 932 946 969 974 987 996 1001 1006 1039 1046 1068 1079 1100 1107 1112 1124 1135 1142 1177 1194 1206 1208 1223 1234 1241 1246 1263 1270 1275 1289 1290 1302 1306 1310 1313 1318 1336 1339 
7 19 55 75 81 83 107 108 126 132 153 179 181 183 184 187 203 218 228 247 284 285 307 336 337 347 375 389 390 396 397 400 474 488 550 556 558 561 562 569 578 581 582 593 601 611 652 669 688 707 709 728 733 748 750 754 759 820 835 860 886 887 945 980 981 995 1044 1050 1069 1102 1125 1130 1131 1159 1181 1186 1204 1218 1236 1328 1329 1344 1346 
6 35 67 74 80 123 167 173 177 205 291 314 329 333 401 424 450 472 476 484 519 547 585 668 674 686 689 727 852 865 900 921 922 955 959 985 991 1002 1043 1179 1188 1196 1201 1220 1249 1287 1324 1327 1338 
0 37 68 78 104 146 287 293 338 367 402 442 458 495 498 548 549 557 583 584 609 640 670 682 697 758 786 787 814 869 891 893 971 978 1007 1012 1022 1030 1117 1133 1214 1238 1253 1267 1268 
73 113 114 130 168 196 202 251 254 324 351 404 464 477 482 483 525 554 563 606 614 641 642 651 723 800 829 830 924 928 1042 1077 1084 1105 1129 1144 1178 1207 1219 1239 1312 
3 29 76 217 357 369 382 384 385 555 579 592 632 680 725 734 749 799 843 917 927 1019 1020 1061 1088 1089 1092 1132 1155 1164 1165 1170 1176 1184 1197 1256 1265 1285 1288 1304 
25 91 112 127 142 143 154 169 213 214 223 225 226 273 299 328 386 537 610 629 683 729 801 807 898 903 1003 1014 1016 1038 1056 1067 1108 1169 1202 1258 1264 1319 1337 1347 
79 84 85 144 201 209 210 300 304 407 412 430 443 473 506 531 574 580 617 673 702 736 821 861 890 914 942 962 963 1047 1052 1060 1063 1072 1075 1110 1269 1272 1294 1321 
136 138 139 164 192 193 290 331 411 452 469 470 479 511 568 605 613 630 731 755 878 972 975 1000 1009 1010 1026 1027 1049 1055 1074 1116 1156 1171 1185 1191 1212 1296 1297 
41 89 90 103 197 222 522 524 541 637 660 675 705 706 774 849 882 904 961 982 1021 1031 1121 1140 1166 1216 1229 1232 1243 1311 1322 1323 1350 1351 1354 
45 96 120 231 232 378 446 496 507 528 622 633 638 679 708 722 746 747 752 763 773 815 816 863 892 1113 1160 1173 1193 1209 1210 1224 1244 1245 
28 50 71 276 465 493 612 661 662 769 777 791 823 836 862 873 911 918 925 939 976 986 989 1101 1136 1153 1190 1221 1274 1284 1316 1340 1341 
206 342 499 500 576 621 695 716 730 738 772 832 853 902 935 947 950 966 993 1015 1057 1111 1222 1228 1240 1248 1262 1292 
24 194 427 517 657 684 685 704 779 781 827 856 884 885 929 952 957 977 999 1215 1231 1277 1279 1298 1307 1308 
2 54 101 170 207 246 249 311 363 364 383 480 514 644 681 811 812 813 819 848 857 1029 1036 1182 1281 
11 292 371 387 620 677 678 694 698 717 767 776 846 847 888 1097 1104 1122 1145 1149 1192 1342 1345 1349 
14 267 341 494 535 536 565 571 596 597 743 871 913 968 1004 1025 1090 1148 1230 1242 1301 1303 
18 38 145 405 408 431 432 701 713 714 788 905 919 1018 1062 1098 1115 1233 1254 1278 1280 1295 
49 117 121 216 229 253 283 345 451 553 647 658 761 762 931 1005 1134 1276 1326 
102 240 241 492 509 510 739 740 828 854 956 1013 1059 1078 1152 1157 1299 1343 
92 105 116 398 455 456 466 490 559 741 775 844 1040 1071 1099 1137 1333 
98 261 413 423 439 459 654 655 744 810 842 906 907 1028 1045 1086 
62 131 266 286 646 874 876 896 990 1011 1286 1330 1335 
8 289 343 344 399 481 538 577 751 760 1017 1172 
9 109 125 150 151 377 487 826 949 1109 1118 1255 
346 671 825 833 834 864 883 1150 1151 1257 1314 
58 95 122 200 667 703 745 983 1139 
156 157 448 551 795 855 858 965 1128 
264 370 380 463 676 691 940 984 994 
159 162 262 700 719 720 926 1138 
422 586 587 831 837 838 1283 
796 797 824 850 851 1119 1120 
110 175 321 330 518 546 
242 544 567 912 1211 
449 1226 1227 1320 
