0 1 12 13 22 23 32 36 37 42 43 44 48 53 54 55 59 63 64 65 66 75 79 83 86 87 88 93 94 95 96 108 111 112 149 155 174 189 195 200 204 205 208 212 218 219 220 234 235 242 245 250 255 256 257 259 269 272 277 278 285 296 303 304 305 306 307 308 309 321 322 327 339 340 341 349 353 355 360 361 374 375 379 381 388 398 403 415 416 421 443 467 468 473 475 490 502 503 504 508 526 563 573 578 579 588 594 599 608 625 626 627 656 681 688 724 728 736 751 770 786 798 803 812 866 867 873 890 899 926 936 942 952 953 980 993 997 1029 1061 1070 1071 1106 1114 1122 1137 1138 1146 1147 1159 1160 1167 1168 1187 1213 1234 1247 1248 1270 1272 1306 1310 1315 1325 1349 
10 31 47 56 57 69 70 99 100 103 104 120 125 126 131 135 156 158 160 172 173 196 197 231 236 237 238 248 251 268 275 288 294 295 352 358 359 377 378 394 409 425 428 429 430 434 442 455 456 461 462 463 471 472 495 496 501 523 527 528 534 539 540 541 552 595 640 648 653 657 665 670 672 676 697 703 706 718 727 742 746 747 752 757 763 785 794 801 815 825 827 840 841 851 861 863 897 904 905 922 923 927 933 941 943 951 969 971 976 982 992 996 1008 1020 1021 1031 1048 1060 1064 1073 1088 1096 1103 1141 1170 1173 1177 1194 1195 1206 1210 1214 1223 1226 1233 1243 1285 1289 1300 1305 
6 7 24 25 34 35 40 41 58 67 73 74 76 80 81 84 85 113 123 132 142 147 148 150 168 169 177 190 227 291 292 314 315 328 329 346 382 384 401 402 408 412 422 424 457 464 466 484 488 489 516 519 531 545 546 547 574 584 585 586 607 629 630 663 667 668 675 686 700 745 758 775 779 780 788 790 792 793 807 832 837 838 843 854 865 874 875 883 886 900 948 955 961 994 1012 1024 1032 1041 1054 1058 1085 1089 1094 1100 1102 1111 1117 1118 1124 1125 1131 1149 1162 1166 1193 1202 1220 1232 1240 1252 1253 1260 1261 1271 1273 1283 1294 1327 1332 1333 1338 1350 
8 9 20 101 102 124 146 187 188 202 203 211 216 217 221 229 230 246 247 252 262 263 276 319 320 332 333 334 344 345 354 357 365 399 431 435 440 441 476 491 492 505 550 551 558 560 561 592 622 632 635 698 733 735 753 754 756 766 783 823 852 860 862 870 935 975 981 987 995 1002 1036 1038 1067 1087 1121 1129 1188 1281 1324 
28 29 38 39 49 50 60 139 182 185 186 232 330 331 370 371 373 404 405 444 465 479 517 518 532 636 638 666 671 699 713 737 760 764 782 919 920 937 960 983 984 1017 1018 1019 1062 1074 1092 1099 1104 1132 1165 1181 1184 1199 1207 1224 1225 1278 1279 1280 1282 1314 1342 1344 
11 68 82 107 118 119 140 141 166 167 179 207 284 324 391 392 395 400 413 423 427 448 470 485 499 500 520 570 589 606 615 628 652 714 726 797 800 804 821 835 889 925 946 947 957 1007 1042 1044 1045 1079 1133 1211 1212 1348 
153 154 225 226 299 300 368 369 386 387 506 510 535 536 537 600 601 684 685 702 729 749 750 765 781 799 817 871 872 903 998 1003 1037 1056 1057 1148 1154 1169 1172 1215 1258 1264 1265 1298 1301 1307 1308 1319 1321 1346 
2 3 21 105 106 109 110 176 223 224 233 260 261 347 348 393 419 420 437 512 571 597 634 715 771 809 819 901 915 974 1068 1083 1112 1139 1142 1143 1183 1208 1275 1290 1302 1347 
4 5 26 30 33 45 97 98 130 133 152 161 180 243 244 254 271 279 301 302 453 454 498 577 598 619 687 693 802 818 910 932 944 985 1030 1175 
27 46 121 122 134 253 289 290 323 426 451 452 494 572 590 637 639 655 658 669 704 744 778 795 845 856 931 1231 1276 
127 128 136 137 170 171 191 192 264 265 460 477 478 486 487 542 564 616 623 624 691 692 710 721 1107 1108 1135 1241 
507 509 515 524 555 567 568 645 739 740 741 833 834 884 885 956 977 1013 1059 1078 1150 1151 1152 1157 1257 1277 1351 
151 258 293 318 338 350 356 367 383 548 549 557 582 583 604 609 696 869 893 940 978 1039 1178 1209 1269 
77 144 145 175 201 209 210 281 282 569 898 914 1046 1051 1052 1063 1075 1105 
162 163 389 390 417 418 538 707 708 719 720 820 945 1093 1186 
164 165 406 407 414 580 631 761 762 814 816 844 878 1244 1245 
206 249 342 514 643 644 732 811 848 857 1145 1182 1189 1198 
312 313 469 521 522 554 633 690 789 1014 1016 1055 1128 1163 
432 449 450 673 674 701 705 722 723 921 938 1043 1196 1255 
61 62 266 651 876 877 896 990 1001 1011 1259 1318 1330 
116 480 730 831 949 950 962 963 1015 1047 1203 1228 1286 
15 115 267 326 649 743 968 1025 1090 1153 1230 1303 
91 92 213 214 397 447 474 556 581 610 1040 1328 
117 316 317 372 445 755 964 965 1005 1034 1066 1161 
215 310 311 325 362 438 439 459 562 654 882 1028 
364 411 614 731 808 864 879 880 887 1065 1082 1235 
71 72 239 446 497 605 748 855 892 979 991 
183 184 337 396 611 709 759 913 1069 1130 1204 
482 483 641 642 734 829 830 924 928 1084 1144 
178 351 784 954 1076 1077 1080 1098 1237 1295 
181 659 660 683 822 849 1216 1222 1229 1354 
198 199 270 297 298 335 533 958 959 973 
646 805 806 826 868 1134 1158 1263 1335 1336 
78 493 661 662 774 918 970 989 1101 
283 529 530 664 694 695 930 999 1035 
157 593 612 613 791 911 1109 1197 
650 725 796 824 912 1119 1120 1201 
193 194 376 511 972 1049 1072 
769 939 1179 1190 1274 1284 1316 
14 513 596 1004 1050 1242 
16 366 836 986 1221 1287 
18 19 553 559 566 787 
89 90 222 1110 1140 1311 
240 241 273 274 385 929 
280 846 847 888 1097 1192 
286 287 682 858 908 1249 
433 525 602 603 1081 1262 
679 680 1155 1164 1288 1331 
1009 1010 1185 1191 1296 1297 
51 52 228 1022 1023 
129 591 891 1238 1239 
138 881 934 967 1171 
436 689 894 895 1006 
677 678 776 777 828 
711 712 842 1026 1027 
17 410 850 1291 
159 1000 1156 1176 
336 565 1236 1329 
575 767 1113 1345 
587 1217 1256 1293 
620 621 716 717 
916 1053 1123 1200 
1115 1254 1299 1343 
114 813 909 
363 380 966 
458 773 1136 
576 738 772 
617 618 1205 
647 1266 1326 
768 917 1304 
810 1086 1116 
839 859 1317 
853 1033 1292 
902 988 1091 
906 907 1246 
1126 1127 1174 
1218 1219 1312 
