1 12 13 14 15 22 23 32 34 36 40 42 43 53 59 63 66 69 86 87 93 94 111 119 130 148 149 161 165 174 189 195 208 212 219 220 234 235 239 245 250 255 256 257 258 259 267 269 272 277 278 280 296 303 305 306 308 309 320 322 323 325 327 339 340 349 350 352 353 355 360 361 362 366 374 381 388 392 403 406 413 414 421 433 457 467 468 475 489 502 503 504 508 513 515 516 526 570 573 575 588 591 594 599 600 606 608 619 626 627 635 645 649 650 724 734 765 770 780 788 792 817 845 867 872 875 877 891 897 908 909 913 936 937 953 968 979 997 1012 1019 1023 1025 1033 1035 1037 1041 1058 1081 1090 1106 1118 1147 1162 1187 1213 1230 1238 1239 1260 1266 1273 1282 1303 1309 1315 1331 1332 1334 1348 
8 20 21 26 27 31 44 46 60 64 67 77 100 134 141 156 157 163 167 178 182 185 186 211 216 217 229 236 238 253 265 268 275 279 281 282 283 289 316 317 343 344 372 373 391 399 409 410 415 417 425 428 434 441 444 445 448 481 527 532 534 538 539 543 545 551 560 572 577 589 618 631 634 653 663 665 666 672 679 680 718 735 751 753 760 768 782 784 785 790 793 795 810 818 822 839 840 855 858 859 870 878 899 901 914 916 933 943 948 954 964 965 970 988 1017 1034 1038 1053 1054 1064 1066 1076 1080 1086 1091 1095 1096 1103 1123 1128 1141 1143 1155 1163 1164 1165 1172 1180 1183 1198 1199 1200 1205 1231 1237 1243 1247 1271 1288 1293 1317 1325 
24 25 39 91 110 117 121 136 139 142 143 164 175 192 193 194 209 213 214 223 264 273 290 299 321 328 329 330 331 346 370 380 411 427 452 463 469 470 479 480 484 511 517 518 521 537 546 553 568 569 605 610 629 657 671 676 684 685 691 704 729 731 755 779 781 801 807 825 827 833 834 835 842 856 864 869 883 884 885 898 900 903 906 907 929 931 940 952 957 972 975 977 984 994 999 1005 1009 1010 1014 1016 1026 1027 1045 1049 1055 1067 1074 1108 1116 1150 1151 1185 1188 1191 1202 1212 1215 1225 1257 1258 1264 1277 1279 1296 1297 1298 1307 1308 1314 1319 1324 1337 1347 
6 9 19 35 57 74 80 107 108 123 125 128 131 137 144 150 151 171 173 177 179 183 184 187 190 203 205 228 230 237 247 248 286 314 318 319 332 333 337 376 377 387 389 401 420 424 426 437 472 476 478 486 519 530 540 547 550 561 562 563 564 566 585 593 602 607 611 612 613 616 620 623 630 668 686 689 692 709 710 717 727 733 754 764 776 783 823 846 847 852 860 866 874 886 887 888 911 915 921 932 949 955 959 967 981 987 991 1002 1043 1046 1069 1085 1097 1107 1109 1130 1142 1149 1171 1179 1192 1194 1204 1236 1241 1255 1289 1310 1327 1338 
4 30 33 47 65 70 82 88 97 99 112 124 133 135 147 152 155 158 166 169 172 180 199 204 207 226 244 263 271 288 294 295 298 301 302 334 356 358 359 368 379 394 395 423 429 453 454 462 471 505 520 523 598 615 628 636 639 674 687 690 693 699 711 712 732 737 757 778 789 794 798 804 805 806 808 879 880 881 889 910 923 934 941 944 985 998 1004 1024 1028 1065 1073 1082 1083 1093 1094 1114 1154 1158 1167 1168 1169 1189 1195 1206 1300 1305 1336 
5 7 55 61 62 73 75 81 83 102 109 113 114 126 129 132 168 181 196 202 218 251 266 284 285 291 292 307 324 336 347 354 375 390 396 397 400 404 464 474 477 487 488 525 556 578 581 582 595 601 614 625 646 647 651 652 669 688 707 723 728 748 759 766 800 820 826 868 876 896 922 945 951 980 990 995 1001 1011 1044 1077 1102 1125 1129 1131 1134 1159 1181 1186 1203 1207 1218 1219 1246 1259 1263 1276 1286 1312 1318 1326 1328 1329 1330 1335 
11 48 56 106 118 140 176 188 191 206 224 233 260 261 313 348 371 393 408 416 418 419 431 432 436 447 460 485 499 500 512 529 542 624 648 656 664 694 696 698 701 714 715 721 726 742 767 771 796 797 803 809 841 850 851 894 895 905 920 930 946 947 969 974 996 1006 1039 1068 1079 1100 1104 1122 1124 1135 1145 1177 1208 1223 1233 1234 1270 1275 1290 1302 1306 1313 1339 1342 1345 1349 
2 10 16 17 54 78 98 101 127 138 170 198 215 243 246 249 252 270 274 297 310 311 326 335 341 345 363 364 365 383 435 438 439 459 461 491 494 514 533 535 536 552 558 565 571 590 596 597 644 654 655 658 659 681 683 743 744 756 811 812 813 819 848 857 871 958 973 1008 1029 1032 1036 1050 1051 1148 1161 1182 1235 1242 1252 1265 1281 1291 1301 
0 18 37 38 51 52 68 104 145 146 160 221 227 287 293 315 338 367 402 405 440 442 458 495 498 548 549 557 583 584 604 609 640 643 670 682 697 713 738 758 786 787 802 814 893 919 971 978 992 1000 1007 1018 1022 1030 1048 1062 1087 1098 1115 1117 1133 1146 1156 1214 1253 1254 1267 1268 1278 1280 1295 
3 28 29 50 71 76 115 240 357 382 384 385 465 555 579 592 632 677 678 725 749 769 777 791 843 862 873 925 927 939 976 1020 1061 1088 1089 1092 1112 1132 1136 1153 1170 1176 1184 1190 1197 1274 1284 1316 1340 1341 
92 105 116 241 242 369 398 455 456 466 490 492 501 509 510 544 559 567 739 740 741 750 775 799 824 828 844 854 912 956 960 1013 1040 1059 1070 1071 1078 1099 1119 1120 1137 1152 1157 1201 1211 1299 1333 1343 1346 
154 159 162 225 262 342 351 386 422 576 586 587 621 695 700 716 719 720 730 772 831 832 837 838 853 902 926 935 950 966 993 1003 1015 1056 1057 1111 1138 1217 1222 1228 1240 1248 1256 1262 1283 1292 
41 72 89 90 103 197 222 449 450 497 522 524 541 637 660 675 705 706 774 849 882 904 961 982 1021 1031 1121 1140 1166 1175 1216 1226 1227 1229 1232 1285 1311 1320 1322 1323 1344 1350 1351 1354 
79 84 85 153 201 210 300 304 407 412 430 443 473 506 531 574 580 617 673 702 736 821 861 890 942 962 963 1047 1052 1060 1063 1072 1075 1110 1269 1272 1294 1321 
45 96 120 231 232 378 446 496 507 528 622 633 638 708 722 746 747 752 763 773 815 816 863 892 1113 1160 1173 1193 1196 1209 1210 1224 1244 1245 1261 
49 254 312 451 482 483 554 603 641 642 761 762 829 830 924 928 938 1042 1084 1105 1144 1178 
276 493 661 662 836 917 918 986 989 1101 1220 1221 1287 1304 
58 95 122 200 667 703 745 865 983 1139 1249 
