4 10 44 46 116 117 118 119 131 135 140 167 206 207 249 253 265 291 316 325 346 365 372 389 394 395 416 429 430 432 438 439 445 447 448 461 466 490 514 515 541 543 570 615 618 645 683 689 701 714 743 755 790 797 800 804 818 849 889 894 895 946 947 951 952 961 976 977 984 997 1005 1015 1034 1041 1042 1043 1053 1064 1079 1091 1092 1095 1102 1104 1123 1140 1147 1180 1196 1200 1203 1216 1252 1333 1342 
48 56 57 71 87 105 127 128 137 141 160 161 162 170 171 188 191 192 239 243 264 268 281 320 391 393 434 437 446 454 460 477 478 486 487 496 501 512 526 528 530 542 552 556 564 567 571 595 602 616 623 624 656 673 691 692 715 718 723 748 775 777 785 801 809 891 892 898 909 944 958 966 969 979 1060 1068 1069 1107 1108 1124 1135 1170 1177 1217 1231 1233 1234 1241 1271 1290 1302 1306 1317 
32 49 50 103 104 109 150 156 157 186 196 197 218 219 292 350 351 357 385 397 404 444 450 452 472 479 493 494 499 546 550 551 574 575 581 588 593 594 612 613 633 636 646 648 651 710 713 727 789 810 812 826 843 860 873 881 904 905 911 967 982 1000 1012 1013 1021 1040 1076 1086 1109 1113 1133 1134 1197 1209 1232 1237 1295 1299 1316 1350 
13 20 22 54 65 75 95 96 110 111 112 124 132 195 200 204 205 224 250 255 256 305 308 321 349 354 361 362 375 379 380 388 428 474 488 489 502 511 589 598 619 625 643 676 706 721 722 728 732 773 786 792 811 866 995 1002 1136 1146 1188 1201 1206 1244 1245 1261 1325 
18 25 68 69 121 123 152 172 174 177 190 193 221 259 269 272 296 306 323 356 377 383 402 407 415 419 443 456 467 470 485 516 527 585 650 663 665 686 747 751 815 836 867 875 893 923 925 972 1030 1038 1039 1049 1075 1106 1145 1178 1181 1207 1218 1219 1223 1328 
1 15 34 36 154 201 220 225 238 267 273 299 300 328 386 401 421 422 425 536 537 600 601 627 674 719 726 736 750 787 788 869 902 903 954 955 957 964 968 1003 1025 1047 1056 1057 1090 1153 1156 1169 1230 1236 1258 1303 1319 1327 1332 1338 1340 1341 1346 
11 40 61 84 88 102 280 285 347 368 376 387 408 412 464 471 507 509 555 584 607 620 649 672 677 678 688 694 740 741 767 776 828 832 846 847 854 859 876 877 888 956 994 1011 1020 1059 1078 1097 1100 1129 1150 1157 1193 1194 1229 1248 1259 1260 1345 
8 9 14 28 62 125 187 203 211 229 262 319 359 364 399 420 435 440 441 465 492 505 513 560 596 622 647 735 753 754 766 783 805 806 839 840 862 896 913 935 974 981 990 993 1001 1004 1050 1149 1158 1228 1240 1276 1286 1326 1330 1335 
76 101 115 151 153 215 217 231 232 252 307 314 369 382 384 480 482 534 558 561 621 632 641 642 679 680 734 756 830 883 924 928 991 1019 1036 1051 1084 1085 1088 1089 1111 1114 1144 1155 1164 1165 1182 1202 1211 1255 1288 1304 1305 
3 94 107 113 114 139 184 276 282 322 336 337 370 396 427 458 525 565 591 603 611 638 653 667 709 712 733 737 752 759 760 960 1009 1010 1026 1070 1116 1130 1132 1139 1173 1183 1185 1191 1204 1222 1242 1282 1296 1297 1329 1344 
17 26 53 60 98 100 181 182 241 261 271 332 333 390 413 417 459 469 495 497 587 614 696 717 731 822 848 916 941 975 985 1080 1167 1212 1225 1275 1291 1313 1318 1339 
0 30 31 37 42 64 189 212 234 235 309 339 340 360 433 457 508 544 573 608 626 634 635 705 724 770 803 861 890 943 948 953 970 978 1071 1187 1205 1213 1310 
67 91 92 147 164 166 312 313 324 343 423 520 521 522 654 682 690 761 762 774 793 880 906 907 908 938 1016 1045 1065 1083 1110 1128 1220 1221 1246 1287 1311 
24 43 80 230 242 245 257 258 277 286 338 476 498 548 549 582 604 671 684 729 807 808 825 858 929 963 1008 1159 1172 1215 1269 1279 1298 1314 
47 72 93 213 237 248 317 318 327 353 378 566 605 637 739 798 855 915 980 987 996 1031 1046 1082 1094 1115 1254 1289 1300 1322 1323 1343 
38 106 144 145 175 176 210 233 260 330 331 348 405 517 518 569 771 819 914 920 988 1018 1052 1063 1099 1105 1184 1208 1270 1280 
77 108 126 163 180 194 290 293 294 352 400 463 532 640 697 704 707 763 765 784 814 971 1007 1061 1093 1117 1210 1293 1308 1315 
66 165 266 279 334 366 414 442 576 630 631 703 744 746 816 844 851 863 868 878 921 940 986 1055 1073 1112 1192 1263 1336 
23 59 85 86 198 199 270 297 298 335 341 533 535 795 817 827 853 864 942 959 962 973 998 1024 1148 1154 1195 1321 
55 79 136 148 149 208 381 473 475 503 510 557 599 749 781 799 899 1066 1186 1247 1266 1273 1307 1309 1334 1348 
63 83 120 178 304 342 344 504 652 681 711 791 842 871 872 1027 1037 1044 1062 1160 1166 1171 1189 1265 1301 
7 58 73 74 99 183 326 329 373 374 484 519 545 659 745 794 865 900 926 1074 1096 1249 1324 
16 240 251 274 411 523 529 664 695 700 779 780 879 930 1033 1035 1118 1125 1162 1175 1235 1262 1292 
19 27 122 134 179 345 426 553 559 572 590 644 658 669 742 778 845 856 931 936 1142 1198 
81 89 90 185 222 278 284 524 657 660 852 874 886 887 992 1017 1131 1224 1243 1351 1354 
5 33 45 70 129 130 133 254 301 302 577 687 693 820 1238 1239 1312 
227 228 288 289 403 418 539 897 932 933 945 1006 1022 1023 1048 1199 
236 371 436 538 675 698 738 772 833 834 857 1122 1141 1151 1257 1349 
449 455 481 540 592 823 1098 1161 1226 1227 1253 1267 1268 1285 1320 1331 
78 142 143 275 303 355 367 609 610 661 662 989 1101 1264 1337 
6 35 209 246 247 283 666 782 813 922 999 1029 1054 1281 
138 406 468 491 617 628 629 670 720 912 934 1137 1138 
29 159 554 568 884 885 927 1014 1152 1176 1277 
39 51 223 315 586 597 837 838 1072 1283 1347 
52 169 226 716 730 831 949 950 1058 1067 1294 
453 768 769 910 917 918 939 1179 1190 1274 1284 
146 158 173 287 358 579 802 983 1168 1256 
214 216 295 431 639 699 758 764 937 1103 
363 462 668 708 725 796 824 841 1119 1120 
155 392 547 580 583 919 1163 1278 
310 311 483 500 562 655 882 965 
2 21 451 578 870 901 1143 
97 244 409 410 850 1028 1032 
12 263 563 606 821 1272 
82 398 835 1077 1081 
168 202 685 829 1121 
41 757 1087 1214 
424 506 531 702 
