48 56 57 105 127 128 137 162 170 171 191 264 281 391 393 460 486 487 512 542 564 571 616 623 624 656 692 715 775 809 867 966 969 1107 1108 1135 1177 1234 1241 1290 1302 1306 
4 44 100 117 131 140 445 466 490 514 515 523 543 618 689 743 755 790 794 800 849 894 895 976 1005 1024 1034 1053 1102 1123 1200 1333 
0 1 22 34 36 42 64 208 212 220 238 360 381 388 421 438 526 573 599 608 627 736 787 803 957 1124 1198 1332 
8 72 93 202 213 248 263 317 318 319 378 435 476 558 563 566 739 766 855 915 987 1031 1082 1289 1300 
13 20 75 112 195 200 224 250 256 288 305 308 354 428 502 511 619 786 811 1325 
126 163 180 194 290 293 294 400 434 463 640 691 697 763 971 1093 1117 1210 
46 118 119 135 167 204 541 570 615 645 699 951 952 977 1004 1042 1103 
154 225 299 300 328 386 536 537 600 601 750 1003 1056 1057 1169 1319 1346 
27 122 316 345 426 572 590 639 658 669 778 845 856 931 936 1142 
16 132 326 405 457 488 489 576 625 779 780 861 1035 1041 1118 
81 99 199 284 374 519 852 874 886 887 926 1017 1074 1096 1131 
144 153 201 210 269 569 869 898 914 1051 1063 1075 1105 1202 1258 
136 148 149 412 473 475 503 781 832 899 1247 1266 1273 1348 
7 58 73 74 95 329 484 545 667 745 865 1237 1249 
59 198 270 297 298 335 533 535 817 853 958 973 1148 
84 646 647 651 672 876 877 990 1011 1050 1259 1326 1335 
107 187 336 337 396 525 603 611 712 733 759 982 1329 
193 323 377 402 456 470 516 527 923 925 972 1030 1049 
203 211 217 262 440 441 492 560 622 753 754 783 981 
231 232 482 641 642 734 830 924 928 1019 1084 1144 1304 
24 43 242 245 277 684 729 929 1008 1172 1215 1298 
31 32 189 234 309 340 634 770 943 953 970 1213 
14 15 267 565 913 968 1025 1090 1230 1242 1303 
41 76 215 307 369 384 756 883 1088 1089 1214 
3 139 370 591 638 737 1026 1116 1173 1183 
9 165 266 279 414 442 630 816 878 940 
49 50 218 219 350 588 812 1040 1086 1197 
109 546 612 613 713 826 911 1109 1156 1299 
141 157 160 268 496 501 528 552 718 801 
258 454 498 549 582 944 963 1159 1269 1279 
364 399 420 513 974 1064 1149 1227 1240 1276 
5 33 45 133 301 302 577 693 820 
28 62 465 735 896 1001 1203 1286 1330 
30 436 724 978 1070 1071 1187 1205 1310 
40 368 387 471 520 620 776 846 1229 
63 252 343 344 871 872 1037 1265 1301 
91 92 324 654 682 906 907 1045 1246 
241 261 413 495 717 810 842 1027 1167 
259 296 356 383 443 751 893 1038 1178 
453 768 769 917 918 939 1179 1190 1274 
479 507 509 555 677 678 727 828 1150 
18 123 152 174 221 407 665 836 
26 60 271 332 417 459 614 848 
29 568 740 854 1059 1078 1152 1157 
115 276 458 760 960 1132 1222 1282 
150 156 196 197 472 636 904 905 
175 176 233 260 348 771 819 1208 
206 207 395 448 796 797 947 1015 
292 351 574 575 767 1113 1133 1345 
334 631 703 746 844 921 1055 1112 
679 680 1155 1164 1165 1288 1305 1331 
873 881 1033 1153 1262 1284 1292 1316 
25 172 272 306 415 467 650 
68 485 494 815 1012 1039 1145 
70 129 130 254 1238 1239 1312 
78 142 610 661 662 989 1101 
113 114 282 322 606 752 1139 
138 444 594 670 789 934 967 
177 585 663 686 875 959 1106 
247 529 664 695 930 999 1036 
312 313 522 690 938 1016 1128 
330 331 517 518 920 1018 1184 
382 409 561 991 1029 1211 1281 
404 843 919 996 1013 1232 1350 
673 676 706 723 1060 1170 1233 
805 806 868 1134 1158 1263 1336 
6 35 246 660 813 1354 
10 11 607 694 741 889 
52 716 730 831 949 950 
61 134 427 653 742 1100 
71 446 605 748 891 892 
80 146 230 287 858 1168 
87 161 897 909 1231 1320 
108 352 432 532 784 1315 
110 362 474 531 1275 1328 
147 774 880 1065 1083 1110 
181 185 524 657 1236 1351 
227 228 1006 1023 1048 1199 
249 643 644 728 773 1136 
273 902 903 954 1047 1091 
310 311 483 562 655 882 
406 468 617 912 1137 1138 
738 772 833 834 1151 1257 
765 866 1007 1061 1307 1308 
1009 1010 1185 1191 1296 1297 
2 21 451 901 1143 
19 179 553 559 722 
23 85 86 942 1195 
47 327 798 980 1094 
54 321 1002 1160 1188 
67 102 103 104 251 
89 90 222 278 1311 
96 205 1201 1327 1338 
98 121 986 1080 1318 
101 314 621 1044 1182 
120 375 1062 1166 1171 
124 792 1244 1245 1261 
182 725 824 1119 1120 
229 283 666 922 1054 
237 418 539 932 933 
289 403 704 945 1022 
315 586 837 838 1283 
347 430 593 595 688 
349 827 998 1154 1321 
365 596 659 701 1196 
390 587 731 916 1212 
1181 1207 1218 1219 1223 
39 223 1072 1347 
55 79 325 1066 
65 379 589 732 
82 835 1076 1077 
111 255 598 995 
116 291 346 1043 
125 151 1111 1255 
155 392 702 1206 
164 423 521 557 
169 226 550 1067 
209 782 900 1324 
235 580 583 1278 
236 371 698 1141 
239 397 602 1069 
280 847 859 888 
285 341 408 649 
416 481 823 1147 
422 685 829 955 
433 508 705 890 
447 984 1104 1342 
452 480 534 1186 
464 477 1129 1248 
795 864 879 962 
839 840 862 935 
850 851 1073 1291 
992 1224 1225 1243 
12 821 1272 
17 469 941 
37 339 544 
38 988 1052 
51 597 1146 
53 696 975 
83 178 791 
88 491 1097 
94 361 604 
97 1028 1032 
106 145 1270 
158 579 1256 
159 554 927 
166 908 1220 
173 802 983 
186 385 860 
188 437 1068 
192 411 700 
216 758 937 
240 274 1235 
243 683 1216 
257 338 548 
265 818 910 
275 609 1021 
286 807 808 
303 355 367 
333 822 985 
357 551 648 
363 668 841 
366 744 863 
424 506 956 
449 450 592 
478 632 1114 
499 633 711 
510 749 799 
530 556 1317 
540 1226 1285 
567 777 785 
581 710 1000 
628 629 720 
671 825 1314 
674 788 1295 
687 994 1020 
761 762 793 
857 1122 1349 
884 885 1277 
946 1092 1252 
1115 1254 1343 
1193 1194 1260 
