1 12 13 22 23 32 34 36 40 42 43 53 55 59 63 66 69 86 87 93 94 111 119 130 148 149 165 174 181 189 195 208 212 219 220 234 235 239 245 250 255 257 258 259 269 272 277 278 280 296 303 305 306 308 309 320 322 325 327 339 340 349 350 352 353 355 360 361 362 366 374 381 388 392 403 406 414 421 433 457 467 468 475 502 503 504 508 513 515 516 526 529 570 573 575 588 591 594 599 600 606 608 619 626 627 635 645 649 650 664 724 765 770 780 792 817 845 867 872 875 877 891 908 909 930 936 937 953 979 997 1012 1023 1033 1035 1037 1058 1081 1106 1147 1162 1186 1187 1213 1217 1238 1239 1260 1266 1273 1282 1309 1315 1332 1334 1348 
11 48 56 61 62 106 109 118 140 167 176 188 191 206 224 233 260 313 348 371 393 408 416 418 419 431 432 436 447 460 485 487 499 500 512 542 624 646 647 648 656 694 696 698 701 714 715 721 726 742 767 771 796 797 803 805 806 809 826 841 850 851 874 876 894 895 905 920 946 947 969 974 990 996 1001 1006 1011 1039 1068 1079 1100 1104 1122 1124 1134 1135 1145 1158 1177 1203 1208 1223 1233 1234 1259 1270 1275 1276 1286 1290 1302 1306 1313 1318 1326 1330 1335 1336 1339 1342 1345 1349 
31 44 46 64 77 100 141 156 157 178 182 185 186 209 211 216 217 229 236 238 253 265 275 282 283 317 368 372 373 391 409 410 425 428 434 441 445 479 501 527 532 534 539 543 545 551 560 589 618 631 634 653 663 665 666 672 674 718 734 753 768 782 784 785 790 793 822 839 840 855 878 899 916 917 933 943 948 954 960 964 965 970 988 1019 1024 1034 1053 1054 1066 1076 1091 1095 1096 1123 1128 1141 1180 1196 1199 1200 1205 1243 1247 1271 1293 1304 
4 20 30 33 47 65 70 82 88 97 99 112 124 133 134 135 147 152 155 158 166 169 172 180 199 204 207 226 244 256 263 268 271 288 291 294 295 301 302 334 354 356 358 359 379 394 395 415 429 453 454 462 471 505 523 598 615 628 636 687 693 711 722 732 737 757 789 794 798 804 808 879 880 881 889 910 922 923 934 941 944 998 1065 1073 1082 1083 1093 1094 1103 1114 1154 1167 1169 1181 1189 1195 1198 1206 1210 1218 1219 1231 1300 1312 1325 
18 38 39 80 107 108 131 145 173 183 184 187 203 228 247 286 298 337 387 389 405 440 550 604 611 612 613 620 630 709 713 717 733 738 754 776 788 846 847 860 888 911 919 967 981 1018 1062 1069 1085 1097 1098 1115 1130 1149 1171 1192 1204 1225 1236 1237 1254 1278 1280 1295 
5 7 19 75 81 83 126 129 132 138 179 218 284 285 307 336 347 375 390 396 397 400 474 488 489 520 556 561 562 569 578 581 582 593 595 601 652 669 688 707 728 748 759 820 835 906 907 945 951 957 980 995 1044 1045 1102 1118 1125 1131 1159 1328 1329 
0 37 51 52 68 104 146 160 161 221 227 287 293 315 323 338 367 402 442 458 495 498 548 549 557 583 584 609 640 643 670 682 697 758 786 787 814 893 897 971 978 992 1007 1022 1030 1048 1087 1117 1133 1146 1214 1253 1267 1268 
57 128 137 144 171 230 248 264 318 357 420 426 437 449 450 476 478 486 530 540 555 563 564 566 579 602 616 623 632 691 692 710 725 764 866 915 921 987 1020 1046 1107 1142 1168 1170 1184 1194 1226 1227 1241 1256 1285 1289 1310 1320 
9 10 16 17 21 78 98 101 127 215 243 252 274 279 310 311 326 345 423 435 438 439 459 461 494 552 558 590 625 639 654 655 658 683 699 744 756 778 802 813 901 1008 1028 1032 1036 1041 1143 1183 1235 1252 1291 
24 117 136 193 427 452 480 517 553 671 679 680 684 685 704 779 781 856 884 885 929 931 952 955 977 999 1074 1155 1156 1164 1165 1215 1277 1279 1288 1298 1305 1307 1308 1331 
142 143 192 223 241 346 369 411 492 509 510 568 739 740 750 799 825 828 833 834 854 864 883 1013 1067 1078 1108 1150 1151 1152 1157 1257 1264 1299 1337 1343 1346 1347 
6 29 35 74 76 123 177 190 205 314 333 376 401 424 472 519 547 585 607 668 686 689 727 852 886 887 927 939 959 985 991 1002 1043 1179 1201 1327 1338 
25 91 121 213 214 240 273 290 299 328 330 331 518 537 605 610 629 729 731 755 801 807 869 898 903 975 1000 1005 1016 1038 1202 1212 1258 1319 
45 96 120 231 232 378 446 496 507 528 622 633 638 708 746 747 752 763 773 815 816 863 892 1113 1160 1173 1193 1209 1224 1244 1245 1261 
154 225 351 386 422 586 587 621 695 716 730 831 832 837 838 853 902 935 950 966 993 1003 1015 1056 1057 1111 1228 1240 1262 1283 1292 
41 72 103 197 497 522 524 541 660 675 705 706 774 849 882 904 961 982 1021 1031 1166 1175 1216 1229 1232 1344 1350 1351 1354 
237 592 677 678 712 769 777 791 818 823 862 873 925 932 976 1061 1092 1132 1136 1153 1176 1190 1197 1274 1284 1316 1340 1341 
139 164 194 312 469 470 511 521 657 690 827 938 972 1009 1010 1014 1026 1027 1049 1055 1080 1116 1163 1185 1191 1296 1297 
14 15 267 319 365 491 565 571 596 597 659 766 783 913 968 1004 1025 1050 1051 1090 1161 1230 1242 1303 
2 26 54 67 170 246 249 363 364 383 514 644 681 811 812 819 848 857 859 1029 1182 1281 1317 
73 102 113 114 168 202 251 266 292 324 404 464 477 525 614 651 723 800 896 1059 1077 1129 1207 
79 276 430 443 493 574 580 661 662 673 836 890 918 986 989 1060 1072 1101 1110 1220 1221 1287 
84 85 153 201 210 300 412 473 506 531 702 942 956 962 963 1047 1052 1063 1075 1269 1321 
92 105 116 398 455 456 466 490 559 741 775 844 1040 1070 1071 1099 1137 1333 
8 27 60 163 281 289 316 332 417 444 448 572 795 858 870 914 
58 95 122 200 329 484 667 703 745 865 900 983 1139 1188 1249 1324 
196 254 482 483 554 641 642 829 830 924 928 1042 1084 1105 1144 1178 
198 270 297 335 341 533 535 536 743 871 958 973 1148 1265 1301 
3 115 382 384 385 749 843 868 1088 1089 1112 1246 1263 
159 162 262 342 576 700 719 720 772 926 1138 1222 1248 
28 50 71 261 413 465 735 810 842 1086 1314 
343 344 399 481 538 577 751 760 1017 1064 1172 
89 90 222 637 1121 1140 1311 1322 1323 
242 544 567 824 912 1119 1120 1211 
304 407 617 736 821 861 1272 1294 
125 150 151 377 949 1109 1255 
370 380 463 676 940 984 994 
49 451 603 761 762 
110 175 321 546 
