1 12 13 22 23 32 34 36 37 40 42 43 53 55 59 63 66 69 86 87 88 93 94 111 119 142 143 148 149 155 165 189 195 208 212 217 219 220 234 235 245 250 255 256 257 259 269 277 278 280 296 303 305 306 308 309 320 322 325 327 339 340 349 350 352 353 354 355 360 361 362 366 374 381 388 392 403 406 414 421 433 440 457 467 468 475 489 501 502 503 504 508 513 515 516 526 529 570 573 575 586 588 591 594 599 600 604 608 619 625 626 627 635 645 647 649 664 724 734 765 780 792 798 817 845 863 867 872 875 877 891 909 930 936 937 945 960 979 997 1012 1019 1033 1035 1037 1038 1041 1050 1073 1081 1094 1106 1113 1147 1162 1186 1187 1189 1213 1217 1260 1266 1273 1276 1282 1304 1309 1315 1326 1331 1332 1334 1337 1348 
9 10 16 17 18 19 21 38 51 52 79 98 125 133 145 152 160 161 174 179 180 190 215 221 227 239 243 244 252 264 265 276 279 288 295 310 311 323 326 359 394 402 405 410 423 426 439 443 453 454 459 461 493 494 523 546 552 557 562 574 580 589 590 654 655 661 662 699 713 744 756 757 778 788 794 802 818 836 850 897 901 910 918 919 944 958 967 986 989 1004 1018 1023 1028 1030 1036 1062 1069 1080 1085 1087 1098 1101 1110 1142 1143 1175 1183 1221 1277 1278 1280 1291 1295 
48 56 61 62 67 73 106 115 118 131 140 167 176 188 191 206 207 224 233 251 260 266 286 313 348 376 393 400 404 416 418 419 436 447 458 460 485 499 500 512 520 542 584 603 614 624 646 648 651 656 689 696 714 715 721 723 742 771 796 797 800 803 809 824 841 851 866 876 894 895 896 906 907 946 947 957 969 974 990 996 1001 1006 1007 1011 1039 1042 1045 1068 1077 1079 1100 1119 1120 1124 1135 1177 1207 1208 1223 1234 1259 1270 1275 1286 1290 1302 1306 1313 1318 1330 1335 1339 
8 27 44 60 64 77 100 129 163 178 185 186 281 289 316 317 358 370 372 373 380 391 401 408 417 432 438 444 445 448 450 462 479 518 532 543 551 572 613 618 631 639 665 666 676 701 726 768 784 793 795 806 822 839 840 858 868 870 916 920 921 933 943 948 954 964 965 970 984 988 1034 1043 1053 1054 1066 1076 1091 1112 1123 1134 1141 1196 1199 1200 1205 1233 1237 1246 1247 1263 1271 1293 
4 5 26 30 33 47 70 97 113 114 124 126 135 147 158 172 204 271 274 282 293 294 298 301 302 334 356 383 395 429 442 471 495 497 525 595 598 615 636 640 674 687 693 697 722 737 758 808 827 859 879 880 889 905 951 971 980 985 992 1008 1032 1048 1065 1082 1083 1093 1103 1114 1117 1155 1195 1235 1243 1252 1253 1267 1268 1288 1305 1317 
7 75 81 82 83 132 138 153 168 202 218 285 307 336 347 375 390 396 397 430 435 464 474 477 488 556 558 561 569 578 581 582 601 652 669 673 688 707 728 748 750 759 814 820 890 995 1044 1058 1060 1072 1102 1125 1129 1131 1159 1258 1281 1328 1329 1346 
54 57 144 166 196 230 237 248 254 272 318 338 420 431 437 478 482 483 530 554 563 566 602 606 641 642 710 764 829 830 848 869 893 908 914 915 924 928 940 987 1046 1084 1105 1144 1168 1178 1181 1194 1206 1218 1219 1220 1239 1241 1287 1289 1300 1310 1312 
80 107 108 139 164 173 177 187 203 284 314 315 332 346 389 424 476 519 550 585 643 668 686 733 754 790 825 833 834 837 838 852 860 865 874 878 886 887 959 981 1009 1010 1026 1027 1055 1095 1116 1150 1151 1180 1185 1191 1249 1257 1283 1296 1297 1314 
3 29 76 102 240 241 319 357 382 384 385 492 509 510 555 567 579 632 650 725 739 740 749 766 799 828 843 854 912 927 1013 1020 1059 1078 1088 1089 1115 1152 1157 1170 1176 1184 1254 1256 1299 1343 
45 72 96 120 231 232 261 378 413 446 496 507 528 622 633 638 679 680 708 711 712 746 747 752 763 773 810 815 816 842 892 1086 1158 1160 1173 1193 1209 1224 1244 1245 1261 
154 162 225 262 304 342 351 386 422 576 587 621 695 700 716 719 720 730 738 772 831 832 902 926 935 950 966 993 1003 1015 1056 1057 1111 1138 1222 1228 1240 1248 
25 39 91 127 128 137 171 213 214 223 273 299 328 486 537 564 610 616 623 629 683 692 729 801 807 898 903 1014 1016 1107 1108 1202 1225 1319 1347 
24 49 110 117 121 175 253 321 330 345 427 451 517 553 658 671 684 704 761 762 779 781 856 929 931 1005 1164 1165 1215 1279 1298 1307 1308 
20 31 46 134 141 205 238 268 275 409 415 425 428 434 527 534 539 545 634 653 672 718 735 785 899 953 1096 1198 1201 1210 1325 1327 
41 103 181 197 522 524 540 541 630 660 675 705 706 774 849 882 904 961 982 1021 1031 1166 1216 1226 1229 1232 1264 1285 1344 1350 1351 1354 
11 211 216 229 258 283 291 292 329 371 441 472 484 547 560 607 694 698 753 767 917 922 1104 1122 1145 1163 1179 1342 1345 1349 
28 50 71 449 465 592 593 612 769 777 791 862 873 911 939 976 1061 1092 1132 1153 1190 1197 1227 1274 1284 1316 1320 1340 1341 
14 15 183 184 267 337 365 491 565 571 596 597 611 659 709 783 913 968 1025 1051 1090 1130 1161 1204 1230 1236 1242 1303 
84 85 201 300 407 412 473 506 531 617 702 736 821 861 942 956 962 963 1047 1075 1269 1272 1294 1321 
2 6 35 101 170 246 249 363 364 463 480 514 644 681 691 811 812 813 819 857 994 1029 1182 
99 198 199 270 297 335 343 344 399 481 533 538 577 628 751 760 973 1017 1064 1172 
92 105 116 398 455 456 466 490 559 741 775 844 1040 1070 1071 1099 1137 1203 1333 
89 90 222 637 685 884 885 952 955 977 999 1121 1140 1311 1322 1323 1338 
136 159 193 312 469 470 511 521 690 789 938 941 972 1000 1049 1074 1156 
182 192 290 331 369 411 452 568 605 731 755 782 864 883 975 1212 1265 
68 146 242 287 324 544 670 682 786 787 835 1022 1133 1211 1214 1238 
341 535 536 743 770 853 871 998 1024 1148 1154 1167 1169 1262 1292 1301 
65 194 263 379 505 657 732 804 881 923 934 1171 1231 
368 387 620 677 678 717 776 846 847 888 1097 1149 1192 
58 95 122 200 667 703 745 983 1136 1139 1146 
0 78 104 367 498 548 549 583 609 978 
109 150 151 377 487 826 1109 1118 1255 
209 210 228 247 900 1052 1063 
74 123 727 1002 1188 1324 
130 333 823 925 932 991 
156 157 236 663 855 1128 
112 169 226 949 1067 
