1 12 13 20 22 23 32 34 36 37 40 42 43 53 59 63 66 69 86 87 88 93 94 111 119 142 148 149 155 165 189 195 208 212 219 220 234 235 245 250 255 256 257 259 269 277 278 280 296 303 305 308 309 320 322 325 327 339 340 349 350 352 353 355 360 361 362 366 374 381 388 392 403 406 414 415 421 457 467 468 475 489 501 502 503 504 513 515 516 526 570 573 575 586 588 591 594 599 600 608 619 626 627 635 645 649 724 765 780 792 798 817 845 867 872 875 877 909 936 937 960 979 997 1023 1033 1035 1037 1041 1070 1081 1094 1106 1147 1162 1187 1189 1213 1260 1266 1273 1282 1315 1325 1331 1332 1348 
48 56 118 140 167 191 206 233 393 400 418 460 499 500 520 542 603 624 648 656 714 715 726 742 803 809 906 907 920 946 947 957 969 996 1042 1045 1079 1124 1135 1177 1223 1234 1290 1302 1306 
44 178 182 185 186 317 372 373 391 445 462 543 551 618 665 666 768 782 784 790 793 822 916 933 948 954 964 965 970 988 1034 1053 1054 1066 1076 1091 1123 1141 1199 1200 1205 1271 
7 75 81 82 83 132 138 153 285 307 336 347 354 390 396 397 430 474 488 556 569 578 581 582 593 601 625 688 728 748 759 1131 1159 1328 1329 
16 19 179 190 215 252 310 311 426 435 438 459 494 552 558 562 590 654 655 744 756 778 1036 1142 
10 33 135 158 172 204 207 248 271 301 302 394 395 429 598 636 674 687 693 707 889 1073 1305 
57 237 272 318 420 437 478 530 566 602 710 869 915 987 1046 1194 1206 1241 1310 
84 85 201 210 282 412 473 506 531 702 914 942 956 1052 1063 1075 1321 
106 109 176 188 224 260 313 348 419 512 634 771 974 1068 1208 1270 1275 
39 127 128 137 171 223 486 564 616 623 683 692 1107 1108 1225 1347 
62 73 266 404 614 646 651 800 876 896 990 1011 1077 1207 1330 1335 
45 72 378 446 496 528 622 746 747 752 763 773 815 892 1173 
107 108 187 203 284 332 389 550 668 733 754 860 981 1264 1344 
26 30 31 126 294 334 358 589 820 859 899 967 1093 1317 
181 524 660 675 774 849 961 1166 1216 1229 1232 1350 1351 1354 
254 482 483 641 642 829 830 924 928 1084 1105 1144 1239 
273 299 328 537 684 685 729 903 1014 1016 1279 1298 1319 
47 147 274 298 471 808 879 880 1065 1082 1083 1235 
6 35 209 246 314 383 585 686 900 1188 1324 
68 338 640 670 891 971 1012 1022 1133 1214 1238 
141 238 268 427 434 534 545 653 672 785 1210 
211 216 229 283 441 529 560 664 753 930 1038 
276 493 661 662 836 918 986 989 1101 1221 1287 
14 15 267 565 611 913 968 1004 1236 1242 
18 38 145 405 713 919 1018 1062 1278 1280 
51 52 227 288 356 461 802 1048 1087 1146 
103 197 540 541 705 706 882 982 1031 1226 
621 695 716 730 831 832 950 1015 1057 1228 
739 740 854 1078 1115 1152 1157 1254 1299 1343 
0 104 367 498 548 549 583 609 978 
3 382 384 385 650 749 843 1088 1089 
4 70 97 129 453 454 910 944 1195 
11 472 547 607 694 767 1163 1179 1345 
29 76 261 413 842 927 1170 1176 1285 
96 231 232 507 633 638 679 1209 1224 
99 198 199 270 297 335 533 628 973 
105 116 398 466 490 775 1071 1203 1333 
239 323 788 958 1069 1098 1237 1277 1295 
436 447 485 689 841 894 895 1006 1039 
24 517 781 856 929 1215 1307 1308 
113 114 166 324 525 606 908 1220 
120 708 816 1160 1193 1244 1245 1261 
136 193 469 470 511 972 1049 1074 
146 287 448 682 786 787 795 858 
177 424 519 852 874 886 887 959 
312 521 690 789 938 941 1289 1300 
46 275 409 425 527 718 1096 
89 90 222 637 1121 1140 1311 
139 164 878 1026 1027 1055 1116 
152 221 359 523 757 794 862 
174 442 758 814 951 992 1243 
192 369 411 864 883 1003 1265 
343 344 481 538 577 751 760 
407 617 736 821 861 1272 1294 
612 777 791 873 911 976 1153 
750 998 1024 1154 1167 1169 1346 
25 78 91 213 214 610 
27 60 100 163 417 870 
168 202 561 1029 1058 1281 
290 331 731 755 975 1212 
292 464 477 704 779 1129 
368 387 620 717 776 846 
371 698 1104 1122 1342 1349 
401 450 630 921 1043 1196 
535 536 853 871 1148 1301 
769 939 1190 1274 1284 1316 
796 797 824 851 1119 1120 
1009 1010 1185 1191 1296 1297 
17 244 410 850 1291 
21 279 901 1143 1183 
61 1001 1100 1286 1318 
64 532 631 943 1247 
65 263 379 732 804 
79 443 574 580 1110 
80 173 329 476 484 
98 130 539 932 1080 
117 291 553 922 931 
150 151 377 1118 1255 
154 225 386 1056 1258 
205 955 1201 1327 1338 
217 734 917 1019 1304 
218 669 995 1102 1125 
293 495 697 1117 1253 
295 326 431 699 764 
300 962 963 1047 1269 
304 375 652 835 1044 
306 433 508 770 953 
402 557 866 1007 1030 
408 432 701 905 1233 
505 881 923 934 1171 
518 555 725 799 1184 
647 1050 1134 1276 1326 
680 1155 1164 1165 1288 
833 834 1150 1151 1257 
2 514 644 819 
28 50 71 465 
41 522 904 1021 
49 451 761 762 
58 200 1136 1139 
74 123 727 1002 
101 480 813 1182 
102 319 766 1059 
133 180 497 1175 
134 735 1198 1231 
160 161 243 897 
162 700 719 720 
183 184 337 1130 
240 241 492 1013 
346 671 825 1314 
351 966 993 1111 
365 659 783 1161 
370 380 676 984 
399 1017 1064 1172 
422 587 1217 1256 
455 456 741 1040 
463 691 940 994 
479 613 839 840 
576 738 772 1222 
615 737 1103 1114 
673 890 1060 1072 
868 1112 1246 1263 
1025 1090 1230 1303 
5 595 827 
55 945 1186 
67 251 723 
92 559 1099 
95 122 745 
110 175 330 
112 169 226 
115 458 1259 
121 253 1005 
124 722 980 
159 1000 1156 
170 363 364 
196 554 1178 
242 544 1211 
249 811 812 
262 926 1138 
264 265 818 
281 428 444 
316 572 639 
333 985 991 
357 579 632 
416 696 721 
423 439 1028 
440 604 1085 
449 1227 1320 
452 568 605 
487 826 1109 
509 510 828 
571 596 597 
629 898 1202 
667 703 983 
711 712 1158 
801 807 1020 
805 806 1336 
837 838 1283 
847 1097 1192 
893 1181 1218 
902 935 1240 
952 977 999 
1008 1032 1252 
1092 1132 1197 
