48 56 57 105 127 128 137 162 170 171 191 192 264 281 391 393 460 477 486 487 512 542 564 571 616 623 624 656 691 692 715 775 809 867 966 969 1107 1108 1124 1135 1177 1234 1241 1290 1302 1306 
0 1 14 15 22 34 36 42 64 208 212 220 238 267 360 381 388 421 526 565 573 599 608 611 627 736 787 803 913 957 968 1025 1090 1198 1230 1236 1242 1303 1332 
4 44 100 117 131 140 291 326 438 445 466 490 514 515 523 543 618 743 755 790 794 800 849 889 976 1005 1024 1034 1043 1053 1091 1102 1123 1200 1333 
8 72 93 202 248 263 317 318 319 345 378 435 476 558 566 739 766 783 855 915 987 1031 1082 1175 1289 1300 
13 20 46 54 96 112 119 135 195 200 204 205 256 308 321 361 511 615 811 1002 1201 1325 1327 
3 71 130 139 370 446 497 591 606 638 737 748 891 892 979 1026 1116 1173 1183 1217 1238 1239 
107 187 203 211 217 229 262 282 440 441 492 525 560 603 622 667 733 753 754 981 982 
154 225 299 300 328 386 387 536 537 600 601 750 1003 1056 1057 1156 1169 1319 1346 
158 206 207 395 429 448 579 714 796 797 850 851 946 947 961 1015 1073 1140 1256 
30 49 50 218 350 464 588 812 978 1040 1071 1086 1129 1187 1197 1205 1248 1310 
106 145 175 176 210 233 260 348 569 771 819 914 1063 1105 1208 1270 
136 148 149 305 412 473 475 503 749 781 899 1247 1266 1273 1348 
16 132 405 457 488 489 576 625 779 780 861 1035 1041 1118 
27 122 426 572 590 658 669 778 845 856 931 936 1142 
59 198 270 297 298 309 335 533 535 817 853 958 973 
24 43 242 245 277 684 729 929 1008 1172 1215 1298 
113 114 276 322 458 752 760 960 1132 1139 1222 1282 
231 232 482 641 642 734 830 924 928 1019 1084 1144 
61 109 826 876 877 896 1001 1134 1203 1259 1286 
62 396 646 647 651 990 1011 1050 1326 1330 1335 
157 501 546 593 612 613 713 911 1109 1295 1299 
164 312 313 521 522 690 938 1014 1016 1128 1176 
479 507 555 727 873 881 1033 1150 1153 1262 1292 
68 166 194 400 485 520 1039 1093 1145 1231 
91 92 324 343 654 682 906 907 1045 1246 
141 160 268 428 434 496 528 552 718 801 
258 498 549 582 604 807 808 1159 1269 1279 
453 768 769 917 918 939 1179 1190 1274 1304 
5 33 45 133 301 302 577 693 820 
7 58 73 74 329 484 545 745 865 
9 98 279 414 630 816 878 940 1028 
18 123 152 303 306 407 516 665 836 
29 568 740 854 885 1059 1078 1152 1157 
31 32 189 340 634 770 943 970 1213 
81 284 852 874 886 887 919 1017 1131 
99 159 199 374 519 702 926 1074 1096 
221 227 228 418 1006 1022 1023 1048 1199 
241 261 413 495 717 810 842 1027 1275 
334 631 703 746 844 868 1055 1112 1263 
444 531 620 776 846 847 888 967 1229 
681 711 712 805 806 1158 1182 1189 1336 
38 738 833 834 988 1052 1151 1257 
126 180 293 463 640 697 971 1117 
150 156 196 197 472 636 904 905 
266 404 757 843 996 1013 1232 1350 
292 351 574 575 767 1113 1133 1345 
529 664 695 716 730 831 832 930 
679 680 1155 1164 1165 1288 1305 1331 
25 172 272 356 415 467 650 
26 60 332 417 459 614 848 
63 871 872 1037 1148 1265 1301 
76 115 307 369 883 1088 1089 
147 774 880 1065 1083 1110 1311 
177 585 663 686 875 959 1106 
193 376 377 470 972 1030 1049 
330 331 517 518 920 1018 1184 
382 409 561 991 1029 1211 1281 
2 21 451 901 1143 1166 
6 35 246 660 813 1354 
11 547 607 694 741 1163 
78 142 661 662 989 1101 
80 146 286 287 858 1249 
108 352 432 532 784 1315 
111 250 255 349 786 995 
118 167 541 570 951 1042 
165 174 219 234 442 443 
188 239 437 602 1068 1069 
237 454 539 932 933 944 
249 643 644 728 773 1136 
310 311 483 562 655 882 
336 530 556 759 1317 1329 
364 420 513 1149 1240 1276 
406 468 617 912 1137 1138 
509 510 677 678 799 828 
673 676 723 1060 1170 1233 
1009 1010 1185 1191 1296 1297 
1181 1207 1218 1219 1223 1312 
12 144 563 821 1272 
19 179 553 559 722 
23 85 86 942 1195 
47 327 798 980 1094 
87 161 897 909 1320 
95 151 772 1111 1255 
153 201 869 1051 1258 
163 290 294 763 1210 
182 725 824 1119 1120 
190 424 506 747 956 
209 782 900 1188 1324 
236 371 436 698 1141 
273 902 903 954 1047 
315 586 837 838 1283 
365 596 659 701 1196 
389 461 683 1216 1291 
390 587 731 916 1212 
402 456 527 923 925 
422 685 829 955 1338 
433 508 705 890 953 
765 1007 1061 1307 1308 
795 864 879 962 963 
827 998 1154 1167 1321 
10 857 1122 1349 
39 223 1072 1347 
52 949 950 1067 
55 79 325 1066 
65 379 589 732 
82 835 1076 1077 
83 178 595 791 
88 280 859 1097 
89 90 222 278 
94 394 1070 1079 
97 244 410 1032 
101 314 621 1044 
102 103 104 251 
110 362 474 1328 
120 375 1062 1171 
134 427 742 1100 
138 670 789 934 
169 226 1058 1294 
185 524 657 1351 
224 354 598 815 
230 921 1160 1168 
235 580 583 1278 
252 344 898 1202 
275 609 610 1021 
283 666 922 1054 
285 341 408 649 
288 397 758 937 
289 403 704 945 
347 430 584 688 
357 550 551 648 
399 974 1064 1227 
416 481 823 1147 
447 984 1104 1342 
452 480 534 1186 
493 1209 1284 1316 
689 866 894 895 
839 840 862 935 
992 1224 1225 1243 
17 469 941 
28 465 735 
37 339 544 
40 368 471 
41 1087 1214 
51 597 1146 
53 696 975 
67 908 1220 
69 419 1012 
70 129 254 
75 594 619 
124 502 792 
125 216 1103 
155 392 1206 
173 802 983 
186 385 860 
215 384 756 
240 274 1235 
247 999 1036 
257 338 548 
265 818 910 
296 383 1178 
323 653 724 
333 822 985 
337 709 1204 
363 668 841 
366 744 863 
425 719 720 
449 450 592 
478 632 1114 
494 499 633 
540 1226 1285 
567 777 785 
581 710 1000 
645 952 977 
671 825 1314 
687 994 1020 
706 1264 1344 
761 762 793 
986 1080 1237 
1115 1254 1343 
1193 1194 1260 
1244 1245 1261 
