1 12 13 22 23 32 34 36 40 42 43 53 55 59 63 66 69 86 87 93 94 111 119 130 148 149 156 174 189 195 208 212 219 220 234 235 245 250 252 255 257 258 259 269 272 277 278 280 296 303 305 306 308 309 320 322 325 327 339 340 349 350 352 353 355 360 361 362 366 374 381 388 392 403 406 410 414 421 433 438 440 467 468 475 501 502 503 504 508 513 515 516 526 570 573 575 588 591 594 599 600 604 606 608 619 626 627 635 645 649 650 765 780 792 845 867 872 875 877 891 908 909 936 937 953 960 979 997 1012 1023 1033 1035 1036 1037 1058 1081 1106 1147 1162 1187 1213 1217 1238 1239 1260 1266 1273 1282 1291 1309 1315 1332 1334 1348 
9 27 31 44 46 60 64 77 100 117 128 129 137 141 163 171 178 182 185 186 236 238 264 265 268 275 279 281 282 299 316 317 373 391 409 417 425 428 434 444 445 479 486 527 532 534 539 543 545 553 564 572 589 616 618 623 631 634 653 663 665 666 672 692 718 722 734 768 784 785 790 793 818 822 839 840 870 878 899 910 916 931 933 943 948 954 964 970 988 1019 1021 1024 1034 1053 1054 1066 1076 1091 1095 1096 1107 1123 1141 1180 1196 1199 1200 1205 1243 1247 1271 1293 
48 56 61 62 67 73 102 106 109 115 140 162 167 168 176 188 191 224 233 251 260 266 313 348 393 404 408 416 418 419 431 432 436 447 460 485 487 512 542 614 624 646 647 648 651 656 696 701 715 721 723 726 742 771 800 803 805 806 809 826 841 868 874 876 894 895 896 905 920 946 969 974 990 996 1001 1006 1011 1039 1059 1068 1077 1079 1100 1108 1112 1124 1134 1135 1177 1203 1207 1208 1223 1233 1234 1246 1259 1263 1270 1275 1276 1286 1290 1302 1306 1313 1326 1328 1330 1335 1336 1339 
4 20 21 26 30 33 47 65 70 88 97 99 112 124 133 135 147 152 155 158 166 169 172 180 199 204 207 226 239 244 263 271 291 294 295 301 302 323 334 354 358 359 379 394 395 415 429 453 454 458 462 471 505 523 598 615 628 636 674 687 693 711 732 737 757 778 789 794 798 804 808 817 820 859 879 880 881 889 901 922 923 934 941 944 985 998 1020 1065 1070 1073 1082 1083 1093 1094 1114 1143 1154 1158 1167 1169 1183 1189 1195 1198 1206 1300 1317 1325 
5 7 75 79 81 82 83 113 114 126 132 138 202 218 256 284 285 288 307 324 336 347 368 375 390 396 397 430 443 457 464 474 477 488 489 520 525 556 561 569 574 578 580 581 582 593 595 601 625 652 669 673 688 707 728 748 759 835 890 945 951 980 995 1041 1044 1060 1072 1102 1110 1118 1125 1129 1131 1181 1218 1219 1312 1329 
35 80 107 108 173 177 183 184 187 203 205 228 247 298 314 332 333 337 387 389 424 472 519 531 547 550 585 607 611 613 620 630 660 668 686 689 709 717 733 754 776 846 847 852 860 866 886 887 888 914 959 967 981 991 1046 1062 1069 1085 1097 1130 1149 1171 1179 1192 1201 1204 1216 1220 1236 1278 1327 1338 1354 
24 25 91 110 175 181 209 213 214 240 273 321 328 329 330 331 427 452 480 484 517 518 529 537 546 610 629 639 664 684 685 704 729 779 781 801 807 856 869 884 885 898 900 903 929 930 952 955 977 999 1016 1038 1159 1186 1188 1202 1215 1277 1279 1298 1307 1308 1319 1324 
6 19 29 57 74 123 125 144 145 150 151 179 190 230 248 318 357 376 377 401 420 426 437 449 450 476 478 530 540 555 562 563 566 579 602 632 710 725 727 764 915 921 949 987 1002 1043 1109 1142 1168 1170 1184 1194 1226 1227 1241 1255 1256 1285 1289 1310 1320 
16 17 78 98 101 161 198 215 237 243 270 274 297 310 311 326 335 345 405 423 435 439 459 461 494 533 535 536 552 558 590 654 655 658 699 744 756 770 802 871 897 917 918 932 958 973 1004 1028 1148 1235 1301 1304 
3 28 50 71 76 261 382 384 385 413 465 592 612 677 678 712 724 749 769 777 791 810 823 842 843 862 873 911 925 927 939 976 1061 1086 1088 1089 1092 1132 1136 1153 1176 1190 1197 1274 1284 1314 1316 1340 1341 
0 37 38 68 104 146 165 287 292 293 338 356 367 442 495 498 548 549 557 583 584 609 640 670 682 697 738 758 767 786 787 814 893 919 971 978 1007 1022 1117 1133 1214 1253 1267 1268 1345 
45 96 120 131 231 232 286 378 446 496 507 528 622 633 638 708 746 747 752 763 773 815 816 863 892 1113 1160 1173 1193 1209 1210 1224 1244 1245 1261 
134 139 164 194 312 400 469 470 511 521 657 690 735 827 906 907 938 957 972 1009 1010 1014 1026 1027 1045 1049 1055 1080 1116 1163 1185 1191 1231 1296 1297 
10 11 206 342 351 371 499 500 576 621 694 698 772 796 797 850 851 853 902 935 947 966 993 1111 1122 1145 1222 1240 1248 1262 1292 1349 
154 241 242 369 386 492 509 510 544 567 739 740 750 799 824 828 854 912 1003 1013 1056 1078 1119 1120 1152 1157 1211 1258 1265 1299 1343 1346 
41 72 103 197 497 522 524 541 675 705 706 774 849 882 904 961 982 1008 1031 1032 1166 1175 1229 1232 1252 1264 1344 1350 1351 
84 85 153 201 210 225 300 304 407 412 473 506 617 702 736 821 861 942 956 962 963 1047 1052 1063 1075 1269 1272 1294 1321 
157 211 216 217 229 253 283 372 441 448 551 560 679 680 753 795 855 858 965 1103 1128 1155 1164 1165 1288 1305 1331 
14 15 267 319 341 365 491 565 571 596 597 659 743 766 783 913 968 1025 1050 1051 1090 1161 1230 1242 1303 
118 121 192 290 346 411 568 605 671 731 755 782 825 833 834 864 883 975 1000 1005 1150 1151 1212 1257 1318 
2 54 170 246 249 315 363 364 383 514 643 644 681 811 812 813 819 848 857 1029 1182 1281 
49 196 254 451 482 483 554 603 641 642 761 762 829 830 924 928 1042 1084 1105 1144 1178 
92 105 116 398 455 456 466 490 559 741 775 844 1040 1071 1099 1137 1333 
18 136 160 193 402 713 714 788 1030 1074 1098 1115 1156 1237 1254 1295 
8 289 343 344 399 481 538 577 751 760 1017 1018 1064 1172 1280 
422 586 587 695 716 730 831 832 837 838 950 1015 1057 1228 1283 
58 95 122 200 667 703 745 865 983 1104 1139 1249 1342 
39 127 142 143 223 683 1067 1225 1337 1347 
276 493 661 662 836 986 989 1101 1221 1287 
89 90 222 637 1121 1140 1311 1322 1323 
51 52 221 227 992 1048 1087 1146 
370 380 463 676 691 940 984 994 
159 262 700 719 720 926 1138 
