0 1 6 7 22 29 34 35 36 37 40 42 55 58 73 74 79 82 83 88 136 148 149 178 208 209 212 220 238 246 247 273 280 285 305 315 325 329 339 341 347 368 376 381 387 388 398 401 408 412 421 430 433 464 473 475 484 503 508 510 516 520 529 544 545 568 573 584 586 595 599 608 620 626 627 649 660 664 688 689 695 705 716 730 736 740 745 749 776 781 782 787 791 799 803 813 831 832 835 837 838 846 847 854 859 865 866 884 885 888 890 894 895 899 900 902 903 930 948 953 954 957 964 999 1007 1036 1047 1059 1061 1066 1076 1077 1078 1081 1097 1125 1129 1152 1157 1162 1198 1229 1247 1249 1266 1273 1277 1283 1307 1309 1324 1332 1334 1348 1354 
14 15 28 49 50 51 61 62 84 106 109 145 175 176 184 186 218 219 233 235 241 260 261 267 292 337 348 350 351 385 396 413 450 452 465 479 480 493 494 495 507 509 534 555 565 574 575 580 583 588 597 611 633 646 647 651 672 677 678 709 717 727 735 759 767 771 805 806 810 812 819 826 828 842 860 868 873 876 877 881 896 913 914 968 990 992 1001 1011 1012 1025 1027 1033 1040 1050 1086 1090 1113 1130 1133 1134 1146 1150 1153 1158 1167 1186 1197 1203 1204 1208 1209 1224 1225 1230 1242 1243 1259 1262 1263 1270 1278 1286 1292 1303 1316 1326 1330 1335 1336 1340 1341 1345 
2 5 17 21 26 33 45 52 60 70 91 92 126 129 130 133 147 158 163 166 169 182 194 226 227 228 237 254 271 289 290 293 294 301 302 324 333 343 390 400 403 417 418 451 459 463 469 497 539 577 578 579 587 614 640 654 682 691 693 697 704 707 725 731 763 774 814 820 822 824 848 870 880 901 906 907 916 932 933 941 945 949 950 971 985 1006 1022 1023 1045 1048 1065 1067 1083 1093 1110 1117 1119 1120 1143 1166 1175 1199 1210 1212 1238 1239 1241 1246 1256 1311 
48 56 57 71 105 125 127 128 137 141 157 160 162 167 170 171 188 191 214 216 225 239 264 268 281 288 295 299 300 328 391 393 397 428 431 434 437 446 460 477 486 487 496 501 512 528 536 537 542 546 552 564 567 571 593 600 601 602 605 612 613 616 623 624 634 656 674 692 713 715 718 748 750 758 764 775 777 785 788 801 809 867 891 892 911 937 966 969 979 1057 1068 1069 1103 1107 1108 1109 1124 1135 1156 1169 1177 1217 1234 1290 1295 1299 1302 1306 1319 1346 
4 10 11 44 94 97 100 116 117 119 131 140 206 207 222 243 291 326 346 358 389 394 395 429 438 439 445 447 448 461 466 471 490 491 514 515 523 543 547 607 618 635 683 694 714 726 741 743 755 765 790 794 796 797 800 849 850 851 857 889 946 947 961 976 984 1005 1015 1024 1028 1032 1034 1043 1046 1053 1073 1079 1085 1091 1092 1095 1102 1104 1122 1123 1140 1163 1180 1200 1216 1252 1291 1308 1333 1342 1349 
13 20 46 54 65 75 95 96 103 104 110 111 112 118 135 155 195 200 204 205 249 250 255 256 303 308 321 349 355 361 362 367 379 380 392 474 511 531 541 570 581 589 594 598 615 619 643 644 645 673 676 699 710 721 723 728 732 773 786 804 811 951 952 977 995 997 1000 1002 1004 1060 1136 1170 1188 1201 1206 1233 1275 1313 1325 1327 1328 1339 
18 25 53 68 69 98 121 123 152 172 174 177 180 190 193 221 258 259 272 296 306 323 356 377 383 402 407 415 419 425 443 454 456 467 470 485 498 527 549 582 585 604 650 663 665 686 696 719 720 747 751 815 836 844 875 893 923 925 944 963 972 975 986 1030 1038 1039 1049 1080 1106 1145 1159 1178 1181 1207 1218 1219 1223 1269 1279 1312 1318 
159 231 232 359 364 399 406 416 420 449 455 468 481 482 499 505 513 554 592 617 628 629 641 642 679 680 681 687 711 712 734 823 830 839 840 862 912 924 927 928 935 974 993 994 1019 1020 1042 1064 1084 1098 1137 1138 1144 1147 1149 1155 1161 1164 1165 1182 1189 1193 1194 1227 1228 1237 1240 1253 1260 1267 1268 1276 1288 1305 1331 
8 12 47 72 93 124 144 187 202 203 211 213 217 229 248 262 263 317 318 319 327 332 345 378 435 440 441 476 478 492 502 550 558 560 563 566 622 632 739 753 754 756 766 783 792 798 821 855 915 980 981 987 1031 1082 1094 1114 1115 1244 1245 1254 1261 1272 1289 1300 1343 
19 23 27 59 85 86 122 134 179 198 244 253 270 297 298 316 335 353 365 366 372 410 426 427 533 535 553 559 572 590 596 637 639 653 658 659 669 701 722 742 744 778 795 817 827 845 853 856 864 879 931 936 942 958 962 973 998 1100 1142 1154 1195 1196 1321 1322 1323 
41 63 76 153 154 168 201 210 215 252 269 304 307 342 344 369 382 384 386 409 422 424 504 506 561 569 652 685 757 829 869 871 872 883 898 955 956 991 1003 1029 1037 1051 1056 1058 1063 1075 1087 1088 1089 1105 1121 1148 1202 1211 1214 1248 1258 1265 1281 1294 1301 1338 
30 31 32 38 64 77 87 108 161 173 189 234 309 320 336 340 352 360 432 526 530 532 556 724 738 770 784 802 833 834 897 909 943 970 978 983 988 1052 1070 1071 1151 1187 1205 1213 1231 1257 1271 1293 1310 1315 1317 1320 1329 
3 107 113 114 115 139 150 156 196 197 276 282 283 322 357 370 458 472 525 551 591 603 606 636 638 648 666 667 733 737 752 760 904 905 922 960 982 1009 1010 1026 1054 1116 1132 1139 1173 1183 1185 1191 1222 1282 1296 1297 
24 43 80 120 138 146 230 242 245 257 266 277 286 287 338 363 375 404 444 462 548 668 670 671 684 708 729 789 807 808 825 841 843 858 929 934 967 996 1008 1013 1062 1160 1168 1171 1172 1215 1232 1298 1314 1350 
9 66 78 101 142 143 151 165 275 279 314 334 414 442 609 610 621 630 631 661 662 703 706 746 772 816 863 878 921 940 989 1021 1044 1055 1101 1111 1112 1192 1255 1264 1337 1344 
81 89 90 99 181 183 185 199 278 284 310 311 373 374 483 500 519 524 562 655 657 702 852 874 882 886 887 919 926 959 965 1017 1074 1096 1099 1131 1236 1280 1351 
16 39 67 102 132 192 223 224 240 251 274 354 405 411 457 488 489 576 625 700 779 780 861 908 1035 1041 1072 1118 1220 1221 1235 1287 1347 
164 236 312 313 371 423 436 521 522 538 540 557 675 690 698 761 762 793 938 1014 1016 1128 1141 1176 1226 1285 
265 453 768 769 818 910 917 918 939 1179 1190 1274 1284 1304 
330 331 517 518 920 1018 1184 
