1 12 13 22 23 32 34 36 37 40 42 43 59 63 66 69 86 87 88 93 94 111 119 142 148 149 155 165 189 195 208 212 219 220 234 235 245 250 255 256 257 269 277 278 280 291 296 303 305 308 309 320 322 327 339 340 349 350 352 353 354 360 362 366 374 381 388 392 403 406 414 421 457 467 468 475 489 501 502 503 504 513 516 526 570 573 575 588 594 599 600 608 619 625 626 627 635 647 649 724 765 792 817 845 867 875 877 936 960 979 997 1037 1041 1070 1094 1106 1147 1187 1213 1217 1260 1266 1273 1276 1315 1326 1331 1332 1348 
10 26 30 31 33 97 126 133 135 158 172 180 204 207 271 288 294 301 302 334 356 394 395 429 453 454 461 497 598 636 687 693 707 778 802 820 859 889 899 944 985 1073 1093 1175 1305 1317 
44 178 185 317 372 373 445 462 515 543 618 665 666 674 768 784 790 793 822 916 933 954 970 988 1034 1053 1066 1076 1091 1123 1141 1199 1200 1271 
5 48 56 191 233 393 418 460 542 595 603 624 648 656 715 742 803 809 827 969 996 1079 1124 1135 1177 1223 1234 1290 1302 1306 
81 129 284 285 336 347 396 397 488 556 578 581 582 593 673 688 728 759 1060 1131 1159 1329 
57 237 248 272 318 420 437 530 566 602 710 869 915 987 1046 1194 1206 1241 1310 
19 179 190 215 252 310 311 438 459 552 562 654 655 744 756 1036 
39 127 128 137 171 223 486 564 616 623 683 692 1107 1108 1225 1347 
75 82 83 132 375 391 400 569 652 835 906 907 957 1044 1045 1050 
45 72 378 446 496 528 622 746 747 752 763 773 815 892 1173 
106 176 188 224 260 313 348 419 512 771 974 1068 1208 1270 1275 
181 524 660 675 774 849 961 1166 1216 1229 1232 1243 1350 1351 1354 
254 482 483 606 641 642 829 830 924 928 1084 1105 1144 1239 1312 
16 276 493 494 589 661 662 836 918 967 986 989 1101 1221 
62 73 266 404 646 651 800 876 896 990 1011 1077 1330 1335 
84 85 201 210 412 473 506 531 702 942 1052 1063 1075 1321 
509 510 739 740 828 854 956 1078 1115 1157 1254 1299 1343 
47 147 274 471 798 808 879 880 1065 1082 1083 1235 
107 108 187 203 298 332 389 550 733 754 860 981 
24 136 427 452 517 590 671 781 856 929 1215 
58 200 329 484 667 865 900 983 1139 1237 1249 
14 15 267 565 611 913 968 1004 1236 1242 
18 38 145 405 713 919 1018 1062 1278 1280 
101 209 246 435 480 558 813 1029 1182 1281 
105 116 398 466 490 775 1071 1203 1286 1333 
140 436 447 485 689 841 894 895 1006 1039 
141 238 268 434 534 545 653 672 785 1210 
368 387 520 620 717 776 846 847 1097 1192 
612 677 678 777 791 862 873 911 976 1153 
0 104 367 498 548 549 583 609 978 
3 382 384 385 561 650 843 1088 1089 
96 231 232 507 633 638 679 1209 1224 
99 198 199 270 297 335 533 628 973 
182 282 290 331 605 731 755 975 1212 
342 576 738 772 966 993 1111 1222 1248 
535 536 853 871 872 1148 1262 1292 1301 
6 314 424 519 585 668 686 959 
68 338 640 670 971 1022 1214 1238 
103 197 541 705 706 882 982 1031 
120 708 816 1160 1193 1244 1245 1261 
139 164 521 878 1026 1027 1055 1116 
146 230 287 441 682 786 787 1168 
152 221 295 359 523 757 794 910 
273 328 537 729 903 1014 1016 1319 
306 361 433 508 770 909 953 1081 
7 383 390 474 748 1136 1328 
9 21 125 279 901 1143 1183 
46 275 409 425 527 718 1096 
113 114 525 615 737 1103 1114 
162 262 700 719 720 926 1138 
193 469 470 511 972 1049 1074 
299 369 749 750 799 1265 1346 
343 344 481 538 577 751 760 
529 664 780 930 1033 1035 1162 
11 292 607 694 767 1345 
25 78 91 213 214 610 
27 60 100 163 417 870 
35 177 333 852 922 991 
51 52 227 1048 1087 1146 
154 225 386 1003 1056 1258 
192 346 411 568 864 883 
206 499 500 714 946 947 
211 216 229 283 560 753 
239 788 958 1069 1098 1295 
371 698 1104 1122 1342 1349 
629 801 807 898 1038 1202 
769 939 1190 1274 1284 1316 
796 797 824 851 1119 1120 
884 885 952 977 999 1277 
1009 1010 1185 1191 1296 1297 
17 244 410 850 1291 
61 376 1001 1100 1318 
65 263 379 732 804 
79 443 574 580 1110 
118 264 416 696 721 
124 722 980 1189 1196 
150 151 377 1118 1255 
202 324 464 477 1129 
205 955 1201 1327 1338 
218 669 995 1102 1125 
240 241 492 1013 1152 
249 681 811 812 857 
293 495 697 1117 1253 
300 962 963 1047 1269 
316 572 639 839 840 
351 621 902 935 1240 
357 478 579 632 1256 
401 450 630 921 1043 
407 617 861 1272 1294 
408 432 701 905 1233 
472 547 917 1163 1179 
680 1155 1164 1165 1288 
684 685 1121 1279 1298 
690 789 941 1289 1300 
730 950 1015 1057 1228 
833 834 1150 1151 1257 
868 1112 1134 1246 1263 
2 514 644 819 
20 259 415 1325 
28 50 71 465 
29 76 927 1176 
41 522 904 1021 
49 451 761 762 
53 261 413 842 
74 123 727 1002 
89 90 222 1311 
95 122 703 745 
98 130 932 1080 
102 319 766 1059 
109 487 826 1109 
112 169 226 1169 
115 458 584 1259 
134 735 1198 1231 
138 881 934 1171 
160 161 243 897 
166 908 1220 1287 
168 251 723 1058 
174 442 758 814 
183 184 337 1130 
186 782 964 1054 
194 505 657 923 
196 554 1042 1178 
217 734 1019 1304 
325 591 645 1023 
326 699 951 992 
358 518 726 920 
365 659 783 1161 
370 380 676 984 
399 1017 1064 1172 
402 823 925 1030 
422 586 587 831 
455 456 741 1040 
463 691 940 994 
540 1170 1226 1285 
555 725 1020 1184 
704 779 825 1314 
893 1181 1218 1219 
943 948 1205 1247 
998 1024 1154 1167 
1025 1090 1230 1303 
55 945 1186 
64 532 631 
80 173 476 
92 559 1099 
110 175 330 
117 553 931 
121 253 1005 
144 563 914 
153 307 601 
156 157 1128 
159 1000 1156 
170 363 364 
242 544 1211 
304 736 821 
355 937 1282 
423 439 1028 
428 539 634 
430 890 1072 
440 604 1085 
448 795 858 
449 1227 1320 
551 855 965 
557 866 1007 
571 596 597 
592 1061 1132 
695 716 832 
711 712 1158 
805 806 1336 
837 838 1283 
874 886 887 
891 1012 1133 
1008 1032 1252 
