9 27 31 44 46 60 64 77 100 117 129 141 152 157 163 178 182 185 186 198 215 217 236 238 265 270 275 279 281 282 295 297 310 311 316 317 335 358 359 370 372 373 380 391 394 409 417 425 428 434 444 445 459 462 479 494 523 527 532 533 534 535 536 539 543 545 551 552 553 572 589 590 618 631 634 639 653 654 655 658 663 665 666 671 672 673 674 676 718 722 726 734 744 756 757 768 770 782 784 785 790 793 794 818 822 839 840 855 870 871 878 899 910 916 917 918 920 931 933 938 943 948 953 954 958 964 965 970 973 984 988 1019 1021 1024 1034 1053 1054 1066 1076 1091 1095 1096 1123 1128 1141 1148 1180 1196 1199 1200 1205 1243 1247 1265 1271 1293 1301 1304 
1 12 13 22 23 32 34 36 40 42 43 53 55 59 63 66 69 86 87 93 94 111 119 130 148 149 156 174 189 195 208 212 219 220 234 235 245 250 252 255 257 258 259 269 272 277 278 280 296 303 305 306 308 309 320 322 325 327 339 340 349 350 352 353 355 360 361 362 366 374 381 388 392 403 406 410 414 421 433 438 440 443 467 468 475 501 502 503 504 508 513 515 516 526 570 573 575 588 591 594 599 600 604 606 608 619 626 627 635 645 649 780 792 817 845 867 872 875 877 891 908 909 936 937 960 979 997 1012 1023 1035 1037 1058 1081 1106 1147 1162 1187 1213 1217 1238 1239 1260 1266 1273 1282 1309 1315 1332 1334 1348 
39 47 48 56 61 62 73 106 109 115 128 137 140 142 143 147 171 176 188 191 223 224 233 237 260 264 266 313 348 393 404 408 416 418 419 431 432 436 447 458 460 471 485 486 487 512 542 564 584 614 616 623 624 646 647 648 651 656 692 696 701 715 721 723 742 771 798 800 803 805 806 808 809 823 826 841 868 874 876 879 880 894 895 896 905 932 946 969 974 990 996 1001 1006 1011 1039 1065 1067 1068 1077 1079 1082 1083 1100 1107 1108 1112 1124 1134 1135 1177 1203 1207 1208 1223 1233 1234 1246 1259 1263 1270 1275 1276 1286 1290 1302 1306 1313 1326 1328 1330 1335 1336 1337 1339 1347 
4 20 21 26 30 33 65 70 88 97 99 112 124 133 135 155 158 169 172 180 199 204 207 226 244 256 263 268 271 288 291 294 301 302 323 334 354 356 368 379 395 415 429 453 454 461 499 505 520 598 615 628 636 687 693 711 724 732 737 765 778 789 802 804 859 881 889 901 922 923 934 941 944 985 998 1020 1070 1073 1093 1094 1103 1114 1143 1154 1158 1167 1169 1183 1189 1195 1198 1228 1278 1300 1317 1325 
0 18 37 38 51 52 68 104 146 165 183 184 221 227 239 287 292 293 337 338 367 442 448 495 498 548 549 583 609 640 670 682 697 709 713 714 738 758 767 786 787 788 814 835 858 893 919 971 978 992 1022 1048 1069 1087 1098 1115 1117 1130 1133 1146 1204 1214 1237 1249 1253 1254 1267 1268 1295 1345 
5 7 19 75 81 82 83 126 132 138 179 218 284 285 307 336 347 390 396 397 430 457 464 474 477 488 489 556 561 562 569 578 581 582 593 595 601 625 669 688 704 707 728 748 759 779 795 820 890 945 951 980 995 1041 1060 1072 1102 1118 1125 1129 1131 1136 1159 1181 1218 1219 1312 1329 
80 101 107 108 113 114 170 173 187 202 203 228 247 298 363 375 387 389 400 463 525 531 611 612 613 620 630 652 691 717 733 776 813 846 847 860 888 906 907 911 940 957 967 994 1029 1036 1044 1045 1046 1062 1085 1097 1149 1171 1192 1236 1281 
6 29 57 74 123 144 145 166 190 197 230 248 318 357 376 401 420 426 437 449 450 476 478 530 540 555 563 566 579 585 602 607 632 686 710 725 727 764 915 921 987 1002 1043 1142 1168 1170 1184 1194 1206 1226 1241 1256 1285 1289 1310 
24 136 139 164 193 194 312 330 427 469 470 511 517 518 521 657 684 685 690 781 827 856 884 885 929 952 955 972 977 999 1009 1010 1014 1016 1026 1027 1049 1055 1074 1080 1086 1116 1156 1163 1185 1191 1215 1277 1279 1296 1297 1298 1307 1308 
45 96 120 131 162 231 232 261 286 378 413 446 496 507 528 622 633 638 679 680 708 746 747 752 763 773 810 815 816 842 863 892 1113 1155 1160 1164 1165 1173 1193 1209 1210 1224 1225 1244 1245 1261 1288 1305 1331 
3 28 50 71 76 240 324 382 384 385 465 592 650 677 678 712 749 769 777 791 843 862 873 925 927 939 976 1033 1061 1088 1089 1092 1132 1153 1176 1190 1197 1274 1284 1314 1316 1340 1341 
41 72 89 90 103 222 497 522 524 541 637 675 705 706 774 849 882 904 961 982 1008 1031 1032 1121 1140 1166 1175 1229 1232 1252 1264 1311 1322 1323 1344 1350 1351 
14 15 267 319 332 341 345 365 435 491 550 560 565 571 596 597 659 743 754 766 783 913 968 981 1025 1050 1051 1090 1161 1230 1242 1303 
154 225 241 242 369 386 492 509 510 544 567 739 740 750 799 824 828 854 912 1003 1013 1056 1078 1119 1120 1152 1157 1211 1258 1299 1343 1346 
25 91 110 175 209 213 214 273 299 321 328 329 484 537 546 610 629 729 801 807 865 869 898 900 903 914 1038 1188 1202 1319 1324 
118 181 192 290 331 346 411 452 480 568 605 731 755 825 833 834 864 883 975 1000 1150 1151 1186 1212 1257 
159 262 342 351 576 621 700 719 720 772 853 902 926 935 966 993 1111 1138 1222 1240 1248 1262 1292 
84 85 153 201 210 300 412 473 506 702 942 956 962 963 1047 1052 1063 1075 1269 1321 
92 105 116 398 455 456 466 490 559 741 775 844 1018 1040 1071 1099 1137 1280 1333 
2 54 246 249 315 364 383 514 643 644 681 811 812 819 848 857 1182 
16 17 78 98 127 243 274 326 405 423 439 557 683 699 1004 1028 1235 
10 11 161 206 371 500 529 664 694 698 897 930 947 1122 1145 1349 
35 160 205 314 402 660 689 866 1007 1030 1201 1216 1220 1327 1338 1354 
196 254 482 483 554 641 642 829 830 924 928 1042 1084 1105 1144 1178 
79 276 493 558 574 580 661 662 836 986 989 1101 1110 1221 1287 
422 586 587 695 716 730 831 832 837 838 950 1015 1057 1283 
121 134 211 216 229 253 283 441 735 753 1005 1231 1318 
58 95 122 200 667 703 745 983 1104 1139 1342 
8 289 399 1017 1064 1172 1227 1320 
177 424 519 668 852 886 887 959 
304 407 617 736 821 861 1272 1294 
125 150 151 377 949 1109 1255 
343 344 481 538 577 751 760 
67 102 167 168 251 1059 
49 451 603 761 762 
333 472 547 991 1179 
796 797 850 851 1291 
