0 1 12 13 22 23 32 36 37 42 43 44 48 53 54 55 59 63 64 65 66 75 79 83 86 87 88 93 94 95 96 108 111 112 149 155 174 189 195 200 204 205 208 212 218 219 220 234 235 242 245 250 255 256 257 259 269 272 277 278 285 296 303 304 305 306 307 308 309 321 322 327 339 340 341 349 353 355 360 361 374 375 379 381 388 398 403 407 415 416 421 443 457 467 468 473 475 489 490 502 503 504 508 526 563 573 578 579 588 594 599 608 625 626 627 656 681 688 724 728 736 751 770 786 790 798 803 812 866 867 873 877 890 899 926 936 942 952 953 980 993 997 1002 1029 1061 1070 1071 1106 1114 1122 1137 1138 1146 1147 1159 1160 1167 1168 1187 1213 1234 1247 1248 1270 1272 1306 1310 1315 1325 1349 
6 7 16 24 25 34 35 40 41 58 67 73 74 76 80 81 84 85 113 123 132 142 147 148 150 157 168 169 177 190 227 291 292 314 315 328 329 346 366 382 384 401 402 408 412 422 424 464 466 484 488 516 519 531 535 545 546 547 574 575 584 585 593 607 612 613 629 657 663 667 668 675 686 689 700 738 745 758 775 779 780 788 791 792 793 807 814 832 836 843 846 854 865 874 875 883 885 886 900 902 911 948 955 967 986 994 1006 1011 1012 1024 1032 1054 1058 1085 1089 1094 1100 1102 1109 1111 1113 1117 1118 1124 1125 1131 1149 1162 1166 1175 1179 1193 1197 1202 1220 1221 1232 1240 1244 1245 1252 1260 1261 1271 1273 1287 1294 1327 1332 1333 1338 1350 
8 9 20 101 102 124 146 187 188 202 203 211 216 217 221 229 230 246 247 252 262 263 276 319 320 331 332 333 334 345 354 357 365 399 431 435 440 441 476 491 492 505 550 551 558 560 561 592 622 632 635 698 733 735 753 754 756 766 783 823 852 860 862 870 934 935 975 981 987 995 1036 1038 1067 1087 1121 1129 1211 1281 
10 56 57 69 120 125 126 131 135 158 160 172 173 236 237 238 248 268 288 294 352 378 428 429 430 434 461 495 496 534 541 552 595 648 653 672 742 747 801 841 863 933 941 976 996 1008 1020 1064 1073 1088 1103 1173 1177 1194 1195 1206 1210 1223 1233 1243 1289 1300 1328 
27 46 68 82 107 121 122 134 140 141 166 167 179 194 253 284 289 290 324 343 400 413 423 426 427 451 452 494 520 572 590 628 637 639 652 655 658 669 704 712 744 778 795 827 835 845 856 931 957 1007 1044 1045 1212 1231 1276 1348 
153 154 225 226 299 300 368 369 386 387 506 510 536 537 600 601 677 678 684 685 702 729 749 750 765 776 777 781 799 817 828 903 998 1003 1056 1057 1154 1169 1172 1215 1258 1264 1298 1307 1308 1319 1321 1346 
4 5 26 30 33 45 97 98 133 152 161 180 243 244 254 271 279 301 302 436 447 453 454 481 485 498 577 598 687 693 802 818 910 932 944 985 1320 
2 3 21 105 106 109 110 176 224 233 260 261 347 348 393 419 420 437 512 571 597 634 715 771 809 819 901 915 974 1139 1142 1143 1183 1208 1275 
127 128 136 137 170 171 191 192 223 264 265 460 477 478 486 487 542 564 616 623 624 691 692 710 721 1068 1083 1107 1108 1112 1135 1241 1290 1302 1347 
28 29 38 39 60 139 185 186 370 371 444 465 532 636 659 666 671 699 764 782 810 937 960 964 1019 1104 1199 1224 1278 
11 118 119 207 222 391 392 395 448 499 500 570 589 615 714 726 797 800 804 889 946 947 951 1042 1079 
258 293 338 350 356 367 383 548 549 557 582 583 604 609 696 869 893 895 940 978 1039 1178 1269 
77 144 145 175 201 209 210 281 282 330 517 518 565 569 914 1046 1050 1051 1052 1063 1075 1105 
14 15 115 267 326 396 513 596 649 743 913 968 1004 1025 1090 1153 1158 1230 1242 1303 
47 99 100 159 275 295 358 359 394 425 462 471 523 665 757 794 927 943 1021 1253 
91 92 213 214 232 397 458 474 556 581 610 619 713 773 1040 1115 1136 1254 1299 1344 
70 71 72 239 446 497 501 605 746 748 752 767 785 815 892 979 991 1345 
509 515 524 555 567 568 739 740 741 956 1013 1059 1078 1152 1157 1236 1343 1351 
61 62 646 647 805 806 826 868 906 907 1134 1246 1263 1326 1330 1335 1336 
116 266 480 651 730 831 876 896 949 950 963 990 1015 1047 1228 1259 1266 
17 312 313 469 521 522 554 633 690 761 789 1014 1016 1055 1128 1163 
78 493 661 662 769 774 847 917 918 970 989 1101 1190 1274 1284 1316 
336 364 411 614 731 808 864 879 880 887 962 1065 1082 1155 1235 1329 
103 104 156 196 197 251 472 703 727 904 905 922 982 1060 
162 163 389 390 417 418 538 707 708 763 820 945 1093 1186 
206 249 311 342 514 643 644 732 811 848 857 1145 1182 1198 
31 231 409 410 527 528 539 718 840 923 969 1096 1291 
164 165 406 414 576 580 630 631 772 816 844 878 1171 
215 310 325 362 438 439 459 562 654 882 894 1028 1304 
117 316 317 372 373 445 755 768 939 1005 1034 1066 
283 529 530 664 694 695 839 859 930 999 1035 1317 
178 351 784 954 1076 1077 1080 1098 1237 1295 1318 
193 323 376 470 511 821 925 972 1030 1049 1072 
432 673 674 701 705 722 723 921 938 1043 1196 
482 483 641 642 734 829 830 924 928 1084 1144 
198 199 270 297 298 335 533 958 959 973 
129 130 344 591 606 638 891 1001 1239 
151 318 363 380 855 966 1170 1189 1209 
183 184 337 611 709 759 1069 1130 1204 
404 405 737 760 919 1017 1062 1181 1207 
479 587 1074 1132 1217 1256 1282 1293 
650 725 796 824 912 1119 1120 1201 
51 52 228 992 1022 1023 1048 
433 525 602 603 762 1081 1262 
449 450 719 1086 1116 1156 1255 
18 19 553 559 566 787 
49 50 617 618 1205 1314 
181 182 822 849 1222 1225 
240 241 273 274 385 929 
286 287 682 858 908 1249 
645 884 977 988 1091 1277 
660 683 1092 1216 1229 1354 
871 872 1037 1148 1265 1301 
1009 1010 1185 1191 1296 1297 
280 888 898 1097 1192 
377 455 456 670 1214 
442 463 640 697 971 
679 680 1164 1305 1331 
833 834 1150 1151 1257 
89 965 1140 1161 
90 920 1110 1311 
138 720 881 1184 
540 1226 1227 1285 
586 837 838 1283 
620 621 716 717 
711 842 1026 1027 
825 850 851 1133 
916 1053 1123 1200 
114 813 909 
676 706 1031 
853 1033 1292 
861 897 1141 
983 984 1342 
1018 1099 1280 
1126 1127 1174 
1165 1279 1288 
1218 1219 1312 
