0 1 11 15 22 23 34 36 37 40 59 61 83 84 85 86 88 115 134 136 148 149 178 198 199 201 208 212 220 222 238 270 280 285 297 298 304 335 339 341 347 360 368 376 381 387 388 401 408 421 427 430 433 470 473 475 503 507 508 509 510 533 535 544 555 557 573 584 593 599 607 608 612 620 621 626 627 635 649 652 672 674 677 678 688 694 705 724 726 736 740 741 742 749 765 767 770 776 781 787 788 791 799 803 817 827 828 832 835 846 847 853 854 859 869 876 877 888 890 899 911 942 948 953 956 957 959 964 972 973 998 1007 1011 1024 1044 1049 1059 1061 1078 1097 1100 1148 1150 1152 1153 1154 1157 1195 1198 1229 1236 1247 1259 1266 1273 1307 1308 1309 1321 1332 1334 1340 1341 1345 1348 
48 56 57 71 77 87 105 108 109 110 118 119 127 128 137 141 158 160 161 162 170 171 188 191 192 207 225 231 232 239 264 268 281 299 300 328 352 362 391 393 397 416 425 429 434 437 446 447 450 460 474 477 482 486 487 496 501 512 528 530 532 536 537 542 546 552 556 564 567 571 579 595 600 601 602 616 623 624 641 642 645 646 656 673 679 680 691 692 713 715 718 719 723 734 748 750 775 777 784 785 801 809 826 830 851 884 885 891 892 909 924 928 952 958 961 966 969 977 979 984 1019 1041 1057 1060 1068 1069 1073 1084 1104 1107 1108 1109 1124 1134 1135 1144 1147 1155 1156 1164 1165 1169 1170 1177 1217 1233 1234 1241 1256 1277 1288 1290 1293 1295 1299 1302 1305 1306 1315 1317 1319 1331 1342 1346 
13 20 47 54 65 72 75 78 93 95 96 111 112 124 132 142 143 155 195 200 204 205 213 224 237 248 249 250 255 256 275 303 305 308 317 318 321 327 349 353 354 355 361 367 375 378 379 380 392 424 428 478 488 489 502 506 511 531 540 547 566 589 605 609 610 619 625 637 643 644 661 662 676 702 706 721 722 728 732 739 773 786 792 798 804 811 815 855 866 915 980 987 989 995 996 997 1002 1031 1046 1082 1094 1101 1115 1136 1146 1163 1188 1201 1206 1226 1244 1245 1254 1261 1264 1285 1289 1300 1322 1323 1325 1337 1343 
6 12 14 16 35 103 104 107 113 114 139 150 156 157 196 197 209 235 246 247 251 263 267 276 282 283 322 323 324 336 337 357 370 396 411 458 472 523 525 529 550 551 563 565 580 583 591 603 606 611 636 638 648 653 664 666 667 695 700 709 712 733 737 752 759 760 779 780 782 813 821 904 905 913 919 922 930 960 968 982 999 1004 1009 1010 1021 1025 1026 1029 1033 1035 1054 1090 1116 1118 1125 1132 1139 1162 1173 1175 1185 1191 1204 1222 1230 1262 1272 1278 1281 1282 1292 1296 1297 1303 1329 1344 
5 33 45 55 70 79 91 92 126 133 147 163 164 166 180 194 236 254 265 274 289 290 293 294 301 302 316 343 371 400 403 423 436 453 454 463 520 538 539 559 577 640 654 675 682 687 693 697 698 707 738 761 762 763 768 769 772 774 793 814 818 820 833 834 857 879 880 897 906 907 910 917 918 932 933 939 944 945 971 1022 1045 1065 1066 1083 1093 1099 1110 1117 1122 1141 1151 1179 1186 1190 1210 1231 1235 1246 1257 1274 1284 1311 1312 1349 
4 10 41 44 46 100 116 131 135 140 146 167 172 173 206 214 216 287 291 295 325 326 346 358 359 365 389 394 395 431 432 438 439 445 448 461 466 471 490 499 514 515 541 543 570 615 618 639 665 683 689 699 701 714 743 755 757 758 764 790 794 797 800 802 841 849 889 894 895 937 946 947 951 976 983 993 1005 1015 1034 1042 1043 1053 1064 1079 1087 1091 1092 1095 1102 1103 1123 1140 1168 1180 1196 1200 1203 1214 1216 1252 1333 
30 31 32 42 49 50 64 154 168 189 202 218 219 234 240 241 261 273 309 340 350 351 386 404 413 457 464 495 574 581 588 634 651 685 710 717 810 812 829 842 843 861 902 903 943 954 970 978 1000 1003 1013 1027 1040 1047 1056 1058 1070 1071 1086 1121 1129 1167 1187 1197 1205 1212 1213 1232 1248 1258 1275 1294 1310 1313 1339 1350 
3 29 51 63 76 101 120 151 153 159 215 223 243 252 307 314 315 320 342 344 366 369 382 384 385 480 504 526 554 558 561 568 586 597 632 681 711 744 756 837 838 871 872 883 898 927 991 1014 1036 1037 1051 1062 1072 1085 1088 1089 1111 1114 1160 1166 1171 1176 1182 1183 1189 1202 1211 1255 1265 1271 1283 1301 1347 
18 19 25 68 69 94 97 121 123 152 174 177 179 190 193 221 244 259 269 272 296 306 356 377 383 402 407 409 410 415 419 443 456 467 485 516 527 553 585 650 663 686 747 751 836 844 850 867 875 893 914 923 1028 1030 1032 1038 1039 1075 1106 1145 1178 1181 1207 1218 1219 1223 1328 
8 9 28 62 102 125 138 187 203 211 217 229 262 319 406 412 435 440 441 449 455 465 468 481 491 492 505 560 592 598 617 622 628 629 670 720 735 753 754 766 783 823 839 840 862 896 912 925 934 935 981 990 1001 1098 1137 1138 1161 1227 1253 1267 1268 1286 1320 1330 
186 292 312 313 363 364 399 405 420 444 462 479 493 494 513 521 522 534 575 594 596 613 633 647 668 690 708 725 727 789 796 805 806 824 860 873 881 938 967 974 994 1012 1016 1020 1050 1113 1119 1120 1128 1133 1149 1158 1193 1194 1209 1228 1240 1242 1260 1276 1316 1326 1335 1336 
17 39 53 60 81 89 90 181 182 185 271 278 284 310 311 332 333 390 417 422 469 483 500 524 562 587 614 655 657 660 696 731 822 852 874 882 886 887 916 941 955 965 975 985 992 1017 1131 1224 1225 1243 1280 1291 1327 1338 1351 1354 
24 27 43 80 117 122 230 242 245 253 257 258 277 286 338 345 372 426 452 476 498 548 549 572 582 590 604 658 669 671 684 704 729 778 795 807 808 825 845 856 858 864 929 931 936 962 963 1008 1142 1159 1172 1215 1269 1279 1298 1314 
7 26 52 58 67 73 74 98 99 169 183 184 226 329 373 374 459 484 497 519 545 659 716 730 745 831 848 865 900 908 926 949 950 986 1067 1074 1076 1080 1096 1130 1220 1221 1237 1249 1287 1304 1318 1324 
38 82 106 144 145 175 176 210 227 228 233 260 288 330 331 348 398 418 517 518 569 771 819 920 988 1006 1018 1023 1048 1052 1063 1077 1081 1105 1184 1199 1208 1270 
2 21 66 129 130 165 266 279 334 414 442 451 576 578 630 631 703 746 816 863 868 870 878 901 921 940 1055 1112 1143 1192 1238 1239 1263 
