6 7 13 25 29 35 40 53 55 58 63 67 68 69 73 74 79 83 121 144 148 149 153 177 178 190 193 201 210 252 269 296 306 321 329 342 344 376 377 383 401 402 412 415 419 424 443 456 467 484 485 503 504 506 516 527 545 546 568 569 585 607 621 660 663 667 686 695 696 712 740 745 749 781 791 832 844 854 865 869 871 872 875 884 885 898 899 900 908 922 923 925 936 956 972 975 979 1030 1037 1039 1049 1051 1059 1063 1066 1075 1078 1105 1106 1145 1157 1178 1217 1220 1221 1237 1247 1249 1266 1273 1277 1301 1309 1318 1334 1348 1354 
48 56 57 105 116 127 128 137 141 157 160 162 170 171 184 188 191 192 239 264 268 281 285 299 300 328 341 346 347 391 393 408 434 437 446 460 486 487 496 501 512 528 536 537 542 552 564 567 571 584 593 595 600 601 602 612 613 616 623 624 649 656 657 688 691 692 709 713 715 750 775 777 785 795 801 809 864 891 892 905 911 962 963 966 969 1057 1068 1069 1107 1108 1109 1115 1124 1130 1135 1156 1177 1204 1211 1234 1241 1254 1269 1272 1290 1295 1299 1302 1306 1319 1343 1346 
4 10 11 44 100 117 131 140 167 206 207 214 216 243 265 295 316 326 359 392 395 439 445 447 448 461 466 471 490 491 514 515 523 541 543 570 618 635 683 694 714 743 755 758 794 796 797 800 818 849 857 889 910 937 946 947 964 976 984 993 1005 1015 1034 1053 1092 1102 1103 1122 1123 1140 1200 1216 1252 1333 1349 
5 18 33 45 46 70 88 98 123 129 130 133 135 146 152 158 204 244 254 287 291 301 302 325 349 358 363 406 407 425 429 430 454 462 468 577 579 617 665 668 693 708 719 764 765 820 827 829 841 851 867 912 944 959 961 998 1007 1032 1043 1061 1064 1073 1097 1137 1138 1154 1168 1238 1239 1256 1307 1308 1312 1321 
8 9 12 17 47 71 72 93 96 187 202 203 205 211 213 217 229 248 262 263 304 317 318 319 345 378 389 426 435 440 441 476 478 492 497 509 510 540 560 563 566 605 622 632 677 678 689 739 748 753 754 766 783 798 799 821 828 850 866 915 980 981 987 996 1031 1082 1094 1114 1142 1175 1201 1289 1291 
0 1 15 22 34 36 42 94 119 169 174 208 212 220 238 259 267 272 324 327 356 360 381 388 394 421 438 475 573 599 606 608 626 627 650 652 674 726 736 751 787 788 803 824 893 948 957 968 1025 1038 1058 1079 1090 1119 1120 1196 1230 1294 1303 1332 
38 77 108 110 136 180 221 227 228 237 288 289 352 362 368 397 418 431 432 473 474 520 530 531 532 539 556 557 671 704 707 738 784 825 833 834 835 897 932 933 945 988 1022 1023 1024 1048 1052 1151 1181 1199 1207 1218 1219 1223 1257 1293 1314 1315 1317 1328 
14 102 103 104 107 113 114 197 209 241 251 261 276 282 322 323 336 337 396 413 458 495 525 565 583 603 611 653 717 724 733 752 759 760 782 810 842 904 913 960 982 1027 1050 1070 1132 1139 1167 1222 1236 1242 1275 1278 1282 1313 1329 1339 
30 49 50 186 218 219 235 292 350 351 361 385 403 404 464 477 479 493 507 555 574 575 580 588 727 767 812 843 860 873 978 1013 1033 1040 1071 1086 1113 1129 1133 1136 1150 1153 1187 1197 1205 1209 1232 1248 1262 1292 1310 1316 1340 1341 1345 1350 
41 76 101 115 154 215 225 226 246 247 307 314 369 382 384 386 387 409 529 558 561 562 596 664 756 757 813 868 883 930 991 999 1002 1003 1029 1036 1044 1046 1056 1085 1087 1088 1089 1112 1169 1202 1214 1258 1263 1281 1327 1336 1338 
16 26 39 51 60 78 132 142 143 223 274 315 332 405 411 417 457 459 488 489 576 597 614 625 661 662 700 747 779 780 790 848 861 879 989 1035 1041 1067 1072 1080 1095 1101 1118 1146 1163 1180 1235 1264 1287 1337 1347 
2 21 24 43 80 120 138 242 245 257 258 277 286 338 375 444 451 498 548 549 578 582 594 604 670 684 685 729 789 807 808 858 870 881 901 929 934 955 967 1008 1062 1143 1159 1160 1166 1171 1172 1215 1279 1298 
150 156 173 182 196 283 357 550 551 636 639 648 666 687 699 725 802 855 941 951 983 992 994 1004 1020 1054 1104 1193 1194 1260 1342 
3 23 85 86 118 139 370 581 591 638 645 710 737 741 942 952 977 1000 1009 1010 1026 1116 1173 1183 1185 1191 1195 1296 1297 1300 
28 61 62 84 109 465 646 647 651 672 735 805 806 826 876 877 896 990 1001 1011 1134 1158 1203 1259 1276 1286 1326 1330 1335 
19 27 122 134 179 253 365 372 427 470 553 554 572 590 658 669 701 722 742 773 778 845 856 927 931 1042 1100 1176 
231 232 364 399 420 482 505 513 641 642 734 830 839 840 853 862 924 928 935 974 1019 1084 1144 1149 1155 1228 1240 
66 165 230 266 275 279 334 414 442 609 610 630 631 703 746 814 816 863 878 921 940 1021 1055 1192 
75 111 172 195 224 250 256 305 353 354 598 619 637 673 676 723 786 815 995 1060 1170 1233 1322 1323 
37 54 87 155 161 249 303 355 367 544 547 643 644 681 711 721 728 732 909 1182 1189 1206 1231 
20 65 112 124 200 308 379 380 502 511 589 615 628 629 720 792 811 1198 1244 1245 1261 1325 
59 198 270 297 298 335 422 494 499 533 535 633 817 958 973 1012 1125 1148 1162 1265 
164 312 313 333 423 469 472 521 522 690 761 762 793 822 938 985 1014 1016 1128 1285 
91 92 147 166 194 343 559 654 682 774 880 906 907 1045 1065 1083 1093 1110 1246 
31 32 64 189 234 309 320 340 428 526 634 718 770 943 953 970 1213 1271 
81 284 310 311 483 500 655 852 874 882 886 887 919 965 1017 1099 1131 1280 
89 90 168 185 222 255 278 524 1121 1152 1224 1225 1243 1311 1351 
126 163 290 293 294 400 463 640 697 763 971 1117 1210 
280 433 508 705 706 776 846 847 859 888 890 1229 1344 
99 159 183 199 373 374 519 659 702 926 1074 1096 
106 145 175 176 233 260 348 771 819 914 1208 1270 
52 95 125 151 730 772 831 949 950 1111 1255 
390 586 587 620 716 731 837 838 916 1212 1283 
453 768 769 917 918 939 1179 1190 1274 1284 1304 
236 371 436 538 675 698 894 895 1006 1141 
679 680 1164 1165 1253 1267 1268 1288 1305 1331 
97 366 410 744 804 836 986 997 1028 
339 416 455 481 592 823 1098 1147 1161 
240 273 902 903 954 1047 1091 
330 331 517 518 920 1018 1184 
181 271 452 480 534 1186 
82 398 1076 1077 1081 
449 450 1226 1227 1320 
