48 56 57 71 105 125 127 128 137 141 157 160 162 167 170 171 188 191 214 216 225 239 264 268 281 288 295 299 300 328 391 393 397 428 431 434 437 446 460 477 486 487 496 501 512 528 536 537 542 546 552 564 567 571 593 600 601 602 605 612 613 616 623 624 634 656 674 692 713 715 718 748 750 758 764 775 777 785 788 801 809 867 891 892 911 937 966 969 979 1057 1068 1069 1103 1107 1108 1109 1124 1135 1156 1169 1177 1217 1234 1290 1295 1299 1302 1306 1319 1346 
0 1 22 34 36 37 40 42 55 79 82 83 88 136 148 149 178 208 212 220 238 273 280 285 305 325 339 341 347 368 376 381 387 388 398 408 412 421 430 433 464 473 475 503 508 510 516 520 529 544 573 584 595 599 608 620 626 627 649 664 688 695 705 716 730 736 749 776 781 787 791 799 803 831 832 835 846 847 859 888 890 899 902 903 930 948 953 954 957 1047 1066 1076 1077 1081 1097 1125 1129 1162 1198 1229 1247 1266 1273 1307 1309 1332 1334 1348 
4 10 11 44 94 97 100 116 117 119 131 140 206 207 222 243 291 326 346 358 389 394 395 429 438 439 445 447 448 461 466 471 490 491 514 515 523 543 547 607 618 635 683 694 714 726 741 743 755 765 790 794 796 797 800 849 850 851 857 889 946 947 961 976 984 1005 1015 1024 1028 1032 1034 1043 1046 1053 1073 1079 1085 1091 1092 1095 1102 1104 1122 1123 1140 1163 1180 1200 1216 1252 1291 1308 1333 1342 1349 
13 20 46 54 65 75 95 96 103 104 110 111 112 118 135 155 195 200 204 205 249 250 255 256 303 308 321 349 355 361 362 367 379 380 392 474 511 531 541 570 581 589 594 598 615 619 643 644 645 673 676 699 710 721 723 728 732 773 786 804 811 951 952 977 995 997 1000 1002 1004 1060 1136 1170 1188 1201 1206 1233 1275 1313 1325 1327 1328 1339 
18 25 53 68 69 123 152 172 174 177 180 190 193 221 258 259 272 296 306 323 356 377 383 402 407 415 419 425 443 456 467 470 485 498 527 549 582 585 604 650 663 665 686 696 719 720 747 751 815 836 844 875 893 923 925 963 972 975 1030 1038 1039 1049 1106 1145 1159 1178 1181 1207 1218 1219 1223 1269 1279 1312 
8 12 47 72 93 124 144 187 202 203 211 213 217 229 248 262 263 317 318 319 327 332 345 378 435 440 441 476 478 492 502 550 558 560 563 566 622 632 739 753 754 756 766 783 792 798 821 855 915 980 981 987 1031 1082 1094 1114 1115 1244 1245 1254 1261 1272 1289 1300 1343 
30 31 32 38 64 77 87 108 161 173 189 234 309 320 336 340 352 360 432 526 530 532 556 724 738 770 784 802 833 834 897 909 943 970 978 983 988 1052 1070 1071 1151 1187 1205 1213 1231 1257 1271 1293 1310 1315 1317 1320 1329 
14 15 28 61 62 84 109 184 267 337 396 465 565 611 646 647 651 672 709 735 759 805 806 826 868 876 877 896 913 968 990 1001 1011 1025 1050 1090 1130 1134 1158 1203 1204 1230 1242 1259 1263 1286 1303 1326 1330 1335 1336 
24 43 80 120 138 146 230 242 245 257 266 277 286 287 338 363 375 404 444 462 548 668 670 671 684 708 729 789 807 808 825 841 843 858 929 934 967 996 1008 1013 1062 1160 1168 1171 1172 1215 1232 1298 1314 1350 
159 231 232 359 416 449 455 481 482 554 592 641 642 679 680 734 823 830 839 840 862 924 927 928 935 993 1019 1042 1084 1098 1144 1147 1155 1161 1164 1165 1237 1253 1267 1268 1288 1305 1331 
2 5 21 26 33 45 60 70 129 130 133 158 254 271 301 302 390 417 451 459 497 577 578 579 587 614 693 731 820 870 901 916 1143 1166 1175 1212 1238 1239 1256 
3 107 113 114 115 139 276 282 322 370 458 525 591 603 606 638 667 733 737 752 760 960 982 1009 1010 1026 1116 1132 1139 1173 1183 1185 1191 1222 1282 1296 1297 
19 27 122 134 179 253 316 353 365 372 426 427 553 559 572 590 596 637 639 653 658 659 669 701 722 742 778 845 856 931 936 1100 1142 1196 1322 1323 
49 50 51 186 218 219 350 385 479 507 509 555 588 597 677 678 727 812 828 860 873 881 1033 1040 1146 1150 1153 1197 1262 1292 1316 1340 1341 
81 89 90 99 181 183 185 199 278 284 373 374 519 524 657 702 852 874 886 887 919 926 959 1017 1074 1096 1099 1131 1236 1280 1351 
23 59 85 86 198 244 270 297 298 335 366 410 533 535 744 795 817 827 853 864 879 942 958 962 973 998 1154 1195 1321 
106 145 175 176 233 235 260 292 348 351 493 494 574 575 580 583 633 767 771 819 914 1012 1113 1133 1208 1209 1270 1278 1345 
9 66 101 151 165 279 314 334 414 442 621 630 631 703 746 772 816 863 878 921 940 1044 1055 1111 1112 1192 1255 
41 76 154 215 307 369 382 384 386 409 424 506 561 757 883 956 991 1003 1029 1056 1087 1088 1089 1211 1214 1258 1281 
16 39 132 192 223 224 240 274 354 405 411 457 488 489 576 625 700 779 780 861 1035 1041 1072 1118 1235 1347 
63 153 201 210 252 269 304 342 344 504 569 652 869 871 872 898 1037 1051 1063 1075 1105 1148 1202 1248 1265 1301 
29 315 401 568 586 689 740 837 838 854 866 884 885 894 895 964 1007 1059 1061 1078 1152 1157 1277 1283 
6 7 35 58 73 74 209 246 247 329 484 545 660 745 782 813 865 900 999 1036 1249 1324 1354 
164 236 312 313 371 423 436 521 522 538 557 675 690 698 761 762 793 938 1016 1128 1141 
126 163 166 194 290 293 294 400 463 640 691 697 763 971 1093 1117 1210 1241 
227 228 237 289 403 418 539 704 707 814 932 933 945 1006 1022 1023 1048 1199 
364 399 420 505 513 687 974 994 1020 1064 1149 1193 1194 1227 1228 1240 1260 1276 
91 92 147 324 343 654 682 774 880 906 907 1045 1065 1083 1110 1246 1311 
78 142 143 275 609 610 661 662 706 989 1021 1101 1264 1337 1344 
150 156 196 197 283 357 472 551 636 648 666 904 905 922 1054 
241 261 413 450 495 717 810 842 992 1027 1086 1167 1224 1225 1243 
265 453 768 769 818 910 917 918 939 1179 1190 1274 1284 1304 
406 468 499 617 628 629 681 711 712 912 1137 1138 1182 1189 
17 182 333 469 725 822 824 941 985 1119 1120 
168 422 685 829 955 1058 1121 1294 1338 
310 311 483 500 562 655 882 965 
52 169 226 848 949 950 1067 
67 102 251 908 1220 1221 1287 
98 121 454 944 986 1080 1318 
330 331 517 518 920 1018 1184 
540 1014 1176 1226 1285 
452 480 534 1186 
