1 12 13 22 23 32 34 36 40 42 43 53 55 59 63 66 69 86 87 88 93 94 111 119 148 149 165 169 174 189 195 208 212 219 220 234 235 245 250 252 255 256 257 259 269 277 278 280 296 303 305 306 308 309 320 322 325 327 339 340 349 350 352 353 354 355 360 361 362 366 374 381 388 392 403 406 414 421 430 433 438 468 475 501 502 503 504 508 513 515 516 526 570 573 575 588 591 594 599 600 606 608 619 626 627 635 645 649 780 792 817 845 863 867 871 872 875 877 890 908 909 936 937 957 960 979 997 1023 1035 1058 1072 1081 1094 1097 1106 1147 1162 1187 1213 1217 1260 1266 1273 1282 1309 1315 1331 1332 1334 1348 
48 56 61 62 67 73 102 106 109 118 140 167 168 176 188 191 206 224 233 251 260 264 266 313 348 393 404 408 416 418 419 431 432 436 447 460 485 487 499 500 512 542 614 624 646 647 648 651 656 673 696 701 714 715 721 723 726 742 771 800 803 805 806 809 823 826 841 868 874 876 894 895 896 905 920 946 947 969 974 990 996 1000 1001 1011 1039 1050 1059 1060 1068 1077 1079 1100 1108 1124 1134 1135 1177 1203 1207 1208 1223 1233 1234 1246 1259 1263 1270 1275 1276 1286 1290 1302 1306 1313 1326 1328 1330 1335 1336 1339 
20 21 27 31 44 46 60 100 117 134 141 156 160 178 182 185 186 217 236 238 244 265 268 275 281 282 316 317 332 368 372 373 391 409 410 417 425 428 434 444 445 448 520 527 543 545 551 572 618 634 639 653 663 665 666 672 674 718 725 734 735 770 782 784 785 790 793 818 822 839 840 856 858 870 899 901 916 931 933 943 948 953 954 964 965 970 988 1019 1021 1024 1034 1053 1054 1066 1076 1091 1095 1096 1123 1141 1143 1180 1183 1198 1199 1200 1205 1231 1237 1243 1247 1271 1325 
3 11 64 76 77 101 107 108 113 114 154 187 202 203 222 225 226 228 247 369 371 375 382 384 385 386 387 389 461 463 525 529 531 532 534 550 558 561 589 611 631 652 664 677 678 691 694 698 733 749 750 754 769 776 777 813 835 843 846 860 862 873 930 939 940 967 976 981 994 1003 1029 1033 1036 1044 1046 1056 1085 1088 1089 1104 1122 1145 1153 1169 1190 1192 1236 1258 1274 1281 1284 1293 1316 1340 1341 1342 1346 1349 
24 25 91 110 136 139 164 175 193 194 213 214 240 273 299 312 321 328 329 330 450 467 469 470 484 511 517 518 521 536 537 546 610 629 657 684 685 690 729 781 801 807 827 869 884 885 898 903 929 938 952 955 972 977 999 1009 1010 1014 1016 1026 1027 1037 1038 1055 1074 1080 1086 1116 1148 1156 1163 1185 1191 1202 1215 1265 1279 1285 1296 1297 1298 1301 1307 1308 1319 
5 7 10 16 17 39 75 78 81 82 83 126 132 133 138 142 143 161 162 163 180 223 237 274 284 285 288 290 294 307 334 336 347 390 396 397 400 405 457 464 474 477 488 489 539 556 569 578 581 582 593 595 601 625 688 704 707 728 748 759 763 779 795 820 897 932 945 951 980 1041 1067 1093 1118 1129 1131 1159 1210 1225 1235 1320 1329 1337 1347 
4 26 30 33 65 70 97 112 124 129 135 155 158 172 197 204 207 263 271 291 301 302 379 395 429 553 598 615 636 687 693 711 722 732 737 765 778 789 796 797 804 850 851 859 881 889 922 923 934 941 998 1008 1020 1032 1073 1114 1154 1158 1189 1195 1196 1252 1291 1300 1317 
19 47 80 98 127 146 147 152 173 179 215 243 287 295 310 311 326 358 359 370 380 394 423 439 454 459 462 471 494 523 552 557 562 590 654 655 676 683 699 744 756 757 764 794 798 802 808 879 880 917 918 944 984 1028 1065 1082 1083 1181 1218 1219 1304 1312 
0 37 38 51 52 68 92 104 221 227 258 272 293 324 338 343 356 367 383 415 440 442 443 495 498 548 549 559 583 604 609 640 650 670 682 697 738 758 786 787 814 893 906 907 971 978 992 1006 1018 1022 1045 1048 1052 1087 1099 1117 1146 1214 1280 
2 8 57 74 123 128 137 144 145 157 166 171 230 248 318 357 420 426 437 476 478 486 530 540 555 563 564 566 579 616 623 632 692 710 727 855 914 915 987 1002 1107 1128 1142 1168 1170 1184 1194 1206 1241 1256 1289 1310 
6 18 29 35 183 184 190 205 239 314 323 337 376 401 402 424 585 602 607 660 686 689 709 712 713 788 791 866 921 925 1007 1030 1043 1049 1069 1098 1115 1130 1201 1204 1216 1220 1254 1277 1295 1327 1338 1354 
45 96 120 130 131 231 232 286 378 446 496 507 528 622 633 638 679 680 708 746 747 752 773 815 891 892 1113 1155 1160 1164 1165 1173 1193 1209 1224 1238 1239 1249 1288 1305 
105 116 241 242 398 455 456 466 490 492 509 510 544 567 739 740 741 775 799 824 828 844 854 912 1012 1013 1040 1071 1078 1119 1120 1137 1152 1157 1211 1299 1333 1343 
41 72 89 90 103 497 522 524 541 637 675 705 706 774 849 882 904 961 982 1031 1121 1140 1166 1175 1226 1229 1232 1264 1311 1322 1323 1344 1350 1351 
121 181 192 211 216 229 253 283 331 411 441 452 479 480 560 568 586 587 605 731 753 755 864 883 975 1005 1103 1186 1212 1287 1318 
54 170 209 246 249 315 363 364 514 643 644 681 811 812 819 837 838 848 857 888 900 1149 1182 1188 1283 1324 
79 292 346 574 580 671 767 825 833 834 919 1062 1110 1133 1150 1151 1257 1278 1314 1345 
196 254 453 482 483 554 641 642 768 829 830 910 924 928 1042 1084 1105 1144 1178 
14 15 267 341 565 571 596 597 743 913 968 1004 1025 1090 1230 1242 1303 
84 85 153 201 300 412 473 506 702 942 956 962 963 1047 1075 1269 1321 
198 270 297 298 335 422 533 535 831 853 902 935 958 973 1240 1262 1292 
9 125 279 612 613 630 816 878 911 1171 1244 1245 1261 
218 304 407 617 669 736 821 861 995 1102 1125 1272 1294 
28 50 71 261 413 465 717 724 810 842 1070 1167 
58 95 122 200 667 703 745 865 983 1136 1139 
99 199 289 399 505 628 1017 1064 1172 1227 1228 
210 319 365 435 491 659 766 783 1051 1063 1161 
276 493 661 662 760 836 847 986 989 1101 1221 
449 592 927 1061 1092 1132 1176 1197 1253 1267 1268 
342 351 427 576 772 966 993 1111 1222 1248 
620 621 695 716 730 832 950 1015 1057 
49 345 451 603 658 761 762 
159 262 700 719 720 926 1138 
177 519 668 852 886 887 959 
150 151 377 949 1109 1255 
333 472 547 985 991 1179 
344 481 538 577 751 
115 458 584 1112 
