0 1 12 13 22 23 32 36 37 42 43 44 48 53 55 59 63 64 66 75 79 83 86 87 88 93 94 108 111 155 174 189 195 200 208 212 218 219 220 234 235 242 245 250 255 256 257 259 269 272 277 278 285 296 303 304 305 306 307 308 309 321 322 327 339 340 341 349 353 355 360 361 374 375 381 388 403 406 407 415 416 421 443 467 468 473 475 502 503 504 508 526 573 588 594 599 608 619 625 626 627 649 656 681 688 724 736 751 770 786 798 803 812 873 890 899 936 953 980 997 1029 1061 1070 1071 1147 1167 1187 1213 1234 1247 1270 1272 1306 1310 1315 1325 
6 7 25 34 35 40 41 58 67 73 74 76 80 81 84 85 123 132 142 147 148 150 168 169 177 190 291 314 315 328 329 346 398 401 402 408 412 424 464 466 484 515 516 519 545 546 547 584 585 607 629 663 667 668 686 700 745 758 775 788 792 807 832 844 865 867 875 900 942 948 994 1024 1032 1058 1085 1094 1102 1124 1125 1149 1162 1193 1202 1220 1240 1252 1260 1271 1273 1294 1332 1333 
8 9 20 101 102 124 146 187 188 202 203 211 216 217 221 229 230 246 247 252 262 263 276 319 320 332 333 334 345 354 357 365 399 431 435 440 441 476 491 492 505 550 551 558 560 561 592 622 632 635 698 733 735 753 754 756 766 783 823 852 860 862 870 935 975 981 987 995 1036 1038 1067 1087 1121 1129 1281 
10 69 70 71 72 120 125 126 131 135 158 160 172 173 236 237 238 239 248 268 288 294 352 378 428 429 430 434 446 461 496 497 501 534 539 552 605 653 672 746 747 748 752 763 785 801 815 841 851 855 861 863 892 897 933 941 951 976 979 991 1008 1020 1064 1073 1103 1141 1173 1194 1195 1210 1223 1233 1289 1300 
31 68 82 107 140 141 166 167 194 231 284 324 391 400 409 413 423 499 520 527 528 606 628 652 718 726 835 840 957 969 1044 1045 1096 1211 1212 1231 1348 
2 3 21 105 106 109 110 176 224 233 260 261 347 348 393 419 420 437 512 571 597 634 715 771 809 819 901 915 974 1083 1142 1143 1183 1208 1275 1290 
4 5 26 30 33 45 97 98 133 152 161 180 243 244 254 271 279 301 302 453 454 498 577 598 687 693 802 818 910 932 944 985 1175 
127 128 136 137 170 171 191 192 223 264 265 460 477 478 486 487 542 564 616 623 624 691 692 710 721 1068 1107 1108 1112 1135 1241 1302 1347 
27 46 121 122 134 179 253 289 290 426 427 451 452 494 572 590 637 639 655 658 669 704 744 778 795 845 856 931 1007 
153 154 225 226 299 300 369 386 387 536 537 600 601 749 750 903 998 1003 1056 1057 1154 1169 1258 1264 1319 1346 
164 165 292 414 422 574 575 576 580 630 631 767 772 814 816 878 902 993 1012 1111 1113 1133 1345 
258 293 318 338 350 356 367 383 548 549 557 582 583 604 609 696 869 893 940 978 1039 1178 
14 15 115 326 336 337 396 513 565 591 596 611 743 759 913 1004 1050 1236 1242 1329 
103 104 156 196 197 251 472 541 676 703 705 706 727 904 905 922 982 1031 1060 1170 
47 99 100 275 295 358 359 394 425 462 471 523 665 757 794 927 943 1021 
77 144 145 175 201 209 210 281 282 569 898 914 1046 1051 1052 1063 1075 1105 
54 65 95 96 112 149 204 205 379 490 563 578 579 728 866 1114 1146 
61 62 266 651 876 877 896 990 1001 1011 1100 1203 1259 1286 1318 1330 
206 249 342 514 643 644 732 811 848 857 1122 1145 1182 1189 1198 1349 
524 555 567 568 739 740 741 854 956 1013 1059 1078 1152 1157 1351 
11 118 207 395 447 448 485 500 714 797 889 946 947 1079 
28 29 139 370 444 465 532 659 671 699 764 810 937 1019 
38 404 405 638 713 737 919 1017 1018 1062 1099 1278 1280 1344 
60 182 185 186 479 636 666 782 822 964 965 1054 1161 1199 
312 313 469 521 522 554 633 690 789 1014 1016 1055 1128 1163 
91 92 213 214 397 474 556 581 610 773 1040 1136 1328 
162 163 389 390 417 418 538 707 708 820 945 1093 1186 
646 647 805 806 826 868 1134 1158 1263 1276 1326 1335 1336 
178 351 784 954 988 1076 1077 1080 1091 1098 1237 1295 
215 310 311 325 362 438 439 459 562 654 882 1028 
193 323 376 470 511 821 925 972 1030 1049 1072 
364 411 614 731 808 864 879 880 1065 1082 1235 
482 483 641 642 734 829 830 924 928 1084 1144 
768 769 917 918 939 1179 1190 1274 1284 1304 1316 
117 316 317 372 373 445 755 1005 1034 1066 
198 199 270 297 298 335 533 958 959 973 
432 673 674 701 722 723 921 938 1043 1196 
51 52 227 228 442 992 1022 1023 1048 
56 57 595 648 742 827 996 1177 1243 
283 529 530 664 694 695 930 999 1035 
16 457 488 489 779 780 1041 1118 
24 684 685 729 1172 1215 1279 1298 
116 480 730 831 949 950 1015 1228 
119 392 570 589 615 800 804 1042 
157 593 612 613 791 911 1109 1197 
377 455 456 657 670 923 1206 1214 
650 725 796 824 912 1119 1120 1201 
679 680 1155 1164 1165 1288 1305 1331 
78 493 661 662 970 989 1101 
368 506 702 765 781 817 1321 
382 384 531 843 883 1088 1089 
535 871 872 1037 1148 1265 1301 
18 19 553 559 566 787 
89 90 222 1110 1140 1311 
151 450 1086 1116 1156 1255 
240 241 273 274 385 929 
267 968 1025 1090 1230 1303 
280 846 847 888 1097 1192 
286 287 682 858 908 1249 
330 331 517 518 920 1184 
463 495 640 697 971 1117 
543 544 916 1053 1123 1200 
675 774 961 1166 1232 1350 
738 833 834 1150 1151 1257 
1009 1010 1185 1191 1296 1297 
49 50 617 618 1205 
113 458 760 1139 1222 
129 130 891 1238 1239 
138 881 934 967 1171 
366 836 986 1221 1287 
371 983 984 1104 1342 
433 525 602 603 1081 
436 689 894 895 1006 
587 1074 1217 1256 1293 
645 884 885 977 1277 
677 678 776 777 828 
711 712 842 1026 1027 
926 1106 1137 1138 1248 
17 410 850 1291 
181 683 849 1229 
183 184 1069 1130 
586 837 838 1283 
620 621 716 717 
660 1092 1216 1354 
853 1033 1262 1292 
874 886 887 1131 
952 1159 1160 1168 
962 963 1047 1269 
1115 1254 1299 1343 
39 1224 1225 
114 813 909 
159 1000 1176 
232 507 1209 
343 344 481 
363 380 966 
449 1227 1320 
509 510 799 
540 1226 1285 
761 762 793 
790 1095 1180 
839 859 1317 
906 907 1246 
955 1327 1338 
960 1132 1282 
1002 1188 1324 
1126 1127 1174 
1153 1340 1341 
1218 1219 1312 
1244 1245 1261 
1253 1267 1268 
1266 1309 1334 
