39 48 56 57 105 127 128 137 162 170 171 191 192 223 264 281 366 391 393 446 460 477 486 487 504 512 542 564 571 595 616 623 624 656 692 715 775 809 898 966 969 1072 1107 1108 1124 1135 1177 1234 1241 1290 1302 1306 1347 
13 20 54 65 82 96 111 112 146 155 195 200 204 205 250 255 256 287 308 349 379 380 488 502 511 589 619 732 786 811 866 952 995 1077 1146 1201 1325 
46 72 93 135 237 248 318 325 378 389 431 510 540 566 707 739 764 814 817 915 987 996 1031 1082 1168 1170 1175 1226 1285 1289 1300 
4 44 131 140 432 438 445 466 490 514 515 541 543 570 618 689 743 755 790 800 849 976 1005 1034 1053 1091 1102 1123 1200 1333 
0 1 15 22 34 36 208 212 220 238 272 305 327 360 381 388 421 467 475 573 599 608 627 736 787 803 1198 1236 1332 
107 187 203 211 229 262 345 435 440 441 492 525 560 603 622 667 712 733 753 754 783 981 1278 1344 
3 14 139 184 282 336 337 370 396 591 611 638 737 759 914 1026 1046 1116 1173 1183 1329 
27 117 122 253 372 426 572 590 639 658 669 778 845 931 936 1142 
217 231 232 482 641 642 734 810 830 924 928 1019 1084 1144 1155 1304 
99 198 199 270 297 335 374 519 533 926 959 973 1074 1096 
225 299 300 328 536 537 600 601 729 750 1057 1169 1319 1346 
24 43 242 277 452 671 704 825 856 929 1008 1215 1314 
148 149 412 503 695 749 781 832 899 1247 1266 1273 1348 
164 166 312 313 400 423 521 522 690 789 957 1016 1128 
91 92 343 559 654 682 774 906 907 1045 1099 1246 
317 334 428 631 634 703 746 844 868 921 1112 1263 
513 565 646 647 913 1050 1134 1149 1240 1276 1326 1335 
53 241 261 413 459 495 717 842 1027 1212 1275 
7 58 73 74 329 484 545 745 900 1324 
25 63 121 172 306 871 872 1037 1148 1301 
75 76 153 154 307 386 1003 1051 1056 1258 
81 284 852 874 886 887 919 1017 1131 1280 
144 210 219 269 443 569 1052 1063 1075 1105 
160 193 377 402 456 516 527 923 1030 1049 
206 207 249 395 448 644 796 797 947 1015 
351 404 574 651 843 1013 1076 1232 1237 1350 
529 664 779 780 930 1033 1035 1118 1262 1292 
575 630 850 851 863 891 1012 1073 1113 1133 
31 32 64 189 234 340 943 970 1213 
97 244 279 302 410 453 454 944 1028 
126 293 294 463 640 691 697 971 1117 
141 268 434 496 528 718 801 1210 1233 
507 509 555 677 678 725 799 828 1150 
8 319 505 766 839 840 862 935 
11 222 607 694 741 767 1311 1345 
18 123 152 221 407 665 836 867 
40 368 387 471 520 776 846 1229 
175 176 233 260 348 771 819 1208 
258 684 963 1165 1269 1279 1288 1298 
769 917 918 939 1179 1190 1274 1284 
5 33 133 301 577 687 693 
42 218 235 309 415 457 861 
60 100 163 316 332 417 614 
84 672 876 877 1011 1203 1259 
102 740 854 956 1059 1078 1157 
115 369 382 883 1088 1089 1265 
118 119 167 645 951 977 1042 
182 333 761 762 793 822 985 
276 458 760 960 1132 1222 1282 
330 331 517 518 920 1018 1184 
893 1181 1207 1218 1219 1223 1328 
6 35 246 813 1029 1281 
9 95 125 151 1111 1255 
16 251 326 405 523 794 
23 85 86 744 942 1195 
28 62 465 735 1001 1330 
30 978 1071 1187 1205 1310 
49 50 350 588 812 1040 
68 485 815 835 1039 1145 
78 610 661 662 989 1101 
94 650 824 1070 1119 1120 
103 104 197 472 904 1021 
129 130 578 870 1238 1239 
147 298 880 1065 1083 1110 
177 585 663 686 875 1106 
185 524 657 660 1351 1354 
267 968 1025 1090 1230 1303 
406 468 617 912 1137 1138 
499 711 805 806 1158 1336 
679 680 1164 1253 1305 1331 
791 873 881 1153 1197 1316 
827 998 1024 1154 1167 1321 
1009 1010 1185 1191 1296 1297 
2 21 451 901 1143 
17 243 469 941 1291 
29 568 1014 1152 1176 
71 748 892 979 1217 
80 286 476 807 808 
101 314 480 621 1182 
108 352 532 784 1315 
109 501 826 1041 1109 
110 362 474 676 706 
113 114 322 752 1139 
116 291 346 1032 1043 
124 792 1244 1245 1261 
132 224 354 375 625 
150 156 196 636 905 
165 174 442 816 1055 
215 252 558 756 1036 
227 228 1023 1048 1199 
236 371 436 698 1141 
266 414 576 878 940 
273 902 903 954 1047 
292 324 464 1129 1248 
310 311 483 655 882 
365 596 659 701 1242 
384 385 478 632 1114 
397 546 713 1295 1299 
409 561 562 991 1211 
416 429 961 1064 1147 
418 539 897 932 933 
673 722 723 773 938 
765 1007 1061 1307 1308 
823 925 972 1098 1161 
10 461 683 1216 
45 70 254 1312 
47 798 980 1094 
55 403 945 1186 
59 341 535 853 
61 376 1100 1209 
83 178 652 1044 
120 1062 1160 1171 
134 427 470 742 
173 288 802 983 
186 444 534 860 
209 247 782 999 
239 602 958 1069 
240 274 879 1235 
259 356 751 1038 
283 666 922 1054 
285 408 649 1272 
321 489 1002 1188 
347 430 584 688 
357 551 648 855 
361 604 1085 1202 
390 620 731 916 
433 508 770 953 
447 984 1104 1342 
493 580 986 1136 
498 549 582 1159 
552 884 885 1277 
586 837 838 1283 
643 721 728 1206 
730 831 950 1228 
833 834 1151 1257 
992 1224 1225 1243 
19 179 553 
37 339 544 
51 315 597 
52 716 949 
67 908 1220 
79 768 1066 
87 161 909 
88 491 934 
89 90 278 
98 1080 1318 
106 145 1270 
136 473 557 
138 670 720 
158 579 1256 
159 554 927 
180 190 747 
183 373 1130 
188 437 1068 
194 1093 1231 
216 758 937 
257 338 548 
263 563 606 
265 818 910 
289 820 1022 
290 696 975 
296 383 1178 
303 355 367 
320 526 1271 
323 583 653 
363 668 841 
392 594 967 
394 889 1079 
425 719 1156 
439 635 724 
449 1227 1320 
462 708 763 
479 613 727 
530 556 1317 
550 848 1067 
567 777 785 
581 710 1000 
593 612 911 
674 788 1196 
685 829 1121 
705 890 1060 
795 864 962 
847 888 1097 
857 1122 1349 
894 895 1006 
896 990 1286 
946 1092 1252 
955 1327 1338 
1115 1254 1343 
1193 1194 1260 
