1 12 13 22 23 32 34 36 40 42 43 53 55 63 66 69 79 86 87 88 93 94 111 119 148 149 165 174 189 195 208 212 219 220 234 235 239 245 250 252 255 256 257 258 259 269 277 278 280 296 303 305 306 308 309 320 322 325 327 339 340 349 350 352 353 354 355 360 361 362 366 374 381 388 392 403 406 414 421 433 438 468 475 501 502 503 504 508 513 515 516 526 570 573 580 588 591 594 599 600 606 608 619 626 627 645 649 792 817 845 854 863 867 871 872 875 908 909 936 937 957 960 979 997 1012 1023 1037 1058 1078 1081 1094 1097 1106 1147 1162 1187 1213 1217 1260 1266 1273 1282 1315 1331 1332 1348 
44 100 117 178 185 265 317 351 372 373 391 445 535 543 589 618 621 665 666 674 784 790 793 818 877 902 916 933 948 954 958 970 988 1034 1053 1066 1076 1091 1123 1141 1200 1205 1240 1243 
26 30 33 97 113 114 135 155 158 172 204 207 271 301 302 395 429 454 598 615 636 687 693 737 765 778 802 859 889 998 1020 1073 1114 1154 1317 
57 128 137 144 145 171 248 318 420 426 437 476 478 486 530 540 563 564 566 602 616 623 692 710 914 915 987 1107 1142 1170 1194 1206 1241 1289 1310 
3 11 76 154 222 225 369 382 384 385 386 387 531 561 694 749 750 776 843 846 860 967 1003 1056 1062 1088 1089 1145 1258 1346 
48 56 191 233 393 418 460 542 624 648 656 715 742 803 809 969 996 1060 1124 1135 1177 1223 1233 1234 1290 1302 1306 
7 92 126 138 180 288 336 390 396 397 400 474 556 559 578 581 582 728 748 759 951 980 1159 1184 1328 1329 
75 81 82 83 132 284 285 307 347 457 488 489 569 593 595 601 625 688 734 795 1019 1041 1050 1118 1131 
19 101 179 215 310 311 459 494 558 562 590 654 655 744 756 813 856 917 931 1029 1036 1281 1304 
47 147 152 295 358 359 394 425 462 471 523 757 764 794 798 808 879 880 1065 1082 1083 1181 
107 108 187 198 199 203 270 297 298 335 375 525 533 611 652 717 733 835 973 1044 1236 
25 91 213 214 273 299 328 329 467 484 536 537 610 903 1016 1148 1265 1301 1319 
5 45 133 378 446 496 528 622 746 747 752 773 815 820 891 892 1173 1210 
20 21 46 275 409 428 527 539 718 839 840 901 1096 1143 1183 1278 1325 
211 217 319 365 435 441 491 550 560 659 753 754 766 783 981 1051 1161 
130 254 482 483 641 642 829 830 924 928 944 1084 1105 1144 1238 1239 
106 176 188 224 260 313 348 419 512 771 974 1068 1208 1270 1275 
84 85 153 201 210 412 473 506 702 942 956 1063 1075 1321 
139 164 469 470 511 521 690 1014 1026 1027 1049 1055 1116 1285 
72 497 524 675 774 849 961 1166 1175 1229 1232 1350 1351 
14 15 267 565 913 968 1004 1025 1090 1230 1242 1303 
24 240 517 684 685 729 781 929 955 1215 1279 1298 
61 62 646 874 876 896 990 1001 1011 1100 1259 1330 
141 160 236 238 268 434 545 653 663 672 782 785 
422 529 664 695 716 730 831 832 930 950 1015 1057 
54 246 249 364 644 681 811 812 848 857 1182 
58 95 122 200 667 703 745 865 983 1136 1139 
162 163 290 294 334 704 707 763 779 945 1093 
276 493 661 662 836 847 918 986 989 1101 1221 
0 37 104 367 498 548 549 583 609 978 
6 29 190 376 401 585 607 686 921 1043 
51 52 221 227 992 1006 1022 1048 1087 1146 
68 338 383 440 604 640 670 893 971 1214 
18 713 714 788 1098 1115 1237 1254 1295 
293 442 495 697 758 814 1117 1220 1253 
9 125 279 816 878 1244 1245 1261 
105 116 398 466 490 775 1071 1333 
146 287 448 682 786 787 858 1249 
182 186 282 725 822 964 1054 1199 
567 740 824 912 1059 1119 1120 1157 
677 678 777 862 873 976 1033 1153 
73 266 404 651 723 800 1077 
103 541 705 706 882 1031 1226 
120 708 711 1113 1158 1160 1193 
157 552 612 855 911 1128 1277 
183 184 337 709 1069 1130 1204 
261 323 413 724 842 1070 1167 
679 680 1155 1164 1165 1288 1305 
16 17 78 274 405 1235 
35 314 660 689 1216 1354 
39 142 223 1067 1225 1347 
140 447 485 946 1039 1079 
300 620 962 963 1047 1269 
331 568 731 755 975 1212 
344 481 538 577 751 760 
371 698 1104 1122 1342 1349 
408 431 432 673 701 905 
576 772 966 993 1111 1222 
868 1134 1246 1263 1335 1336 
1009 1010 1185 1191 1296 1297 
27 60 281 332 417 
28 50 71 465 1314 
31 634 899 953 1271 
59 575 635 780 1035 
65 263 379 732 804 
74 123 197 727 1002 
98 423 439 557 1028 
150 151 377 949 1109 
192 411 864 883 1287 
218 669 995 1102 1125 
264 463 691 940 994 
272 324 356 415 650 
357 555 579 632 1256 
399 1017 1064 1172 1227 
402 712 791 925 1030 
450 810 1086 1156 1255 
647 805 806 1276 1326 
769 1190 1274 1284 1316 
796 797 850 851 1291 
884 885 952 977 999 
4 70 129 1195 
38 738 919 1052 
41 522 904 982 
64 532 631 1192 
96 232 507 1209 
112 169 226 1169 
121 253 1005 1318 
134 735 1198 1231 
136 193 972 1074 
159 262 926 1138 
177 424 668 959 
196 554 1042 1178 
202 464 477 1129 
205 1201 1327 1338 
206 499 500 947 
209 900 1188 1324 
216 229 283 1103 
231 633 638 1224 
241 492 1013 1152 
292 767 1133 1345 
304 736 821 1272 
343 906 907 1045 
370 380 676 984 
407 617 861 1294 
416 696 721 1108 
436 841 894 895 
449 592 1061 1320 
452 479 480 605 
455 456 741 1040 
472 547 939 1179 
518 1018 1099 1280 
519 852 886 887 
739 799 1299 1343 
770 943 1021 1247 
833 834 1151 1257 
853 935 1262 1292 
869 898 1038 1202 
2 514 819 
10 161 897 
49 603 762 
89 90 1311 
102 168 251 
109 487 826 
110 175 330 
127 243 683 
156 244 410 
166 230 1168 
181 534 1186 
194 657 827 
237 823 932 
242 544 1211 
316 572 639 
333 985 991 
342 427 1248 
346 825 1150 
368 520 1024 
430 890 1072 
443 574 1110 
444 671 870 
453 768 910 
509 510 828 
553 722 1196 
571 596 597 
613 630 1171 
629 801 807 
637 1121 1140 
700 719 720 
789 941 1300 
837 838 1283 
881 923 934 
1008 1032 1252 
1092 1176 1197 
1218 1219 1312 
