1 12 13 15 22 23 32 34 36 40 42 43 53 55 66 69 86 87 88 89 90 93 94 111 148 149 174 189 195 208 212 218 219 220 234 235 245 250 252 255 257 269 277 278 280 296 303 305 306 308 309 320 322 325 327 339 340 349 350 352 353 355 360 361 362 366 374 381 388 392 403 406 414 421 433 438 440 468 475 502 503 504 508 516 526 570 573 588 591 594 599 600 604 606 608 619 627 645 649 669 765 781 792 817 845 867 875 877 908 909 936 937 957 979 995 997 1023 1058 1081 1097 1102 1106 1125 1147 1162 1172 1187 1217 1220 1253 1260 1266 1267 1268 1273 1307 1308 1309 1311 1315 1331 1332 1334 1348 
48 56 57 73 106 110 128 137 140 144 145 166 171 175 176 188 191 206 224 230 233 248 260 264 266 313 318 330 348 393 404 419 426 436 437 447 448 460 476 478 485 486 499 500 512 517 518 530 540 542 563 564 566 616 623 624 648 651 656 692 710 714 715 723 726 742 771 795 800 803 809 841 855 858 894 895 914 915 920 946 947 969 974 987 996 1039 1046 1068 1077 1079 1107 1108 1124 1128 1135 1142 1168 1170 1177 1193 1194 1208 1233 1234 1241 1270 1275 1289 1290 1302 1306 1310 1313 1339 
20 27 31 44 46 60 64 77 100 141 160 178 183 185 186 236 238 244 265 268 275 281 316 317 332 371 372 373 391 409 410 417 425 428 434 444 445 453 479 501 515 527 528 532 534 539 543 545 551 567 572 618 626 631 634 639 653 663 666 672 698 718 768 770 782 784 785 793 818 822 839 840 870 899 910 912 916 933 943 948 953 954 960 964 965 970 988 1034 1053 1054 1066 1076 1085 1091 1096 1122 1123 1141 1199 1200 1213 1237 1247 1271 1293 1325 1349 
5 7 8 16 26 39 59 75 81 82 83 115 118 119 126 132 133 138 162 163 180 223 274 284 285 288 289 290 291 292 294 307 334 336 347 354 357 390 396 397 400 405 411 430 457 458 464 474 477 488 489 556 569 575 578 581 582 584 593 595 601 625 635 688 704 707 708 721 728 748 759 763 779 820 835 859 868 883 890 945 951 1000 1007 1041 1050 1060 1072 1093 1112 1118 1129 1131 1155 1159 1210 1235 1246 1263 1287 1288 1317 1329 1347 
4 30 33 97 135 147 152 156 157 158 172 204 207 256 271 295 301 302 326 358 359 370 380 394 395 408 429 431 432 454 462 463 471 523 598 636 665 676 679 680 687 691 693 699 701 757 764 794 808 879 880 889 905 944 984 994 998 1004 1008 1020 1021 1032 1065 1073 1082 1083 1100 1104 1154 1164 1195 1205 1252 1305 1342 
10 19 80 98 101 107 108 127 131 161 173 179 184 187 203 215 228 237 239 243 247 286 310 311 337 343 375 389 418 423 439 459 461 494 550 552 562 602 611 652 654 655 683 709 733 744 754 756 802 860 897 906 907 932 967 981 1012 1028 1029 1036 1044 1045 1069 1130 1192 1204 1236 1277 1281 1320 
18 51 109 136 150 151 193 221 227 315 377 402 416 450 487 612 643 646 647 696 700 712 713 719 720 788 790 791 823 826 911 925 961 972 1006 1030 1074 1087 1095 1098 1109 1111 1115 1134 1146 1156 1180 1254 1255 1295 1326 1335 
0 37 68 79 104 146 165 258 259 272 287 293 323 324 338 356 367 383 415 442 443 495 498 548 549 574 580 583 609 640 650 670 682 697 758 786 787 814 919 971 978 1022 1038 1110 1117 1165 1214 1278 1279 
9 45 70 120 125 129 130 254 279 346 378 446 483 496 613 622 630 746 747 752 773 796 797 815 816 825 850 851 863 864 878 891 892 940 1062 1105 1113 1133 1160 1171 1173 1239 1244 1245 1261 
24 25 91 139 164 213 214 299 321 328 427 467 521 536 537 546 610 629 671 684 690 729 801 807 856 869 898 903 1009 1010 1014 1016 1026 1027 1055 1116 1185 1191 1202 1215 1285 1296 1297 1298 1319 
47 54 65 112 124 155 209 246 249 263 379 589 615 644 681 711 732 737 798 804 805 806 811 812 848 857 881 900 923 934 980 1094 1114 1158 1182 1188 1189 1206 1324 1336 
38 67 102 113 114 167 168 202 251 276 319 329 435 493 525 558 661 662 738 760 766 772 813 833 834 836 847 986 989 1052 1059 1101 1136 1150 1151 1221 1257 
3 11 76 154 222 225 368 369 382 384 385 386 387 520 561 632 694 749 750 767 776 843 846 1003 1024 1056 1088 1089 1145 1258 1345 1346 
6 29 74 123 190 376 401 509 510 555 579 607 673 674 727 739 740 799 828 854 921 1002 1043 1078 1152 1157 1184 1196 1256 1299 1343 
50 71 449 592 677 678 769 777 780 862 873 927 939 976 1033 1035 1061 1092 1132 1153 1176 1190 1197 1274 1282 1284 1314 1316 1340 1341 
41 72 78 103 142 143 181 197 497 522 524 541 705 706 774 849 882 904 982 1031 1166 1175 1229 1232 1264 1337 1344 1350 1351 
198 270 297 298 335 341 351 422 533 535 620 621 695 716 730 743 831 832 853 902 935 950 958 973 1015 1057 1240 1262 1292 
35 177 205 314 333 424 472 519 547 585 660 668 686 689 852 866 874 886 887 959 985 991 1011 1179 1201 1216 1327 1354 
482 529 637 641 642 664 685 829 830 884 885 924 928 930 952 955 977 999 1084 1121 1140 1144 1322 1323 1338 
14 153 211 267 365 441 491 560 565 571 596 597 659 753 783 913 968 1025 1051 1090 1161 1230 1242 1303 
92 105 116 242 398 455 456 466 490 544 559 741 775 844 1018 1040 1071 1099 1137 1203 1211 1280 1333 
182 192 282 331 452 480 568 586 587 605 725 731 755 824 837 838 975 1119 1120 1186 1212 1283 
84 85 201 210 300 412 473 506 531 557 702 942 956 962 963 1047 1063 1075 1269 1321 
96 217 231 232 507 633 638 734 917 918 992 1019 1048 1209 1224 1225 1238 1243 1304 
117 121 216 229 253 283 345 553 590 658 722 778 922 931 1005 1080 1103 1163 1318 
63 159 262 342 576 871 872 926 966 993 1037 1138 1148 1222 1248 1265 1301 
2 58 95 122 200 484 514 667 703 745 819 865 983 1139 1249 
28 61 62 134 465 735 876 896 990 1001 1198 1231 1259 1286 1330 
240 241 261 273 413 492 717 724 810 842 929 1013 1070 1086 1167 
17 194 312 469 470 511 657 789 827 938 941 1049 1291 1300 
21 49 196 451 554 603 761 762 901 1042 1143 1178 1183 1276 
170 363 364 399 420 505 513 888 1017 1064 1149 1226 1227 1228 
99 199 304 407 617 628 736 821 861 1272 1294 
614 893 1181 1207 1218 1219 1223 1312 1328 
52 169 226 949 1067 1169 
344 481 538 577 675 751 
