48 56 57 105 125 127 128 137 141 154 157 160 162 170 171 188 191 192 214 216 225 239 264 268 281 288 295 299 300 328 337 386 387 391 393 397 428 434 437 452 460 477 480 486 487 496 501 512 528 534 536 537 542 546 552 564 567 571 593 600 601 602 612 613 616 623 624 656 691 692 709 713 715 718 750 758 775 777 785 801 809 867 884 911 937 966 969 1003 1056 1057 1068 1069 1103 1107 1108 1109 1124 1135 1156 1169 1177 1186 1204 1234 1241 1277 1290 1295 1299 1302 1306 1319 1346 
6 7 18 29 35 40 55 58 73 74 79 123 136 148 149 152 177 190 193 246 303 305 306 315 325 329 355 367 368 376 377 401 402 407 412 424 425 456 470 471 473 475 484 503 506 516 527 545 568 585 586 660 663 665 686 719 720 740 745 747 749 781 813 836 837 838 854 865 875 885 899 923 925 956 959 964 972 1030 1049 1059 1066 1078 1106 1152 1157 1247 1266 1273 1283 1309 1334 1348 1354 
4 10 11 44 70 100 116 117 129 131 140 158 206 207 243 254 265 291 326 346 358 365 389 395 429 438 445 448 461 466 490 491 514 515 523 543 547 579 596 607 618 659 683 694 701 714 726 741 743 755 790 794 796 797 800 818 849 850 851 857 889 910 946 947 961 976 1005 1015 1024 1034 1043 1046 1053 1073 1085 1091 1092 1095 1102 1122 1123 1140 1163 1180 1196 1200 1216 1252 1256 1291 1333 1349 
0 1 14 15 22 34 36 37 42 64 82 83 178 208 212 220 238 267 273 285 339 341 347 360 381 388 398 408 421 430 526 544 565 573 584 595 599 608 611 626 627 649 674 688 736 787 788 791 803 835 902 903 913 948 954 957 968 1025 1047 1076 1077 1081 1090 1198 1230 1236 1242 1303 1332 
3 71 107 113 114 130 139 187 203 211 217 229 262 276 282 322 323 370 440 441 446 458 492 497 525 560 591 603 606 622 638 653 667 724 733 737 748 752 753 754 760 891 892 960 979 981 982 1009 1010 1026 1116 1132 1139 1173 1183 1185 1191 1217 1222 1238 1239 1282 1296 1297 
13 20 46 54 65 75 96 110 111 112 119 135 155 195 200 204 205 224 249 250 255 256 308 321 349 354 361 362 379 380 392 474 511 589 594 598 615 619 643 644 673 676 721 723 728 732 773 786 804 811 815 995 997 1002 1060 1136 1170 1201 1206 1233 1325 1327 1328 
8 12 47 72 93 124 144 202 213 248 263 317 318 319 327 345 353 378 431 435 476 478 502 558 563 566 605 632 637 739 764 766 783 792 798 821 855 915 980 987 1031 1082 1094 1114 1115 1175 1244 1245 1254 1261 1272 1289 1300 1322 1323 1343 
30 49 50 53 218 241 261 350 413 464 479 495 507 555 588 696 717 727 810 812 842 873 881 975 978 992 1027 1033 1040 1071 1086 1129 1150 1153 1187 1197 1205 1224 1225 1243 1248 1262 1275 1292 1310 1313 1339 1340 1341 
24 43 80 146 230 242 245 257 258 277 286 287 338 498 548 549 582 604 684 729 807 808 858 921 929 1008 1159 1160 1168 1172 1215 1249 1269 1279 1298 
19 27 94 122 134 179 253 316 372 394 426 427 553 559 572 590 639 658 669 699 722 742 778 845 856 931 936 1004 1070 1079 1100 1142 
9 97 98 165 174 219 234 244 279 334 366 410 414 442 443 630 631 703 744 746 816 844 863 868 878 940 1028 1032 1055 1112 1263 
38 77 87 108 161 173 336 352 432 530 532 556 738 759 784 802 833 834 897 909 983 988 1052 1151 1257 1293 1315 1317 1320 1329 
23 59 85 86 198 270 297 298 309 335 533 535 795 817 827 853 864 879 942 958 962 963 973 998 1154 1167 1195 1321 
25 68 121 166 172 194 272 356 400 415 467 485 520 650 751 893 1039 1093 1145 1181 1207 1218 1219 1223 1231 1312 1318 
28 61 62 84 109 396 465 646 647 651 672 735 826 876 877 896 990 1001 1011 1050 1134 1203 1259 1286 1326 1330 1335 
16 39 51 132 223 240 274 405 411 457 488 489 576 597 625 700 779 780 861 1035 1041 1072 1118 1146 1235 1347 
231 232 359 482 641 642 679 680 734 830 839 840 862 924 928 935 993 1019 1084 1144 1155 1164 1165 1288 1305 1331 
26 52 60 332 390 417 459 529 587 614 664 695 716 730 731 831 832 848 916 930 949 950 1067 1212 
81 99 159 183 184 199 284 373 374 519 702 852 874 886 887 919 926 1017 1074 1096 1099 1130 1131 1280 
41 118 167 266 404 541 570 581 645 710 757 843 951 952 977 996 1000 1013 1042 1087 1214 1232 1350 
69 106 145 175 176 210 233 260 269 348 419 569 771 819 914 1012 1063 1075 1105 1125 1162 1208 1270 
76 115 215 307 369 382 384 409 509 510 561 677 678 756 799 828 883 991 1029 1088 1089 1211 1281 
120 138 186 375 385 444 531 620 670 671 776 789 825 846 847 860 888 934 967 1062 1171 1229 1314 
5 33 45 126 133 163 180 290 293 294 301 302 463 577 640 693 697 763 820 971 1117 1210 
221 227 228 237 289 403 418 454 539 704 707 814 932 933 944 945 1006 1022 1023 1048 1199 
150 156 196 197 283 357 472 494 499 550 551 633 636 648 666 904 905 922 1054 
164 312 313 423 521 522 540 557 690 761 762 793 938 1014 1016 1128 1176 1226 1285 
235 292 351 493 574 575 580 583 767 986 1080 1113 1133 1209 1237 1278 1284 1316 1345 
63 153 201 252 342 344 504 869 871 872 898 1037 1051 1148 1202 1258 1265 1301 
364 399 420 505 513 687 974 994 1020 1064 1149 1193 1194 1227 1228 1240 1260 1276 
91 92 147 324 343 654 682 774 880 906 907 1045 1065 1083 1110 1246 1311 
406 468 617 628 629 681 711 712 805 806 912 1137 1138 1158 1182 1189 1336 
31 32 88 189 280 320 340 634 770 859 943 970 1097 1213 1271 
78 142 143 275 609 610 661 662 706 989 1021 1101 1264 1337 1344 
416 449 450 455 481 554 592 823 927 1098 1147 1161 1253 1267 1268 
66 95 101 151 304 314 621 652 772 1044 1111 1192 1255 
17 182 333 469 725 822 824 941 985 1119 1120 
168 169 226 422 685 829 955 1058 1121 1294 1338 
236 371 436 447 538 675 698 984 1104 1141 1342 
89 90 181 185 222 271 278 524 657 1351 
453 768 769 917 918 939 1179 1190 1274 1304 
67 102 103 104 251 908 1220 1221 1287 
689 765 866 894 895 1007 1061 1307 1308 
2 21 451 578 870 901 1143 1166 
209 247 782 900 999 1036 1188 1324 
310 311 483 500 562 655 882 965 
330 331 517 518 920 1018 1184 
433 439 508 635 705 890 953 
259 296 383 1038 1178 
363 462 668 708 841 
