48 56 57 105 127 128 137 162 170 171 191 366 391 393 446 460 486 487 512 542 564 571 595 616 623 624 656 692 715 775 785 809 898 966 969 996 1038 1107 1108 1124 1135 1177 1234 1290 1302 1306 
11 44 100 117 131 140 254 291 432 438 445 466 490 514 543 618 665 666 683 689 694 755 790 794 800 849 976 1005 1034 1043 1053 1102 1123 1200 1216 1333 
13 20 21 22 54 65 96 112 169 195 200 204 205 226 250 255 308 349 361 379 380 511 589 732 811 901 1143 1146 1198 1201 1325 
9 102 187 203 211 217 229 262 276 319 332 345 435 440 441 455 492 550 560 592 622 735 753 754 766 783 823 981 1098 
42 64 111 208 212 218 220 234 235 245 259 309 341 360 381 388 415 421 457 467 573 608 626 803 861 
72 93 213 237 248 317 318 378 420 431 510 540 566 602 739 764 915 987 1031 1082 1170 1226 1285 1299 
165 230 279 334 414 442 576 630 631 703 746 816 863 868 878 921 940 1055 1112 1113 1134 1263 1336 
225 299 300 328 536 537 600 601 684 685 729 750 829 962 1057 1148 1156 1169 1215 1298 1301 1319 1346 
2 3 139 144 210 281 282 569 591 638 737 741 914 1026 1046 1050 1052 1063 1105 1116 1173 1183 
99 183 184 198 199 270 297 335 373 374 519 533 700 926 959 973 1074 1096 1130 
1 15 34 238 267 625 627 736 787 968 1025 1090 1230 1242 1303 1332 
14 107 337 396 525 603 611 667 712 717 733 759 960 1278 1344 
27 122 353 426 572 590 637 658 669 778 845 856 931 936 1142 
52 228 529 664 695 716 730 831 832 930 949 950 1023 1048 1228 
75 76 513 792 807 925 994 1020 1051 1149 1202 1240 1244 1245 1261 
4 70 147 166 194 400 520 880 957 1065 1083 1093 1110 1231 
61 62 84 646 647 672 806 876 877 1011 1259 1326 1330 1335 
89 90 185 222 278 515 524 660 1236 1243 1311 1351 1354 
478 482 632 641 642 734 830 924 928 1019 1084 1114 1144 
7 58 73 74 329 484 545 607 745 865 900 1324 
125 126 173 293 294 434 463 640 691 697 971 1241 
330 331 518 874 919 920 1017 1018 1099 1184 1280 
452 479 613 727 791 873 881 1153 1171 1279 1316 
18 123 152 174 221 407 836 867 910 1312 
148 149 412 503 749 781 899 1247 1273 1348 
154 386 902 903 954 1003 1047 1056 1091 1258 
164 312 313 423 521 522 557 690 789 1016 
504 635 724 779 780 1033 1035 1118 1262 1292 
91 92 343 654 682 906 907 1045 1246 
106 175 176 233 348 819 1139 1208 1270 
116 266 346 743 896 990 1203 1266 1286 
768 769 917 918 939 1179 1190 1274 1284 
5 33 133 301 302 577 687 693 
23 85 86 744 942 1195 1289 1300 
39 51 142 223 260 597 1264 1347 
49 350 475 588 812 1040 1086 1197 
97 156 244 410 453 454 944 1032 
206 207 643 644 728 947 1136 1206 
382 387 531 594 776 846 967 1229 
8 505 839 840 862 935 1161 
24 242 277 517 1008 1232 1350 
63 681 857 871 872 1037 1189 
101 314 480 621 772 1111 1182 
141 268 496 552 801 1210 1233 
167 395 461 796 797 951 992 
241 261 413 495 842 1027 1275 
16 251 326 405 523 1175 
28 29 465 1001 1014 1176 
31 189 340 943 970 1205 
36 119 249 303 516 599 
50 292 468 574 575 617 
60 163 316 390 417 614 
71 605 748 979 991 1217 
78 610 661 662 989 1101 
81 284 657 852 886 1131 
118 416 645 952 977 1147 
120 1062 1160 1193 1194 1260 
121 160 402 456 527 923 
146 287 808 858 1168 1249 
172 409 428 528 634 718 
177 585 663 686 875 1106 
182 333 822 985 1222 1225 
193 469 470 1030 1049 1072 
202 324 464 477 1129 1248 
215 252 384 558 756 1036 
227 418 894 895 1006 1199 
240 273 274 879 929 1235 
371 436 698 1104 1141 1342 
498 549 582 604 1085 1159 
507 509 555 725 799 1150 
565 639 699 913 1004 1028 
740 854 956 1059 1078 1157 
827 998 1024 1154 1167 1321 
1009 1010 1185 1191 1296 1297 
0 433 508 770 953 
6 246 364 1029 1281 
10 889 1064 1122 1349 
25 53 272 306 844 
30 978 1071 1187 1310 
32 546 713 905 1295 
46 135 325 389 817 
68 485 1039 1133 1145 
98 986 1080 1237 1318 
108 352 532 784 1315 
110 474 1181 1218 1219 
134 427 619 742 1100 
138 488 670 676 995 
150 196 298 636 941 
192 336 411 568 1329 
232 679 680 1253 1331 
239 767 958 1069 1345 
315 586 837 838 1283 
351 404 651 843 1013 
365 596 659 701 1196 
406 824 912 1119 1120 
444 451 810 870 1276 
449 450 1227 1255 1320 
483 655 706 882 887 
499 633 711 805 1158 
620 731 774 916 1212 
771 891 1012 1125 1162 
1155 1164 1165 1288 1305 
19 179 553 559 
40 347 471 688 
45 47 763 820 
59 494 535 853 
83 178 835 1044 
87 161 813 909 
88 491 934 1097 
113 114 322 752 
153 201 307 869 
155 392 583 702 
159 554 927 1042 
181 271 534 1186 
188 437 721 1068 
197 472 547 1163 
209 247 782 999 
216 758 937 1282 
219 269 443 1075 
224 305 354 815 
283 584 786 1054 
290 696 975 1000 
321 489 1002 1188 
356 751 760 893 
357 551 648 855 
369 883 1089 1265 
398 1081 1137 1138 
539 897 932 933 
567 777 1152 1211 
671 704 825 1314 
765 866 1007 1061 
833 834 1151 1257 
850 851 1073 1291 
12 821 1272 
37 339 544 
38 145 988 
41 904 1214 
43 359 993 
55 79 1066 
82 1076 1077 
94 650 1070 
130 1238 1239 
157 982 1128 
158 579 1256 
180 190 747 
186 385 860 
231 425 719 
236 675 738 
256 286 1060 
257 338 548 
258 963 1269 
263 563 606 
264 265 818 
275 609 1021 
285 408 649 
296 383 1178 
304 342 652 
310 362 1213 
311 848 1067 
320 526 1271 
327 798 1094 
344 538 1166 
363 668 841 
376 377 972 
397 561 562 
399 974 1172 
430 705 890 
458 722 773 
493 580 1209 
530 556 1317 
581 710 980 
593 612 911 
628 629 720 
673 723 938 
677 678 828 
761 762 793 
802 983 1132 
884 885 1277 
955 1327 1338 
1115 1254 1343 
1207 1223 1328 
1220 1221 1287 
