6 7 16 24 25 34 35 40 41 58 67 73 74 76 80 81 84 85 113 123 132 142 147 148 150 157 168 169 177 190 201 227 232 291 292 314 315 328 329 344 346 366 382 384 401 402 408 412 422 424 464 466 484 488 516 519 531 535 545 546 547 574 584 585 586 593 607 612 613 629 663 667 668 675 686 700 713 738 745 758 772 775 779 788 790 791 792 793 807 832 836 837 838 843 844 846 854 865 874 875 883 885 886 900 902 911 942 948 955 986 994 1011 1024 1032 1054 1058 1085 1089 1094 1098 1100 1102 1109 1111 1117 1118 1124 1125 1131 1149 1162 1166 1175 1179 1193 1197 1202 1220 1221 1232 1237 1240 1244 1245 1252 1260 1261 1271 1273 1283 1294 1295 1299 1327 1332 1333 1338 1344 1350 
0 1 12 13 22 23 32 36 37 42 43 44 48 53 55 59 63 64 65 66 75 79 83 86 87 88 93 94 108 111 112 155 174 189 195 200 208 212 218 219 220 234 235 242 245 250 255 256 257 259 269 272 277 278 285 296 303 304 305 306 307 308 309 321 322 327 339 340 341 349 353 355 360 361 374 375 381 388 398 403 415 416 421 443 457 467 468 473 475 489 502 503 504 508 526 573 588 594 599 608 625 626 627 656 681 688 724 728 736 751 770 786 798 803 812 873 877 890 899 926 936 953 980 993 997 1029 1061 1070 1071 1106 1122 1136 1137 1138 1147 1167 1187 1213 1234 1247 1248 1270 1272 1306 1310 1315 1325 1349 
4 11 27 46 68 78 82 91 92 98 107 118 119 121 122 134 140 141 152 166 167 179 194 207 213 214 222 253 284 289 290 324 343 391 392 395 397 400 413 423 426 427 447 448 451 452 458 470 474 485 493 494 499 500 520 556 570 572 581 589 590 610 615 628 637 639 652 655 658 661 662 669 704 714 726 744 773 778 795 797 800 804 835 845 856 867 889 918 931 946 947 957 967 970 989 1007 1040 1042 1044 1045 1079 1101 1211 1212 1231 1348 
10 51 52 56 57 69 103 104 120 125 126 131 135 156 158 172 173 196 197 228 236 237 248 251 268 288 294 352 378 428 429 430 434 442 461 463 472 495 534 539 541 595 640 648 676 697 703 706 727 742 747 827 841 851 861 863 897 904 905 922 933 941 951 971 976 982 992 996 1002 1008 1020 1022 1023 1031 1048 1060 1064 1073 1088 1103 1133 1141 1173 1177 1194 1195 1210 1223 1233 1243 1289 1300 1328 
8 9 20 101 102 124 146 187 188 202 203 211 216 217 221 229 230 246 247 252 262 263 276 319 320 331 332 333 334 345 354 357 365 399 431 435 440 441 476 491 492 505 550 551 558 560 561 592 622 632 635 698 733 735 753 754 756 766 783 823 852 860 862 870 934 935 975 981 987 995 1036 1038 1067 1087 1121 1129 1227 1281 
28 29 38 39 49 50 60 89 139 181 182 185 186 370 371 373 404 405 444 465 479 532 617 618 636 638 659 660 666 671 683 699 737 755 760 764 782 810 822 849 919 937 960 964 965 983 984 1017 1019 1062 1092 1104 1132 1140 1161 1165 1181 1199 1205 1207 1216 1222 1224 1225 1229 1278 1279 1282 1314 1342 1354 
127 128 136 137 170 171 191 192 223 264 265 420 460 477 478 486 487 542 564 616 623 624 691 692 710 721 1068 1083 1107 1108 1112 1135 1241 1290 1302 1347 
2 3 21 105 106 109 110 176 224 233 260 261 347 348 393 419 437 512 571 597 634 715 771 809 819 901 915 974 1139 1142 1143 1183 1208 1275 
153 154 225 226 369 386 387 506 510 536 537 600 601 749 750 871 872 903 998 1003 1037 1056 1057 1148 1154 1169 1258 1264 1265 1301 1319 1321 1346 
5 26 30 33 45 97 133 161 180 243 244 254 271 279 301 302 453 454 481 498 577 598 619 687 693 802 818 910 932 944 985 1320 
31 47 99 100 159 231 275 295 358 359 394 409 425 462 471 523 527 528 657 665 718 757 794 840 923 927 943 969 1021 1096 
509 515 524 555 567 568 739 740 741 780 799 833 834 956 1013 1059 1078 1150 1151 1152 1157 1236 1257 1351 
61 62 513 646 647 805 806 826 868 876 906 907 1050 1134 1158 1246 1263 1266 1276 1326 1330 1335 1336 
14 15 115 267 326 396 565 596 649 743 759 913 968 1004 1025 1090 1153 1230 1242 1259 1303 
258 293 338 350 356 367 383 548 549 557 582 583 604 609 696 869 940 978 1039 1178 
77 144 145 175 209 210 281 282 330 517 518 569 914 1046 1051 1052 1063 1075 1105 
336 364 411 614 731 774 808 864 879 880 887 962 1065 1082 1155 1235 1287 1288 1329 
206 249 311 342 363 380 514 643 644 732 811 848 857 966 1145 1182 1189 1198 
160 238 239 496 501 552 653 672 746 752 767 785 801 815 855 1277 1345 
164 165 406 407 414 575 576 580 630 631 814 816 878 1012 1113 
312 313 469 521 522 554 633 690 761 789 1014 1016 1055 1128 1163 
54 95 96 149 204 205 379 490 563 578 579 866 1114 1146 
162 163 389 390 417 418 538 707 708 763 820 945 1093 1186 
300 368 684 685 702 729 765 781 817 1172 1215 1298 1307 1308 
116 266 480 651 730 831 896 949 950 990 1015 1047 1228 
215 310 325 362 438 439 459 562 654 882 894 1028 1304 
70 71 72 446 497 605 748 825 892 979 991 
117 316 317 372 445 768 917 939 1005 1034 1066 
151 286 287 318 682 858 893 908 1170 1209 1249 
432 673 674 701 705 722 723 921 938 1043 1196 
482 483 641 642 734 829 830 924 928 1084 1144 
129 130 507 591 606 611 891 1001 1238 1239 
198 199 270 297 298 335 533 958 959 973 
283 529 530 664 694 695 930 999 1035 
178 351 784 954 1076 1077 1080 1318 
650 725 796 824 912 1119 1120 1201 
18 19 299 553 559 566 787 
183 184 337 709 1069 1130 1204 
193 323 376 511 972 1049 1072 
433 525 602 603 762 1081 1262 
449 450 719 1086 1116 1156 1255 
240 241 273 274 385 929 
280 847 888 898 1097 1192 
377 455 456 670 1206 1214 
679 680 1164 1253 1305 1331 
1009 1010 1185 1191 1296 1297 
587 1074 1217 1256 1293 
645 884 977 988 1091 
677 678 776 777 828 
769 1190 1274 1284 1316 
17 410 850 1291 
90 920 1110 1311 
436 689 895 1006 
620 621 716 717 
711 842 1026 1027 
712 821 925 1030 
916 1053 1123 1200 
952 1159 1160 1168 
114 813 909 
138 720 1184 
540 1226 1285 
839 859 1317 
853 1033 1292 
1018 1099 1280 
1115 1254 1343 
1126 1127 1174 
1218 1219 1312 
