1 12 13 22 23 32 34 36 37 40 42 43 53 59 63 66 69 86 87 88 93 94 111 119 142 143 148 149 189 195 208 212 219 220 234 235 245 250 252 255 256 257 258 259 269 277 278 280 296 303 305 306 308 309 320 322 327 339 340 349 350 352 353 354 355 360 361 362 366 374 381 388 392 403 406 414 421 433 438 440 457 467 468 475 489 501 502 503 504 508 513 515 516 526 570 573 575 588 591 594 599 600 604 608 619 625 626 627 635 645 649 724 780 792 817 845 867 872 875 877 908 909 936 937 953 960 967 979 997 1023 1033 1037 1041 1081 1085 1094 1106 1147 1162 1187 1203 1213 1259 1260 1266 1273 1282 1309 1315 1331 1332 1334 1337 1348 
8 20 21 27 31 44 46 60 64 100 128 134 137 141 156 157 163 171 178 185 186 236 238 264 265 268 275 279 281 289 316 317 332 372 373 391 401 409 415 417 425 428 434 444 445 448 450 479 486 527 532 534 539 543 545 551 564 572 589 613 616 618 623 630 631 634 639 653 663 665 666 672 692 718 735 768 782 784 785 790 793 795 818 822 839 840 855 858 878 899 901 914 916 921 933 943 948 954 964 965 970 988 1021 1034 1043 1053 1054 1066 1076 1091 1095 1096 1107 1123 1128 1141 1143 1171 1180 1183 1198 1199 1200 1205 1231 1247 1271 1325 
4 7 10 14 15 26 30 33 51 52 67 72 75 81 82 83 97 126 129 132 133 153 158 167 172 180 183 184 227 244 267 271 272 285 288 294 299 301 302 307 334 336 337 347 356 375 390 396 397 400 429 453 454 461 474 488 497 520 552 556 565 569 578 581 582 593 598 601 611 636 650 652 687 688 693 707 728 748 750 759 802 820 835 859 886 887 893 906 907 913 944 945 951 957 968 980 992 1004 1025 1044 1045 1048 1073 1087 1090 1093 1131 1159 1175 1181 1195 1218 1219 1230 1236 1242 1303 1317 1328 1329 1346 
5 48 56 70 106 115 118 140 176 188 191 194 224 233 260 313 348 393 416 418 419 436 447 458 460 485 512 518 542 584 595 603 624 648 656 657 696 715 721 726 742 771 803 809 827 841 894 895 920 946 969 974 1006 1039 1068 1079 1124 1135 1177 1208 1223 1234 1270 1275 1290 1302 1306 1313 1339 
0 68 77 78 104 146 165 174 242 254 287 293 338 367 442 482 483 494 495 498 544 548 549 557 583 606 609 640 641 642 670 682 697 758 786 787 814 829 830 869 870 891 924 928 971 978 1007 1012 1022 1084 1105 1117 1133 1144 1211 1214 1238 1239 1253 1267 1268 1312 
61 62 73 80 107 108 113 114 131 168 173 187 196 202 203 228 247 251 266 284 286 298 404 476 525 550 554 558 615 646 651 723 733 737 754 800 860 874 876 896 981 990 996 1001 1011 1042 1058 1077 1100 1103 1114 1178 1264 1286 1318 1330 1335 1344 
16 17 47 135 147 152 204 221 274 295 310 311 325 326 358 359 389 394 395 410 423 439 462 471 523 674 680 699 757 764 794 798 808 850 879 880 889 910 1008 1028 1032 1065 1082 1083 1155 1164 1165 1235 1252 1288 1291 1305 
2 54 101 170 206 207 209 246 249 363 364 383 480 499 500 514 644 647 681 711 712 796 797 805 806 811 812 813 819 824 848 851 857 868 947 1029 1036 1050 1112 1119 1120 1134 1158 1182 1246 1263 1281 1326 1336 
19 49 98 130 160 161 179 190 215 239 243 323 345 402 426 451 459 562 590 654 655 658 709 744 756 761 762 778 788 823 897 925 932 958 1030 1069 1080 1098 1130 1142 1163 1204 1276 1295 
79 84 85 201 210 300 304 407 412 430 443 473 506 531 574 580 617 673 702 736 821 861 890 942 956 962 963 1047 1052 1060 1063 1072 1075 1110 1269 1272 1294 1321 
18 38 57 144 145 166 230 237 248 318 405 420 437 478 530 540 563 566 602 710 713 714 866 915 919 987 1018 1046 1062 1168 1194 1206 1241 1278 1280 1310 
24 55 136 346 427 452 517 529 664 671 684 685 704 779 781 825 833 834 856 884 885 929 930 952 977 999 1035 1150 1151 1186 1215 1257 1277 1279 1298 1314 
25 91 112 127 154 169 213 214 223 225 226 273 328 386 387 537 610 629 683 729 801 807 898 903 1003 1014 1016 1038 1056 1067 1108 1169 1202 1258 1319 1347 
45 96 120 231 232 378 446 496 507 528 622 633 638 679 708 722 746 747 752 763 773 815 816 863 892 1113 1160 1173 1193 1196 1209 1210 1224 1244 1245 1261 
6 11 29 76 217 292 324 357 371 376 464 477 555 579 607 632 694 698 725 734 767 927 1019 1020 1122 1129 1145 1170 1176 1184 1256 1285 1304 1345 1349 
39 159 182 192 193 282 290 312 331 411 469 470 511 521 568 605 690 731 755 789 864 883 938 941 972 975 1000 1049 1074 1156 1212 1225 1287 1289 1300 
41 89 90 103 181 197 222 522 524 541 637 660 675 705 706 774 849 882 904 961 982 1031 1121 1140 1166 1216 1229 1232 1243 1311 1322 1323 1350 1351 1354 
58 74 95 122 123 200 205 314 315 329 424 484 519 585 643 667 668 686 689 703 727 745 865 900 955 959 983 1104 1139 1201 1237 1249 1327 1338 1342 
162 262 342 351 576 620 621 695 700 716 719 720 730 738 772 832 902 926 935 950 966 993 1015 1057 1111 1138 1222 1228 1240 1248 
276 422 493 586 587 614 661 662 769 831 836 837 838 847 918 939 986 989 1101 1136 1190 1207 1217 1221 1274 1283 1284 1293 1316 
28 50 71 449 465 592 612 777 791 862 873 911 976 1061 1064 1092 1132 1153 1197 1226 1227 1320 1340 1341 
102 240 241 492 509 510 567 739 740 828 854 912 1013 1059 1078 1115 1152 1157 1254 1299 1343 
9 109 125 150 151 370 377 380 463 487 676 691 826 940 949 984 994 1109 1118 1255 
99 198 199 270 297 335 343 344 399 481 533 538 577 628 751 760 973 1017 1172 
138 139 164 218 669 995 1009 1010 1026 1027 1055 1102 1116 1125 1185 1191 1296 1297 
65 124 155 263 379 472 505 547 732 804 881 917 923 934 1146 1179 1189 
92 105 116 398 455 456 466 490 559 741 775 844 1040 1071 1099 1137 1333 
261 413 677 678 717 776 810 842 846 888 1070 1086 1097 1149 1167 1192 
341 368 535 536 743 770 853 871 998 1024 1148 1154 1262 1292 1301 
211 319 365 435 491 560 571 596 597 659 766 783 1051 1161 
3 369 382 384 385 561 749 799 843 1088 1089 1265 
35 177 291 333 765 852 922 985 991 1220 1307 1308 
117 121 216 229 253 283 441 553 753 931 1005 
110 175 321 330 546 1002 1188 1324 
408 431 432 701 905 1233 
