1 12 13 22 23 32 34 36 40 42 43 53 55 59 63 66 69 86 87 93 94 111 119 130 148 149 165 174 181 189 195 208 212 219 220 234 235 245 250 252 255 257 258 259 269 272 277 278 280 296 303 305 306 308 309 320 322 325 327 339 340 349 350 352 353 355 360 361 362 366 374 381 388 392 403 406 414 421 433 438 467 468 475 502 503 504 508 513 515 516 526 570 573 575 588 591 594 599 600 606 608 619 626 627 635 645 649 650 724 765 780 792 845 867 872 875 877 891 908 909 936 937 953 979 997 1012 1023 1033 1035 1037 1058 1081 1106 1147 1162 1186 1187 1213 1217 1238 1239 1260 1266 1273 1282 1309 1315 1332 1334 1348 
4 20 21 26 30 33 47 65 70 88 97 99 112 124 133 134 135 147 152 155 158 166 169 172 180 199 204 207 226 244 256 263 271 294 295 301 302 334 356 358 359 379 394 395 415 429 453 454 462 471 505 523 598 615 628 636 687 693 711 722 732 737 757 778 789 794 798 804 808 859 879 880 881 889 901 910 923 934 941 998 1020 1065 1070 1073 1082 1083 1093 1094 1103 1114 1143 1154 1167 1169 1181 1183 1189 1195 1198 1218 1219 1300 1312 1317 1325 
31 44 46 64 100 141 156 157 178 182 185 186 209 211 216 217 229 236 238 253 265 268 275 282 283 317 368 373 391 400 409 410 425 428 434 441 445 479 520 527 532 534 543 545 560 589 618 631 634 653 663 665 666 672 674 718 734 753 768 782 784 785 790 793 822 839 840 878 899 906 907 916 933 943 948 954 957 964 970 988 1019 1024 1034 1045 1053 1054 1066 1076 1091 1095 1096 1123 1141 1180 1196 1199 1200 1205 1210 1231 1243 1247 1271 
48 56 61 62 106 109 118 140 176 188 191 224 233 260 313 348 393 408 416 418 419 431 432 436 447 460 485 487 512 542 624 646 647 648 656 696 701 714 715 721 726 742 771 803 805 806 809 826 841 868 874 876 894 895 896 905 920 946 969 974 990 996 1000 1001 1006 1011 1039 1068 1079 1100 1108 1124 1134 1135 1158 1177 1203 1208 1223 1233 1234 1246 1259 1263 1270 1275 1276 1286 1290 1302 1306 1313 1326 1330 1335 1336 1339 
6 19 29 57 74 123 128 137 144 171 179 190 230 248 318 357 376 401 420 426 437 449 450 476 478 486 530 540 555 562 563 564 566 579 602 607 616 623 632 692 710 725 727 764 817 866 915 921 987 1002 1043 1046 1107 1142 1168 1170 1184 1194 1206 1226 1227 1241 1256 1285 1289 1310 1320 
5 7 75 81 82 83 126 129 132 138 218 284 285 288 307 336 347 375 390 396 397 457 474 488 489 556 561 569 578 581 582 593 595 601 652 669 688 707 728 748 759 820 835 945 951 980 995 1044 1102 1118 1125 1131 1159 1328 1329 
9 10 16 17 78 98 101 127 161 215 237 243 274 279 310 311 326 345 423 435 439 459 461 494 501 539 552 558 590 625 654 655 658 683 699 744 756 770 802 818 897 917 932 944 960 1008 1028 1032 1036 1041 1235 1252 1291 1304 
18 38 80 107 108 145 173 187 203 228 247 298 332 387 389 405 440 531 550 604 611 612 613 620 630 713 717 733 738 754 776 788 846 847 860 888 911 919 967 981 1018 1062 1085 1097 1098 1115 1149 1171 1192 1236 1254 1278 1295 
25 91 139 154 164 213 214 225 273 299 312 328 329 386 469 470 484 511 521 537 610 629 690 729 801 807 869 898 903 938 972 1003 1009 1010 1014 1016 1026 1027 1038 1049 1055 1056 1080 1116 1163 1185 1191 1202 1258 1296 1297 1318 1319 
24 117 136 193 194 240 330 331 427 517 518 529 553 657 664 671 679 680 684 685 704 779 781 825 827 856 884 885 929 930 931 952 955 977 999 1074 1155 1156 1164 1165 1215 1277 1279 1288 1298 1305 1307 1308 1331 
3 28 50 71 76 115 261 382 384 385 413 465 592 677 678 712 735 749 769 777 791 810 823 842 843 862 873 925 927 976 1061 1086 1088 1089 1092 1112 1132 1136 1153 1176 1190 1197 1274 1284 1314 1316 1340 1341 
0 37 68 104 146 160 287 293 338 354 367 383 402 442 448 458 495 498 548 549 557 583 584 609 640 670 682 697 758 786 787 795 814 858 893 971 978 1007 1022 1030 1117 1214 1253 1267 1268 
45 96 120 131 231 232 286 378 446 496 507 528 622 633 638 708 746 747 752 763 773 815 816 863 892 1113 1160 1173 1193 1209 1224 1244 1245 1261 
11 183 184 206 239 291 292 323 337 371 499 500 694 698 709 767 796 797 850 851 922 947 1069 1104 1122 1130 1133 1145 1204 1342 1345 1349 
41 72 103 197 497 522 524 541 660 675 705 706 774 849 882 904 961 982 1021 1031 1166 1175 1216 1229 1232 1264 1344 1350 1351 1354 
39 121 142 143 192 223 290 346 411 452 480 568 605 731 755 833 834 864 883 975 1005 1067 1150 1151 1212 1225 1257 1337 1347 
35 177 205 314 333 424 472 519 547 585 668 686 689 852 886 887 939 959 985 991 1179 1201 1327 1338 
342 351 576 621 695 716 730 772 832 853 902 935 950 966 993 1015 1057 1111 1222 1228 1240 1248 1262 1292 
67 73 102 113 114 167 168 202 251 266 324 404 464 477 525 614 651 723 800 1059 1077 1129 1207 
79 276 430 443 493 574 580 661 662 673 836 890 918 986 989 1060 1072 1101 1110 1220 1221 1287 
58 95 110 122 175 200 321 546 667 703 745 865 900 914 983 1139 1188 1237 1249 1324 
84 85 153 201 210 300 412 473 506 702 942 956 962 963 1047 1052 1063 1075 1269 1321 
2 54 170 246 249 363 364 514 644 681 811 812 813 819 848 857 1029 1182 1281 
92 105 116 398 455 456 466 490 559 741 775 844 1040 1071 1099 1137 1333 
14 15 267 565 571 596 597 913 968 1004 1025 1050 1090 1230 1242 1303 
196 254 482 483 554 641 642 829 830 924 928 1042 1084 1105 1144 1178 
8 289 343 344 399 481 538 577 751 760 1017 1064 1172 1280 
198 270 297 335 341 533 535 536 743 871 958 973 1148 1301 
369 509 510 739 740 750 799 828 1078 1157 1265 1299 1343 1346 
241 242 492 544 567 824 854 912 1013 1119 1120 1152 1211 
27 60 163 281 316 417 444 572 639 870 
51 52 221 227 315 643 992 1048 1087 1146 
77 422 586 587 831 837 838 1283 1293 
89 90 222 637 1121 1140 1311 1322 1323 
264 370 380 463 676 691 940 984 994 
159 162 262 700 719 720 926 1138 
304 407 617 736 821 861 1272 1294 
319 365 491 659 766 783 1051 1161 
125 150 151 377 949 1109 1255 
49 451 603 761 762 
372 551 855 965 1128 
