1 12 13 22 23 32 34 36 37 40 42 43 53 59 63 66 69 86 87 88 93 94 111 119 142 148 149 189 195 208 212 219 220 234 235 245 250 252 255 256 257 258 259 269 277 278 280 296 303 305 306 308 309 320 322 327 339 340 349 350 352 353 354 355 360 361 362 366 374 381 388 392 403 406 414 421 433 438 440 457 467 468 475 489 501 502 503 504 508 513 515 516 526 570 573 575 588 591 594 599 600 604 608 619 625 626 627 635 645 649 724 780 792 817 845 867 872 875 877 908 909 936 937 953 960 967 979 997 1023 1033 1037 1041 1081 1085 1094 1106 1147 1162 1187 1203 1213 1259 1260 1266 1273 1282 1315 1331 1332 1348 
7 30 81 126 129 285 294 334 336 347 390 396 397 474 488 556 578 581 582 593 688 707 728 748 759 820 886 887 945 980 1093 1131 1159 1328 1329 
44 178 185 317 372 373 391 445 543 589 618 665 666 768 784 790 793 822 916 933 954 970 988 1034 1053 1066 1076 1091 1123 1141 1199 1200 1271 
5 48 56 191 233 393 418 460 542 595 603 624 648 656 715 742 803 809 969 1124 1135 1177 1223 1234 1290 1302 1306 
57 237 248 318 420 437 478 530 540 566 602 710 866 915 987 1046 1194 1206 1241 1310 
84 85 201 210 300 412 473 506 531 702 942 956 962 963 1047 1052 1063 1075 1269 1321 
41 181 522 524 660 675 774 849 904 961 1166 1216 1229 1232 1243 1350 1351 1354 
254 482 483 606 641 642 829 830 891 924 928 1084 1105 1144 1239 1312 
276 493 661 662 769 836 847 918 939 986 989 1101 1136 1190 1221 1316 
10 72 133 180 244 288 302 453 454 461 497 552 802 944 1175 
20 31 46 275 409 415 425 428 527 539 634 718 899 1096 1325 
58 95 122 200 329 484 667 703 745 900 983 1104 1139 1237 1342 
75 82 83 132 375 400 520 569 652 835 906 907 957 1044 1045 
106 176 188 224 260 313 348 419 512 771 974 1068 1208 1270 1275 
8 27 60 100 163 289 316 332 417 572 639 839 840 
45 378 446 496 622 746 747 752 763 815 892 1173 1210 
107 108 187 203 284 298 550 733 754 860 981 1264 1344 
47 147 274 471 798 808 879 880 1065 1082 1083 1235 
62 266 646 651 874 876 896 990 1011 1286 1330 1335 
128 137 171 264 265 486 564 616 623 692 818 1107 
509 510 739 740 828 854 1078 1115 1157 1254 1299 1343 
0 104 338 367 498 548 549 583 609 869 978 
18 38 145 405 713 714 919 1018 1062 1278 1280 
24 136 427 452 517 704 779 781 856 929 1215 
211 319 365 435 491 560 659 766 783 1051 1161 
33 172 271 301 429 598 636 687 693 1073 
98 130 459 590 654 655 744 778 897 932 
135 204 295 325 394 395 674 764 889 1305 
141 236 238 268 434 545 653 663 672 785 
165 174 293 442 495 697 758 814 1117 1253 
15 267 968 1025 1090 1230 1236 1242 1303 
96 231 232 507 633 638 679 1209 1224 
99 198 199 270 297 335 533 628 973 
152 221 358 359 462 523 757 794 910 
182 282 290 331 605 731 755 975 1212 
273 328 537 729 903 1014 1016 1258 1319 
612 777 791 862 873 911 976 1064 1153 
681 711 712 805 806 811 812 857 1158 
64 532 631 943 948 1021 1205 1247 
68 640 670 870 971 1022 1214 1238 
103 197 541 705 706 882 982 1031 
105 116 398 466 490 775 1071 1333 
120 708 816 1160 1193 1244 1245 1261 
312 521 690 789 938 941 1289 1300 
357 555 579 632 725 1020 1184 1256 
535 536 853 871 1148 1262 1292 1301 
89 90 222 637 1121 1140 1311 
113 114 525 615 737 1103 1114 
193 469 470 511 972 1049 1074 
205 314 689 955 1201 1327 1338 
343 344 481 538 577 751 760 
576 738 772 966 993 1111 1222 
11 292 694 767 1145 1345 
21 279 878 901 1143 1183 
26 67 167 859 951 1317 
51 52 227 992 1048 1087 
54 207 249 644 848 1182 
65 263 379 732 804 1146 
140 447 485 946 1039 1079 
150 151 377 949 1118 1255 
153 299 307 601 750 1346 
154 225 386 387 1056 1169 
192 411 568 864 883 1287 
261 413 717 842 1070 1167 
310 311 423 439 699 1028 
351 620 621 695 716 832 
424 519 585 668 686 959 
629 801 807 898 1038 1202 
677 678 776 846 1097 1192 
796 797 824 851 1119 1120 
884 885 952 977 999 1277 
1009 1010 1185 1191 1296 1297 
17 389 410 850 1291 
25 91 213 214 610 
49 451 761 762 1276 
73 404 800 996 1077 
79 443 574 580 1110 
97 158 272 356 650 
101 480 813 1036 1281 
112 169 226 1003 1067 
127 223 683 1108 1347 
138 139 1026 1027 1116 
146 287 682 786 787 
160 161 215 243 756 
216 229 283 441 753 
218 669 995 1102 1125 
239 788 958 1069 1130 
240 241 492 1013 1152 
262 342 926 1138 1248 
368 770 998 1024 1154 
407 617 861 1272 1294 
430 673 890 1060 1072 
436 841 894 895 1006 
680 1155 1164 1165 1288 
730 950 1015 1057 1228 
833 834 1150 1151 1257 
868 1112 1246 1263 1336 
3 382 384 561 
14 565 913 1004 
19 179 190 562 
28 50 71 465 
29 76 927 1176 
61 1001 1100 1318 
70 194 657 827 
109 487 826 1109 
118 416 696 721 
134 735 1198 1231 
162 700 719 720 
168 202 558 1058 
183 184 337 611 
186 782 964 1054 
196 554 1042 1178 
206 499 500 947 
209 246 383 1029 
217 734 1019 1304 
281 444 534 914 
324 464 477 1129 
346 671 825 1314 
369 749 799 1265 
370 380 676 984 
371 698 1122 1349 
385 843 1088 1089 
401 450 921 1043 
449 1226 1227 1320 
455 456 741 1040 
463 691 940 994 
472 547 917 1179 
505 881 923 934 
528 722 773 1196 
529 664 930 1035 
586 587 1217 1293 
647 1050 1134 1326 
684 685 1279 1298 
823 925 1098 1295 
893 1181 1218 1219 
2 514 819 
6 376 607 
35 922 1220 
74 123 727 
80 173 476 
92 559 1099 
110 175 330 
115 458 584 
117 553 931 
121 253 1005 
124 155 1189 
156 157 1128 
159 1000 1156 
166 230 1168 
170 363 364 
242 544 1211 
304 736 821 
321 546 1002 
323 402 1030 
333 985 991 
399 1017 1172 
408 701 905 
431 432 1233 
448 795 858 
494 1012 1133 
518 726 920 
551 855 965 
571 596 597 
837 838 1283 
902 935 1240 
1008 1032 1252 
1092 1132 1197 
