1 12 13 22 23 32 34 36 37 40 42 43 53 59 63 66 69 86 87 88 93 94 111 119 142 148 149 174 189 195 208 212 219 220 234 235 239 245 250 252 255 256 257 258 259 269 272 277 278 291 296 303 305 306 308 309 320 322 327 339 340 349 350 352 353 354 355 360 361 362 366 374 381 388 392 403 406 414 421 433 438 440 457 467 468 475 489 501 502 503 508 513 515 516 526 570 573 575 588 591 594 599 600 604 608 619 625 626 627 635 645 649 650 724 765 780 788 792 845 867 872 875 877 908 909 936 937 953 958 960 967 979 997 1023 1033 1035 1037 1041 1058 1085 1094 1106 1147 1162 1187 1213 1260 1266 1273 1282 1315 1331 1332 1348 
44 178 182 185 186 282 317 372 373 391 445 543 551 589 618 665 666 768 782 784 790 793 822 916 933 954 964 965 970 988 1034 1053 1054 1066 1076 1091 1098 1123 1141 1199 1200 1237 1271 1295 
57 128 137 166 171 230 237 248 318 420 437 478 486 530 540 564 566 602 616 623 692 710 817 866 915 987 1046 1107 1168 1194 1206 1241 1289 1310 
26 30 33 97 126 155 158 172 271 294 301 302 334 356 395 400 429 598 636 687 693 737 778 820 859 951 1073 1093 1317 
5 48 56 191 233 393 418 460 542 595 603 624 648 656 715 742 803 809 969 996 1124 1135 1177 1223 1234 1290 1302 1306 
20 31 46 141 238 268 275 409 410 415 425 428 434 527 539 545 634 653 672 718 785 839 840 899 1096 1325 
45 72 120 378 446 496 528 622 708 722 746 747 752 763 773 815 816 892 1160 1173 1193 1196 1210 1244 1245 1261 
47 70 147 152 221 274 295 358 359 394 462 471 523 757 794 798 808 879 880 1065 1082 1083 1235 
14 15 129 336 337 396 397 556 565 578 581 582 728 759 913 980 1004 1159 1236 1329 
61 266 646 647 805 806 868 876 896 990 1011 1112 1134 1158 1246 1259 1263 1326 1335 1336 
10 133 135 180 204 288 325 389 461 497 674 707 764 802 889 1064 1175 1305 
130 254 482 483 641 642 829 830 924 928 1084 1105 1144 1219 1238 1239 1312 
75 83 115 132 285 307 375 488 601 652 906 907 957 1044 1045 1131 
106 109 176 188 224 260 313 348 419 512 771 974 1068 1208 1270 1275 
98 215 310 311 345 439 459 494 552 590 654 655 658 744 756 
107 108 187 203 284 298 332 550 611 733 754 860 981 1264 1344 
24 136 427 452 517 671 704 779 781 856 929 1215 1307 1308 
524 660 675 774 849 961 1166 1216 1229 1232 1243 1350 1351 1354 
18 38 145 405 713 714 919 1018 1062 1115 1254 1278 1280 
0 104 323 324 367 498 548 549 583 609 869 978 
493 661 662 769 847 918 939 989 1101 1136 1190 1316 
105 116 398 466 490 775 844 1071 1137 1203 1333 
35 205 314 519 585 686 689 922 1201 1220 
84 85 412 473 506 531 702 942 956 1321 
193 194 469 470 511 657 827 972 1049 1074 
387 620 677 678 716 717 776 846 1097 1192 
68 338 640 670 835 893 971 1022 1214 
91 273 328 537 729 903 1014 1016 1319 
96 231 232 507 633 638 679 1209 1224 
99 198 199 270 297 335 533 628 973 
165 293 442 495 697 758 814 1117 1253 
342 576 738 772 966 993 1111 1222 1248 
27 60 100 163 316 417 572 639 
65 124 263 379 732 804 1146 1189 
81 347 569 593 688 886 887 1050 
103 197 541 705 706 882 982 1031 
299 369 749 750 799 1003 1265 1346 
357 555 579 632 725 1020 1184 1256 
509 510 739 740 828 854 1078 1157 
529 664 684 685 930 999 1279 1298 
612 777 791 862 873 911 976 1153 
3 382 384 385 843 1088 1089 
4 244 453 454 910 944 1195 
7 390 474 748 1181 1218 1328 
211 216 229 283 441 560 753 
343 344 481 538 577 751 760 
695 730 832 950 1015 1057 1228 
11 292 694 767 1145 1345 
51 52 227 992 1048 1087 
62 1001 1100 1286 1318 1330 
113 114 525 615 1103 1114 
117 121 253 553 931 1005 
140 447 485 946 1039 1079 
150 151 377 949 1118 1255 
206 499 500 711 712 947 
207 249 681 811 812 857 
267 968 1025 1090 1230 1303 
351 402 621 902 1030 1240 
629 801 807 898 1038 1202 
1009 1010 1185 1191 1296 1297 
21 279 901 1143 1183 
29 76 927 1092 1176 
49 451 761 762 1276 
73 404 651 800 1077 
79 443 574 580 1110 
102 319 435 766 1059 
112 169 226 1067 1169 
127 223 683 1108 1347 
138 139 1026 1027 1116 
146 287 682 786 787 
154 225 386 1056 1258 
168 202 558 561 1036 
201 210 1052 1063 1075 
209 246 383 1029 1281 
218 669 995 1102 1125 
240 241 492 1013 1152 
261 413 842 1070 1167 
300 962 963 1047 1269 
368 520 998 1024 1154 
407 617 861 1272 1294 
430 673 890 1060 1072 
436 841 894 895 1006 
535 536 871 1148 1301 
667 703 983 1104 1342 
680 1155 1164 1165 1288 
796 797 824 1119 1120 
833 834 1150 1151 1257 
884 885 952 977 1277 
19 179 190 562 
25 213 214 610 
28 50 71 465 
41 522 904 1021 
54 644 848 1182 
55 181 945 1186 
80 173 476 874 
82 464 477 1129 
89 90 222 1311 
101 480 770 813 
118 416 696 721 
134 735 1198 1231 
144 563 606 914 
162 700 719 720 
164 521 878 1055 
183 184 1069 1130 
192 411 864 883 
196 554 1042 1178 
217 734 1019 1304 
281 444 534 870 
290 331 605 975 
321 546 1002 1188 
329 484 900 1324 
370 380 676 984 
371 698 1122 1349 
401 450 921 1043 
449 1226 1227 1320 
455 456 741 1040 
458 557 584 1007 
463 691 940 994 
472 547 917 1179 
505 881 923 934 
568 731 755 1212 
571 596 597 1242 
586 587 1217 1293 
690 789 941 1300 
823 897 925 932 
853 935 1262 1292 
943 948 1205 1247 
2 514 819 
6 376 607 
9 125 783 
16 17 1291 
58 200 1139 
64 532 631 
74 123 727 
92 559 1099 
95 122 745 
110 175 330 
153 491 1051 
159 1000 1156 
160 161 243 
170 363 364 
242 544 1211 
262 926 1138 
264 265 818 
280 504 1081 
304 736 821 
333 985 991 
346 825 1314 
365 659 1161 
399 1017 1172 
408 701 905 
424 668 959 
431 432 1233 
448 795 858 
487 826 1109 
518 726 920 
637 1121 1140 
837 838 1283 
891 1012 1133 
955 1327 1338 
986 1221 1287 
1008 1032 1252 
