7 12 32 39 42 43 44 81 88 89 90 91 92 106 107 108 109 111 114 165 166 167 169 171 205 206 207 311 321 327 328 353 365 466 472 487 488 489 494 495 506 527 528 529 530 532 534 537 587 601 602 624 625 675 
31 34 37 69 103 172 173 174 175 176 177 178 203 204 249 272 273 351 415 428 429 430 560 574 581 582 651 
28 29 30 237 248 360 400 410 427 431 432 473 480 543 559 567 630 652 653 654 655 656 
179 180 181 182 184 185 186 189 191 192 194 387 388 389 390 391 392 538 550 590 611 
53 54 55 56 57 58 59 60 61 62 63 152 153 154 155 156 380 463 518 672 
221 222 223 224 225 226 227 340 341 342 343 344 461 591 592 593 594 646 647 668 
75 78 83 234 236 238 240 241 242 243 244 245 247 265 266 268 421 536 640 
131 132 138 140 141 144 145 146 147 149 150 313 451 482 519 613 618 
33 133 134 135 136 137 142 143 148 274 470 471 523 524 631 632 
41 246 299 300 330 362 363 375 490 492 503 504 522 610 621 644 
66 67 68 291 292 397 398 399 408 445 483 620 
5 6 8 9 10 11 14 15 86 533 586 
96 97 98 99 101 102 104 105 627 628 629 
100 200 280 281 282 283 284 285 286 329 411 
115 116 117 118 119 120 121 122 338 539 571 
70 71 308 309 310 438 439 440 626 658 
87 93 94 95 195 202 378 481 641 642 
448 449 450 452 453 454 549 612 619 671 
0 235 239 262 263 264 267 287 416 
19 20 21 22 151 368 441 479 661 
38 213 214 215 216 217 218 220 412 
350 406 425 426 459 462 616 660 666 
73 76 82 157 158 352 385 622 
127 301 302 303 316 317 648 649 
417 418 419 420 531 579 580 603 
72 80 159 163 230 384 667 
168 170 377 404 405 407 597 
250 251 252 253 254 409 566 
269 270 271 335 336 337 364 
288 331 332 333 356 357 553 
295 296 297 298 318 319 339 
23 366 386 401 402 403 
24 25 26 27 219 334 
49 322 323 324 325 326 
123 124 258 546 564 565 
369 370 458 512 513 554 
125 126 128 129 130 
139 371 372 373 374 
183 190 193 500 514 
208 209 210 211 212 
289 290 561 638 639 
345 346 347 348 349 
468 469 547 548 558 
474 475 476 520 521 
493 525 526 535 545 
636 637 645 659 678 
1 2 3 4 
40 498 570 600 
74 79 376 657 
77 257 259 261 
110 113 320 555 
231 232 233 676 
260 315 486 572 
358 359 361 367 
381 382 501 502 
393 394 395 460 
497 588 589 670 
45 46 437 
47 48 505 
50 662 663 
112 275 279 
160 161 162 
196 197 198 
199 201 617 
255 256 396 
306 307 312 
422 423 424 
444 496 540 
455 456 457 
507 508 509 
510 511 669 
515 516 517 
551 552 575 
568 569 623 
576 577 578 
583 584 585 
607 608 609 
