0 7 34 41 42 248 299 301 302 303 321 328 362 363 425 426 427 459 489 503 504 537 625 630 643 648 649 666 
17 234 235 236 237 238 239 240 241 242 243 244 245 246 247 262 263 264 265 266 267 268 287 288 316 416 655 656 
40 53 54 56 58 59 61 62 63 152 153 154 155 156 283 379 380 401 402 403 493 525 526 535 545 570 672 
72 73 74 75 76 77 78 79 80 81 82 83 157 158 159 195 228 229 230 383 384 385 622 667 
179 180 181 182 183 184 185 186 189 190 191 192 193 194 388 389 391 500 514 550 590 611 
106 107 108 109 163 164 165 166 167 168 169 170 171 205 206 207 311 315 353 466 467 
8 43 87 88 90 91 92 93 94 95 122 378 481 532 586 587 600 601 602 
30 86 141 345 346 347 349 397 398 399 400 408 409 410 421 536 567 620 640 
131 134 135 136 137 139 142 143 145 148 150 274 371 372 373 458 513 
66 68 123 358 359 360 361 366 367 375 376 386 483 564 565 657 
23 27 37 69 128 249 282 284 286 369 370 415 554 573 574 
118 119 120 133 300 330 338 490 492 522 539 571 610 621 644 
14 212 419 506 527 528 529 530 531 534 579 580 675 
67 250 251 253 254 291 292 444 445 496 497 540 566 
55 113 320 404 405 406 420 491 512 544 555 660 
124 313 431 432 448 449 450 451 452 453 546 
213 214 215 216 217 218 219 412 588 589 670 
221 222 223 224 225 226 227 340 576 647 
99 104 199 201 202 617 641 642 659 
140 149 314 549 612 613 618 619 671 
5 6 9 10 11 12 15 533 
31 32 33 35 36 38 327 365 
175 231 232 233 377 407 597 676 
28 29 350 351 352 616 651 
220 470 471 523 524 631 632 
269 270 271 335 336 337 364 
295 296 297 298 318 319 339 
16 18 454 487 488 498 
39 89 110 111 114 624 
44 387 390 392 486 572 
49 322 323 324 325 326 
132 138 146 147 482 519 
172 173 174 176 177 178 
348 472 473 480 543 559 
252 636 637 645 678 
257 258 259 260 261 
272 273 428 429 430 
1 2 3 4 
24 25 26 334 
97 101 102 105 
98 187 538 635 
112 200 279 411 
115 116 117 121 
203 204 464 465 
208 209 210 211 
280 281 285 329 
331 332 333 356 
515 516 517 518 
13 650 677 
47 48 505 
50 662 663 
57 462 463 
275 276 277 
317 484 485 
417 418 603 
455 456 457 
551 552 575 
607 608 609 
627 628 629 
652 653 654 
