5 7 8 9 10 12 13 14 15 32 39 40 42 43 44 72 73 74 75 76 81 82 83 84 85 86 87 88 89 90 91 92 93 94 95 111 114 157 158 159 195 202 321 327 328 352 365 378 379 383 385 406 426 449 472 481 487 488 493 494 495 506 525 526 527 528 529 530 532 533 534 535 537 541 542 545 570 586 587 600 601 602 616 622 624 625 640 641 642 660 666 675 
77 80 106 107 108 109 110 112 113 163 164 165 166 167 168 169 170 171 205 206 207 228 229 230 257 259 260 261 275 276 277 278 279 295 296 297 298 311 315 318 319 320 339 353 377 384 404 405 407 466 467 484 485 486 555 572 597 598 599 606 607 608 609 667 
0 1 2 3 4 41 78 103 199 200 201 234 235 236 237 238 239 240 241 242 243 244 245 246 247 262 263 264 265 266 267 268 287 299 300 330 350 362 363 375 411 416 421 503 504 536 610 617 621 644 655 656 
6 11 28 29 30 66 67 68 248 254 291 292 345 346 347 348 349 360 397 398 399 400 408 409 410 425 427 431 432 444 445 459 473 480 483 496 540 543 559 566 567 620 630 636 652 653 654 677 
31 34 35 36 37 69 172 173 174 175 176 177 178 203 204 249 272 273 293 294 351 415 428 429 430 464 465 560 574 581 582 651 
49 50 96 97 98 99 100 101 102 104 105 280 281 282 283 284 285 286 322 323 324 325 326 329 498 627 628 629 633 634 662 663 
182 183 186 188 190 193 221 222 223 224 225 226 227 340 341 342 343 344 461 499 500 514 591 592 593 594 646 647 668 
131 132 138 140 141 144 146 147 149 150 313 314 448 450 451 452 453 454 519 549 612 613 618 619 671 
53 54 55 56 57 58 59 60 61 62 63 152 153 154 155 156 380 462 463 515 516 517 518 672 
33 133 134 135 136 137 142 143 145 148 274 304 305 442 443 470 471 482 523 524 631 632 
179 180 181 184 185 187 189 191 192 194 387 388 389 390 391 392 538 550 590 611 650 
23 24 25 26 27 219 334 358 359 361 366 367 386 401 402 403 
139 369 370 371 372 373 374 455 456 457 458 512 513 554 
38 213 214 215 216 217 218 220 412 497 588 589 670 
417 418 419 420 490 491 492 522 531 544 579 580 603 
47 48 127 301 302 303 316 317 505 648 649 
115 116 117 118 119 120 121 122 338 539 571 
70 71 308 309 310 438 439 440 626 658 
19 20 21 22 151 368 441 479 661 
123 124 258 546 551 552 564 565 575 
269 270 271 335 336 337 364 635 643 
250 251 252 253 637 645 659 678 
288 331 332 333 356 357 553 
51 52 576 577 578 
125 126 128 129 130 
208 209 210 211 212 
231 232 233 489 676 
289 290 561 638 639 
468 469 547 548 558 
474 475 476 520 521 
16 17 18 573 
381 382 501 502 
393 394 395 460 
45 46 437 
79 376 657 
160 161 162 
196 197 198 
255 256 396 
306 307 312 
422 423 424 
507 508 509 
510 511 669 
568 569 623 
583 584 585 
