7 8 12 18 32 42 43 81 86 88 90 91 92 93 115 116 117 118 119 120 121 122 165 284 321 327 328 338 353 365 481 487 488 498 537 539 586 587 625 643 
27 34 37 69 100 128 172 173 174 175 176 177 178 249 272 273 351 369 370 428 429 430 458 512 513 554 560 573 574 581 582 651 
11 237 248 358 359 360 361 366 367 400 427 431 432 473 543 559 567 630 652 653 654 655 656 677 
98 102 179 180 181 182 183 185 186 187 188 189 190 191 192 193 194 388 391 500 550 611 635 
41 300 301 302 303 330 362 363 375 503 504 525 526 535 571 610 621 644 648 649 
53 54 55 56 57 58 59 60 61 62 152 153 154 155 156 380 462 463 518 672 
23 24 25 26 40 63 260 315 386 401 402 403 493 495 545 570 572 600 
5 6 9 10 13 14 527 528 529 530 531 532 533 534 675 
16 17 234 236 238 240 241 242 243 244 245 246 265 266 268 
33 131 133 134 135 136 137 139 142 143 144 148 150 274 471 
72 73 74 75 76 77 83 157 158 159 259 384 385 667 
132 138 140 141 145 146 147 149 313 451 482 519 613 618 
213 215 216 217 218 219 220 334 412 470 523 524 631 632 
0 235 239 262 263 264 267 287 288 316 317 415 416 
107 166 168 169 170 404 405 407 466 467 597 
66 68 291 292 397 398 399 408 483 620 
67 250 251 252 253 254 409 445 566 636 
70 71 308 309 310 438 439 440 626 658 
44 96 97 105 387 389 390 392 590 
295 296 297 298 318 319 320 339 555 
448 450 452 453 454 549 612 619 671 
94 95 201 202 425 617 641 642 
103 104 221 499 514 637 647 659 
108 109 164 171 205 206 207 314 
222 224 340 341 342 343 344 646 
417 418 419 420 544 579 580 603 
15 280 281 282 283 286 329 
49 99 322 323 324 325 326 
269 270 271 335 336 337 364 
444 496 497 540 588 589 670 
123 494 564 565 601 602 
406 426 459 640 660 666 
80 106 163 167 311 
89 110 111 114 624 
101 285 627 628 629 
112 199 200 350 411 
275 276 277 278 606 
345 346 347 348 349 
1 2 3 4 
29 410 480 616 
31 35 36 38 
78 247 421 536 
125 127 129 130 
203 204 464 465 
208 209 210 211 
227 576 577 578 
331 332 333 356 
490 491 492 522 
591 592 593 594 
28 30 472 
39 214 299 
47 48 505 
50 662 663 
79 376 657 
82 352 622 
87 113 378 
124 258 546 
184 538 650 
223 226 461 
228 229 230 
231 233 489 
232 377 676 
279 598 599 
371 372 373 
455 456 457 
484 485 486 
515 516 517 
551 552 575 
607 608 609 
