7 11 34 41 42 57 125 127 248 299 301 302 303 321 328 425 426 427 459 462 463 489 503 504 537 625 630 643 648 649 666 
17 234 235 236 237 238 239 240 241 242 243 244 245 246 247 251 253 262 263 264 265 266 267 268 287 288 316 416 655 656 
40 53 54 56 58 59 61 62 63 152 153 154 155 156 200 283 379 380 401 402 403 411 493 545 570 572 672 
8 39 43 87 88 89 90 91 92 93 94 95 110 111 114 122 327 378 481 532 586 587 600 601 602 624 
103 118 119 120 133 199 201 300 330 338 490 492 522 525 526 535 539 571 610 617 621 644 
72 73 74 75 76 77 78 79 80 81 82 83 157 158 159 195 383 384 385 622 667 
10 13 14 212 419 506 527 528 529 530 531 533 534 579 580 675 
23 27 37 69 128 249 282 284 286 369 370 415 554 573 574 
30 86 141 397 398 399 400 408 409 410 421 536 567 620 
179 180 181 182 184 185 186 189 192 194 388 391 538 611 
55 113 320 404 405 406 420 491 512 544 555 640 660 
44 96 98 100 187 387 389 390 392 560 590 635 
67 250 254 291 292 444 445 496 497 540 566 636 
108 163 164 165 166 167 168 170 171 311 466 467 
213 214 215 216 217 218 219 412 588 589 670 
66 68 358 359 360 361 366 367 386 483 
140 149 150 314 549 612 613 618 619 671 
221 222 223 224 225 226 227 340 576 647 
106 107 109 169 205 206 207 315 353 
134 135 136 137 142 143 145 148 274 
175 231 232 233 377 407 597 676 
49 99 322 323 324 325 326 
123 124 375 376 564 565 657 
131 139 371 372 373 458 513 
132 138 146 147 313 482 519 
183 190 191 193 500 514 550 
220 470 471 523 524 631 632 
269 270 271 335 336 337 364 
295 296 297 298 318 319 339 
431 432 448 449 450 451 452 
172 173 174 176 177 178 
15 28 29 350 616 
104 202 641 642 659 
257 258 259 260 261 
272 273 428 429 430 
275 276 277 278 606 
345 346 347 348 349 
472 473 480 543 559 
1 2 3 4 
5 6 9 12 
16 18 487 488 
24 25 26 334 
31 32 33 365 
97 101 102 105 
115 116 117 121 
203 204 464 465 
208 209 210 211 
252 637 645 678 
280 281 285 329 
317 484 485 486 
515 516 517 518 
0 362 363 
35 36 38 
47 48 505 
50 662 663 
228 229 230 
331 332 333 
351 352 651 
356 357 553 
417 418 603 
455 456 457 
551 552 575 
607 608 609 
627 628 629 
652 653 654 
