0 1 2 3 4 7 16 18 23 24 25 26 27 37 41 42 47 48 69 125 127 128 203 204 248 249 280 281 282 284 285 286 299 301 302 303 321 328 329 334 348 362 363 369 370 415 425 426 431 432 459 462 464 465 472 473 480 487 488 489 503 504 505 537 543 554 559 573 574 625 633 634 643 648 649 652 653 654 
17 34 66 68 100 123 124 172 173 174 175 176 177 178 231 232 233 234 235 236 237 238 239 240 241 242 243 244 245 246 247 262 263 264 265 266 267 268 272 273 287 288 293 294 316 317 358 359 360 361 366 367 375 376 377 386 407 416 428 429 430 483 546 551 552 560 564 565 575 597 655 656 657 676 
8 31 32 33 35 36 38 39 43 84 85 87 88 89 90 91 92 93 94 95 106 107 108 109 110 111 114 122 163 164 165 166 167 168 169 170 171 205 206 207 311 315 327 338 353 365 378 448 449 450 452 453 454 466 467 481 498 532 549 586 587 600 601 602 612 619 624 671 
49 50 51 52 96 97 98 99 101 102 103 104 105 187 199 201 202 221 222 223 224 225 226 227 269 270 271 322 323 324 325 326 335 336 337 340 341 342 343 344 364 461 538 576 577 578 591 592 593 594 617 626 627 628 629 635 641 642 646 647 659 662 663 668 
40 44 53 54 56 57 58 59 60 61 62 63 112 152 153 154 155 156 200 275 276 277 278 279 283 379 380 387 390 392 401 402 403 411 463 484 485 486 494 495 570 572 598 599 606 607 608 609 672 
5 6 9 10 11 12 14 15 28 29 208 209 210 211 212 350 351 352 417 418 419 421 506 527 528 529 530 531 533 534 536 541 542 579 580 603 616 640 651 675 
30 86 132 138 140 141 145 146 147 149 304 305 313 314 345 346 347 349 397 398 399 400 408 409 410 451 482 519 567 613 618 620 
55 113 257 258 259 260 261 295 296 297 298 318 319 320 339 404 405 406 420 458 512 513 515 516 517 518 555 660 
115 116 117 118 119 120 121 300 330 490 491 492 493 522 525 526 535 539 544 545 571 581 582 610 621 644 
72 73 74 75 76 77 78 79 80 81 82 83 157 158 159 195 228 229 230 383 384 385 622 667 
179 180 181 182 183 184 185 186 188 189 190 191 192 193 194 388 389 391 499 500 514 550 590 611 
126 131 133 134 135 136 137 139 142 143 144 148 150 274 371 372 373 374 442 443 
213 214 215 216 217 218 219 220 412 470 471 523 524 588 589 631 632 670 
67 250 251 253 254 291 292 444 445 496 497 540 566 
252 636 637 645 678 
331 332 333 356 
13 650 677 
427 630 666 
