0 7 16 18 41 42 127 248 299 301 302 303 321 328 362 363 425 426 431 432 459 462 472 487 488 489 503 504 537 625 643 648 649 652 653 654 
34 66 68 100 123 172 173 174 175 176 177 178 272 273 358 359 360 361 366 367 375 376 386 428 429 430 483 560 564 565 657 
30 86 132 138 140 141 145 146 147 149 313 314 345 346 347 349 397 398 399 400 408 409 410 451 482 519 567 613 618 620 
17 234 235 236 237 238 239 240 241 242 243 244 245 246 247 262 263 264 265 266 267 268 287 288 316 317 416 655 656 
23 27 37 69 125 128 203 204 249 280 281 282 284 285 286 329 369 370 415 554 573 574 
118 119 120 300 330 490 491 492 493 522 525 526 535 539 544 545 571 581 582 610 621 644 
106 107 108 109 163 164 165 166 167 168 169 170 171 205 206 207 311 315 466 467 
8 43 87 88 90 91 92 93 94 95 122 338 353 378 481 532 586 587 600 
40 44 63 154 379 387 390 392 401 402 403 484 485 486 494 495 570 572 
97 99 101 102 104 105 199 201 202 221 226 227 617 641 642 647 659 
53 54 56 57 58 59 60 61 62 152 153 155 156 380 463 672 
131 133 134 135 136 137 139 142 143 144 148 150 274 371 372 373 
72 73 74 79 80 82 83 158 159 230 383 384 622 667 
179 180 182 183 184 185 186 189 190 193 194 391 500 514 
32 327 448 449 450 452 453 454 498 549 612 619 671 
14 419 527 528 529 530 531 534 579 580 675 
55 113 320 404 405 406 420 512 555 660 
75 76 77 78 81 157 195 228 229 385 
15 28 29 350 351 352 533 616 651 
39 84 85 89 110 111 114 624 
213 214 215 217 218 219 412 632 
67 250 251 253 254 445 566 
231 232 233 377 407 597 676 
269 270 271 335 336 337 364 
295 296 297 298 318 319 339 
5 6 9 10 11 12 
49 322 323 324 325 326 
220 470 471 523 524 631 
291 292 444 496 497 540 
31 33 365 601 602 
112 200 279 283 411 
252 636 637 645 678 
257 258 259 260 261 
275 276 277 278 606 
348 473 480 543 559 
1 2 3 4 
24 25 26 334 
98 187 538 635 
115 116 117 121 
208 209 210 211 
216 588 589 670 
341 343 626 646 
515 516 517 518 
591 592 593 594 
13 650 677 
35 36 38 
47 48 505 
50 662 663 
181 192 611 
222 224 225 
388 389 590 
417 418 603 
421 536 640 
427 630 666 
551 552 575 
576 577 578 
607 608 609 
627 628 629 
