17 234 235 236 237 238 239 240 241 242 243 244 245 246 247 262 263 264 265 266 267 268 287 316 416 655 656 
179 180 181 182 183 184 185 186 188 189 190 191 192 193 194 387 388 389 390 391 392 499 500 514 550 590 611 
8 39 43 87 88 89 90 91 92 93 94 95 110 111 114 122 327 378 481 532 586 587 600 601 602 624 
7 41 42 125 127 299 301 302 303 321 328 425 426 427 459 489 503 504 537 625 630 643 648 649 666 
72 73 74 75 76 77 78 79 80 81 82 83 157 158 159 195 228 229 230 383 384 385 622 667 
103 118 119 120 199 201 300 330 338 490 492 522 525 526 535 539 571 610 617 621 644 
23 24 25 26 27 37 69 128 249 282 284 286 334 369 370 415 554 573 574 
131 133 134 135 136 137 139 142 143 145 148 150 274 371 372 373 458 513 
66 68 123 124 358 359 360 361 366 367 375 376 386 483 564 565 657 
132 138 140 146 147 149 313 314 482 519 549 612 613 618 619 671 
104 202 221 222 223 224 225 226 227 340 576 641 642 647 659 
30 86 141 397 398 399 400 408 409 410 421 536 567 620 
53 54 56 58 59 61 62 152 153 154 155 156 380 672 
108 163 164 165 166 167 168 170 171 205 207 311 466 467 
10 419 506 527 528 529 530 531 533 534 579 580 675 
40 63 200 283 379 401 402 403 411 493 545 570 572 
55 113 320 404 405 406 420 491 512 544 555 640 660 
213 214 215 216 217 218 219 412 588 589 670 
175 231 232 233 377 407 597 676 
49 99 322 323 324 325 326 
67 250 251 253 254 445 566 
106 107 109 169 206 315 353 
220 470 471 523 524 631 632 
269 270 271 335 336 337 364 
288 331 332 333 356 357 553 
295 296 297 298 318 319 339 
431 432 448 449 450 451 452 
172 173 174 176 177 178 
291 292 444 496 497 540 
0 11 248 362 363 
5 6 9 12 14 
15 28 29 350 616 
34 44 96 100 560 
208 209 210 211 212 
252 636 637 645 678 
257 258 259 260 261 
272 273 428 429 430 
345 346 347 348 349 
472 473 480 543 559 
1 2 3 4 
16 18 487 488 
31 32 33 365 
97 101 102 105 
98 187 538 635 
115 116 117 121 
203 204 464 465 
280 281 285 329 
317 484 485 486 
515 516 517 518 
13 650 677 
35 36 38 
47 48 505 
50 662 663 
57 462 463 
275 276 277 
351 352 651 
417 418 603 
455 456 457 
551 552 575 
607 608 609 
627 628 629 
652 653 654 
