41 133 199 300 301 302 303 330 490 491 492 503 504 522 525 526 535 544 571 610 621 644 648 649 
66 68 123 124 172 173 174 175 176 177 178 358 359 360 361 366 367 375 377 483 564 565 
179 180 181 182 183 184 185 186 188 189 190 191 192 193 194 388 389 391 500 550 590 611 
7 42 81 88 299 321 327 328 426 472 487 488 489 537 587 625 643 
72 73 74 75 76 83 157 158 159 228 229 230 384 385 667 
221 222 223 224 225 226 227 461 499 514 576 577 578 647 668 
11 29 237 248 347 362 363 410 473 480 543 559 655 656 
53 54 56 58 59 61 62 152 153 154 155 156 380 672 
27 37 69 103 128 249 369 370 554 573 574 601 602 
44 96 97 98 100 102 105 187 387 390 392 538 635 
234 236 238 240 241 242 244 245 246 265 266 268 
34 272 273 351 428 429 430 560 581 582 651 
67 254 291 292 444 445 496 497 540 566 636 
132 138 140 146 147 149 150 313 482 519 
0 239 251 262 263 264 267 415 416 
13 527 528 529 530 531 533 534 675 
40 63 386 401 402 403 493 545 570 
70 71 308 309 310 438 439 440 658 
115 116 117 118 119 120 121 338 539 
94 95 201 202 425 617 641 642 
106 108 109 171 205 206 207 311 
107 166 167 168 169 170 466 467 
134 135 136 137 142 143 145 274 
49 99 322 323 324 325 326 
269 270 271 335 336 337 364 
295 296 297 298 318 319 339 
5 6 9 10 12 14 
31 32 33 165 284 365 
55 406 420 512 640 660 
148 404 405 407 471 597 
213 215 217 218 220 412 
331 332 333 356 357 553 
371 372 373 374 458 513 
397 398 399 408 409 620 
417 418 419 579 580 603 
549 612 613 618 619 671 
28 30 141 400 567 
43 90 353 532 600 
87 195 378 379 383 
104 637 645 659 678 
110 112 113 320 555 
275 276 277 278 606 
280 281 282 286 329 
340 341 342 344 646 
470 523 524 631 632 
1 2 3 4 
8 86 122 586 
15 200 283 411 
16 17 18 243 
23 24 25 26 
78 247 421 536 
89 111 114 624 
91 92 93 481 
203 204 464 465 
208 209 210 211 
216 588 589 670 
231 232 233 676 
235 287 288 316 
260 315 486 572 
345 346 348 349 
427 459 630 666 
448 450 451 452 
515 516 517 518 
591 592 593 594 
38 39 214 
47 48 505 
50 662 663 
57 462 463 
79 376 657 
82 352 622 
126 129 130 
250 252 253 
257 258 261 
279 598 599 
317 484 485 
431 432 449 
455 456 457 
551 552 575 
607 608 609 
627 628 629 
652 653 654 
