7 10 12 13 32 42 43 88 89 90 91 92 110 111 112 114 321 327 328 472 487 488 527 528 529 530 532 533 534 537 587 624 625 675 
72 73 74 75 76 77 78 79 80 81 82 83 157 158 159 195 228 229 230 376 379 383 384 385 622 657 667 
106 107 108 109 163 164 165 166 167 168 169 170 171 205 206 207 311 315 353 377 404 405 407 466 467 597 
179 180 181 182 183 184 185 186 188 189 190 191 192 193 194 387 388 389 390 391 392 500 538 550 590 611 
31 37 69 172 173 174 175 176 177 178 203 204 249 272 273 351 415 428 429 430 560 574 581 582 651 
29 248 345 346 347 348 349 360 400 410 425 427 459 473 480 543 559 567 630 652 653 654 666 677 
39 40 44 87 93 95 365 378 481 493 494 495 525 526 535 545 570 600 601 602 
66 67 68 254 291 292 397 398 399 408 409 444 445 483 496 540 566 620 636 
234 235 236 238 240 241 242 243 244 245 247 262 264 265 266 267 268 287 
53 54 55 56 58 59 60 61 62 63 152 153 154 155 156 380 672 
221 222 223 224 225 227 340 341 343 499 514 576 577 578 646 647 668 
0 103 199 201 239 263 300 330 362 363 416 610 617 621 644 
131 132 138 140 141 144 146 147 150 313 314 519 618 619 671 
49 97 98 99 101 102 104 105 322 323 324 325 326 
23 24 25 26 27 334 366 386 401 402 403 
115 116 117 118 119 120 121 122 338 539 571 
149 448 449 450 451 452 453 454 549 612 613 
33 134 135 136 137 142 143 148 274 482 
70 71 308 309 310 438 439 440 626 658 
5 6 8 9 11 14 15 506 586 
19 20 21 22 151 368 441 479 661 
280 281 282 283 284 285 286 329 498 
295 296 297 298 318 319 320 339 555 
34 113 352 406 426 616 640 660 
219 220 470 471 523 524 631 632 
41 246 375 421 503 504 536 
127 301 302 303 316 648 649 
269 270 271 335 336 337 364 
123 124 258 546 564 565 
126 139 371 372 373 374 
369 370 458 512 513 554 
28 30 86 431 432 
208 209 210 211 212 
231 232 233 489 676 
275 276 277 278 606 
289 290 561 638 639 
344 591 592 593 594 
468 469 547 548 558 
474 475 476 520 521 
1 2 3 4 
38 213 214 217 
94 202 641 642 
215 216 218 412 
237 299 655 656 
250 251 252 253 
288 331 332 333 
317 484 485 486 
358 359 361 367 
381 382 501 502 
393 394 395 460 
419 531 579 580 
490 491 492 522 
497 588 589 670 
515 516 517 518 
637 645 659 678 
45 46 437 
47 48 505 
50 662 663 
57 462 463 
160 161 162 
196 197 198 
200 350 411 
226 342 461 
255 256 396 
257 259 261 
279 598 599 
306 307 312 
356 357 553 
417 418 603 
422 423 424 
455 456 457 
507 508 509 
510 511 669 
551 552 575 
568 569 623 
583 584 585 
607 608 609 
627 628 629 
