7 12 18 40 42 43 63 81 88 89 90 91 92 93 110 111 112 114 231 233 321 327 328 353 365 481 487 488 489 493 498 537 545 570 587 600 624 625 643 
34 41 173 175 300 301 302 303 330 351 362 363 375 490 491 492 503 504 522 525 526 535 571 581 582 610 621 644 648 649 651 
11 29 237 248 358 359 360 361 366 367 400 410 431 432 473 480 543 559 567 652 653 654 655 656 677 
98 102 179 180 181 182 183 185 186 187 188 189 190 191 192 193 194 388 391 500 550 611 635 
5 6 8 9 14 32 86 115 116 117 118 119 120 121 122 165 167 284 338 539 586 
27 37 69 123 128 172 174 176 177 178 249 369 370 494 554 564 565 573 574 601 602 
33 60 131 133 134 135 136 137 139 142 143 144 148 150 274 471 
53 54 55 56 58 59 61 62 152 153 154 155 156 518 672 
132 138 140 141 145 146 147 149 313 451 482 519 613 618 
213 215 216 217 218 219 220 334 412 470 523 524 631 632 
0 235 239 262 263 264 267 287 288 316 317 415 416 
44 96 97 100 105 387 389 390 392 495 560 590 
234 236 238 240 241 242 244 245 246 265 266 268 
10 13 527 528 529 530 531 532 533 534 675 
66 68 291 292 397 398 399 408 483 620 
70 71 308 309 310 438 439 440 626 658 
15 212 280 281 282 283 286 329 506 
295 296 297 298 318 319 320 339 555 
406 426 427 459 616 630 640 660 666 
448 450 452 453 454 549 612 619 671 
23 24 25 26 386 401 402 403 
73 76 157 159 228 229 384 667 
80 106 109 163 169 205 206 311 
94 95 201 202 425 617 641 642 
103 104 221 499 514 637 647 659 
222 224 340 341 342 343 344 646 
417 418 419 420 544 579 580 603 
49 99 322 323 324 325 326 
269 270 271 335 336 337 364 
444 496 497 540 588 589 670 
107 108 166 171 466 467 
168 170 404 405 407 597 
67 250 252 253 445 
101 285 627 628 629 
251 254 409 566 636 
272 273 428 429 430 
275 276 277 278 606 
345 346 347 348 349 
1 2 3 4 
31 35 36 38 
57 380 462 463 
75 158 379 383 
77 230 259 385 
78 247 421 536 
125 127 129 130 
199 200 350 411 
203 204 464 465 
207 260 315 572 
208 209 210 211 
227 576 577 578 
591 592 593 594 
16 17 243 
28 30 472 
39 214 299 
47 48 505 
50 662 663 
72 74 83 
79 376 657 
82 352 622 
87 113 378 
124 258 546 
184 538 650 
223 226 461 
232 377 676 
279 598 599 
331 332 333 
356 357 553 
371 372 373 
455 456 457 
458 512 513 
484 485 486 
515 516 517 
551 552 575 
607 608 609 
