27 31 34 35 36 37 38 41 47 48 69 78 79 123 124 128 172 173 174 175 176 177 178 203 204 232 247 249 257 258 261 300 301 302 303 330 351 362 363 369 370 375 376 377 421 455 456 457 458 464 465 490 491 492 494 503 504 505 512 513 522 525 526 535 536 546 551 552 554 564 565 571 573 574 575 581 582 601 602 610 621 644 648 649 651 657 676 
33 60 80 106 107 108 109 131 132 133 134 135 136 137 138 139 140 141 142 143 144 145 146 147 148 149 150 163 164 166 168 170 171 205 206 207 213 215 216 217 218 219 220 274 304 305 311 313 314 334 404 405 407 412 442 443 448 450 451 452 453 454 466 467 470 471 482 519 523 524 549 597 612 613 618 619 631 632 671 
44 49 50 96 97 98 99 100 102 105 179 180 181 182 183 184 185 186 187 188 189 190 191 192 193 194 269 270 271 322 323 324 325 326 335 336 337 364 387 388 389 390 391 392 500 538 550 560 590 611 635 650 662 663 
7 12 18 23 24 25 26 40 42 43 63 81 88 89 90 91 92 110 111 112 114 169 231 233 260 315 321 327 328 353 365 386 401 402 403 487 488 489 493 495 498 537 545 570 572 587 600 607 608 609 624 625 643 
0 1 2 3 4 16 17 125 126 127 129 130 234 235 236 238 239 240 241 242 243 244 245 246 262 263 264 265 266 267 268 287 288 316 317 331 332 333 356 357 371 372 373 374 415 416 553 
5 6 8 9 10 13 14 32 86 115 116 117 118 119 120 121 122 165 167 284 338 527 528 529 530 531 532 533 534 539 586 675 
82 93 94 95 201 202 352 406 417 418 419 420 425 426 427 459 481 541 542 544 579 580 603 616 617 622 630 640 641 642 660 666 
66 67 68 250 251 252 253 254 291 292 397 398 399 408 409 444 445 483 496 497 540 566 588 589 620 636 670 
11 29 237 248 358 359 360 361 366 367 400 410 431 432 473 480 543 559 567 652 653 654 655 656 677 
72 73 74 75 76 77 83 87 113 157 158 159 195 228 229 230 259 378 379 383 384 385 449 667 
53 54 55 56 57 58 59 61 62 152 153 154 155 156 380 462 463 515 516 517 518 672 
70 71 222 224 225 308 309 310 340 341 342 343 344 438 439 440 626 646 658 668 
15 199 200 208 209 210 211 212 280 281 282 283 286 329 350 411 506 633 634 
51 52 223 226 227 461 576 577 578 591 592 593 594 
295 296 297 298 318 319 320 339 555 
103 104 221 499 514 637 647 659 
275 276 277 278 279 598 599 606 
272 273 293 294 428 429 430 
39 84 85 214 299 
101 285 627 628 629 
345 346 347 348 349 
28 30 472 
484 485 486 
