7 8 12 32 39 40 42 43 44 81 86 87 88 89 90 106 107 108 109 111 114 165 166 167 169 171 195 205 206 207 311 321 327 328 353 365 378 379 383 385 466 472 487 488 494 495 498 532 537 570 586 587 600 601 602 624 625 
31 34 37 69 82 103 157 172 173 174 175 176 177 178 249 272 273 351 352 415 426 428 429 430 462 560 574 581 582 622 651 
28 29 30 248 345 346 347 348 349 360 400 410 431 432 473 480 543 559 567 652 653 654 677 
53 54 55 56 57 58 59 60 61 62 63 152 153 154 155 156 380 463 518 672 
41 133 199 201 246 300 330 362 363 375 490 492 503 504 522 610 617 621 644 
66 67 68 254 291 292 397 398 399 408 409 444 445 483 496 540 566 620 636 
131 132 138 140 141 144 145 146 147 149 150 313 451 482 519 613 618 
179 180 181 185 189 191 192 194 387 388 389 390 391 392 550 590 611 
5 6 9 10 11 13 14 15 506 527 528 529 530 533 534 675 
33 134 135 136 137 142 143 148 274 470 471 523 524 631 632 
234 236 238 240 241 242 243 244 245 247 265 266 268 
96 97 98 99 101 102 104 105 627 628 629 
100 200 280 281 282 283 284 285 286 329 411 
115 116 117 118 119 120 121 122 338 539 571 
0 235 239 262 263 264 267 287 288 416 
70 71 308 309 310 438 439 440 626 658 
221 222 223 224 225 226 227 461 647 668 
448 449 450 452 453 454 549 612 619 671 
19 20 21 22 151 368 441 479 661 
38 213 214 215 216 217 218 220 412 
91 92 93 94 95 202 481 641 642 
75 76 78 83 350 421 536 616 
127 301 302 303 316 317 648 649 
417 418 419 420 531 579 580 603 
23 24 25 26 27 219 334 
72 80 159 163 230 384 667 
123 124 258 261 546 564 565 
168 170 377 404 405 407 597 
182 183 186 190 193 500 514 
269 270 271 335 336 337 364 
295 296 297 298 318 319 339 
49 322 323 324 325 326 
340 341 342 343 344 646 
369 370 458 512 513 554 
51 52 576 577 578 
73 74 79 376 657 
110 113 257 320 555 
125 126 128 129 130 
139 371 372 373 374 
208 209 210 211 212 
231 232 233 489 676 
260 315 484 486 572 
275 276 277 278 606 
289 290 561 638 639 
366 386 401 402 403 
425 427 459 630 666 
468 469 547 548 558 
474 475 476 520 521 
493 525 526 535 545 
1 2 3 4 
184 187 538 650 
203 204 464 465 
237 299 655 656 
250 251 252 253 
331 332 333 356 
358 359 361 367 
381 382 501 502 
393 394 395 460 
497 588 589 670 
591 592 593 594 
637 645 659 678 
45 46 437 
47 48 505 
50 662 663 
77 158 259 
160 161 162 
196 197 198 
255 256 396 
306 307 312 
406 640 660 
422 423 424 
455 456 457 
507 508 509 
510 511 669 
515 516 517 
551 552 575 
568 569 623 
583 584 585 
607 608 609 
