8 32 39 72 73 74 75 76 77 78 79 80 81 82 83 84 85 87 88 89 90 91 92 93 94 95 106 107 108 109 110 111 112 113 122 124 157 158 159 163 164 165 166 167 168 169 170 171 195 205 206 207 213 214 215 216 217 218 219 220 228 229 230 257 258 259 260 261 275 276 277 278 279 311 314 315 320 327 338 353 378 383 384 385 412 448 449 450 452 453 454 466 467 481 498 546 586 587 588 589 598 599 600 606 612 619 622 624 667 670 671 
7 12 14 23 24 25 26 27 37 41 42 43 69 100 114 125 128 203 204 248 249 272 273 280 281 282 284 285 286 293 294 301 302 303 321 328 329 334 365 369 370 406 415 417 418 419 420 425 426 427 428 429 430 431 432 458 459 462 464 465 489 503 504 512 513 527 528 529 530 531 532 534 537 544 554 573 574 579 580 603 625 630 633 634 643 648 649 652 653 654 660 666 675 
13 49 50 51 52 96 97 98 99 101 102 104 105 179 180 181 182 183 184 185 186 187 188 189 190 191 192 193 194 221 222 223 224 225 226 227 269 270 271 322 323 324 325 326 335 336 337 340 342 343 344 364 388 389 391 461 499 500 514 538 550 576 577 578 590 591 592 593 594 611 626 635 647 650 659 662 663 668 677 
5 6 9 10 11 15 16 18 28 29 30 66 67 68 86 132 138 140 141 145 146 147 149 212 250 253 254 291 292 304 305 313 345 346 347 348 349 358 359 360 361 366 367 386 397 398 399 400 408 409 410 444 445 451 472 473 480 482 483 487 488 496 497 506 519 533 540 543 549 559 566 567 613 618 620 
33 103 115 116 117 118 119 120 121 131 133 134 135 136 137 139 142 143 144 148 150 199 200 201 202 274 283 299 300 330 404 405 411 442 443 470 471 490 491 492 493 522 523 524 525 526 535 539 545 571 581 582 610 617 621 632 641 642 644 
17 34 123 127 172 173 174 175 176 177 178 231 232 233 234 235 236 237 238 239 240 241 242 243 244 245 246 247 251 262 263 264 265 266 267 268 287 288 316 317 375 376 377 407 416 551 552 560 564 565 575 597 655 656 657 676 
31 35 36 38 40 44 53 54 55 56 57 58 59 60 61 62 63 152 153 154 156 379 387 390 392 401 402 403 486 494 495 518 570 572 601 602 607 608 609 
350 351 352 421 536 541 542 616 640 651 
126 371 372 373 374 455 456 457 
0 1 2 3 4 362 363 
295 296 297 298 318 319 
252 636 637 645 678 
331 332 333 356 
47 48 505 
627 628 629 
