8 32 39 86 87 88 89 90 91 92 93 94 95 110 111 122 213 214 217 327 353 378 448 450 452 454 481 498 586 587 600 612 619 624 671 
0 7 12 41 42 43 114 248 299 301 302 303 321 328 362 363 365 425 426 431 432 462 489 503 504 537 625 643 648 649 652 653 654 
30 132 138 140 141 145 146 147 149 313 345 346 347 349 397 398 399 400 408 409 410 451 482 519 549 567 613 618 620 
72 73 74 75 76 77 78 79 80 81 82 83 157 158 159 163 228 229 230 259 383 384 385 622 667 
49 96 97 98 99 101 102 103 104 105 187 221 223 322 323 324 325 326 499 514 538 635 647 659 
34 123 172 173 174 175 176 177 178 272 273 375 376 377 407 428 429 430 560 564 565 597 657 
5 6 9 10 11 15 28 29 66 68 212 358 359 360 361 366 367 386 483 506 533 
179 180 181 182 183 185 186 188 189 190 191 192 193 194 388 389 391 500 550 590 611 
23 27 37 69 100 125 128 203 204 249 282 284 286 369 370 415 554 573 574 
53 54 55 56 57 58 59 60 61 62 63 152 153 154 155 156 380 463 672 
234 236 237 238 240 241 242 244 245 246 247 262 264 265 266 267 268 655 656 
118 119 120 300 330 338 490 491 492 522 539 544 571 581 582 610 621 644 
33 131 133 134 135 136 137 139 142 143 144 148 150 274 404 405 
40 44 379 387 390 392 401 402 403 486 494 495 570 572 
67 250 253 254 291 292 444 445 496 497 540 566 
108 165 166 167 168 169 170 171 311 466 467 
16 18 348 472 473 480 487 488 543 559 
106 107 109 164 205 206 207 314 315 
215 216 218 219 220 412 588 589 670 
14 527 528 529 530 532 534 675 
222 224 225 227 340 343 626 668 
113 257 258 260 261 320 555 
269 270 271 335 336 337 364 
295 296 297 298 318 319 339 
31 35 36 38 601 602 
127 235 287 288 316 317 
199 201 202 617 641 642 
344 461 591 592 593 594 
406 420 458 512 513 660 
470 471 523 524 631 632 
252 636 637 645 678 
275 276 277 278 606 
350 351 352 616 651 
493 525 526 535 545 
1 2 3 4 
13 184 650 677 
24 25 26 334 
112 200 283 411 
115 116 117 121 
231 232 233 676 
239 251 263 416 
280 281 285 329 
419 531 579 580 
427 459 630 666 
515 516 517 518 
47 48 505 
50 662 663 
124 453 546 
279 598 599 
371 372 373 
417 418 603 
421 536 640 
455 456 457 
551 552 575 
576 577 578 
607 608 609 
627 628 629 
