5 7 8 9 12 14 15 32 39 42 43 81 86 87 88 89 90 91 92 93 94 95 106 108 109 111 114 165 166 171 195 202 205 206 207 311 321 327 328 353 365 378 467 472 481 487 488 537 586 587 624 625 641 642 
34 41 82 133 157 199 200 201 246 300 330 350 351 352 362 363 375 385 411 426 462 493 503 504 525 526 535 545 581 582 610 617 621 622 644 651 
6 11 28 29 30 248 345 346 347 348 349 360 400 410 425 427 431 432 459 473 480 543 559 567 630 652 653 654 666 677 
53 54 55 56 57 58 59 60 61 62 63 152 153 154 155 156 380 463 518 672 
75 76 78 83 234 236 238 240 241 242 243 244 245 247 265 266 268 421 536 616 
66 67 68 254 291 292 397 398 399 408 409 444 445 483 496 540 566 620 636 
131 132 138 140 141 144 145 146 147 149 150 164 313 314 451 482 519 613 618 
179 180 181 185 187 189 192 194 387 388 389 390 391 392 590 611 
31 37 69 103 172 173 174 176 177 178 249 415 574 
23 24 25 26 27 219 334 366 386 401 402 403 
10 13 506 527 528 529 530 532 533 534 675 
107 167 168 169 170 377 404 405 407 466 597 
33 134 135 136 137 142 143 148 274 471 
70 71 308 309 310 438 439 440 626 658 
96 97 98 101 102 104 105 627 628 629 
100 280 281 282 283 284 285 286 329 498 
221 222 223 224 225 226 227 461 647 668 
448 449 450 452 453 454 549 612 619 671 
0 235 239 262 263 264 267 287 416 
19 20 21 22 151 368 441 479 661 
38 213 214 215 216 217 218 220 412 
77 257 259 260 261 315 484 486 572 
182 183 186 190 191 193 500 514 550 
40 44 494 495 570 600 601 602 
127 301 302 303 316 317 648 649 
417 418 419 420 531 579 580 603 
49 99 322 323 324 325 326 
72 80 159 163 230 384 667 
115 116 117 118 121 122 338 
269 270 271 335 336 337 364 
288 331 332 333 356 357 553 
295 296 297 298 318 319 339 
73 74 79 158 376 657 
110 112 113 279 320 555 
123 124 258 546 564 565 
340 341 342 343 344 646 
369 370 458 512 513 554 
51 52 576 577 578 
125 126 128 129 130 
139 371 372 373 374 
208 209 210 211 212 
231 232 233 489 676 
272 273 428 429 430 
275 276 277 278 606 
289 290 561 638 639 
468 469 547 548 558 
470 523 524 631 632 
474 475 476 520 521 
490 491 492 522 544 
1 2 3 4 
119 120 539 571 
203 204 464 465 
237 299 655 656 
250 251 252 253 
358 359 361 367 
381 382 501 502 
393 394 395 460 
497 588 589 670 
591 592 593 594 
637 645 659 678 
45 46 437 
47 48 505 
50 662 663 
160 161 162 
184 538 650 
196 197 198 
255 256 396 
306 307 312 
406 640 660 
422 423 424 
455 456 457 
507 508 509 
510 511 669 
515 516 517 
551 552 575 
568 569 623 
583 584 585 
607 608 609 
