27 37 69 103 104 128 133 172 173 174 175 176 177 178 249 272 273 300 330 369 370 375 428 429 430 490 492 513 522 525 526 535 554 571 573 574 610 621 644 
33 60 131 132 134 135 136 137 138 139 140 142 143 144 145 146 147 149 150 274 313 482 519 549 612 613 618 619 671 
7 18 42 43 81 88 90 91 92 93 231 233 321 327 328 353 365 481 487 488 489 532 537 587 625 643 
41 301 302 303 406 417 418 419 420 426 459 462 491 503 504 512 544 579 580 603 616 640 648 649 660 
180 181 182 183 184 185 186 188 189 190 191 192 194 387 388 389 390 391 392 499 538 650 
53 54 55 56 57 58 59 61 62 152 153 154 155 156 380 463 518 672 
8 31 32 86 115 116 117 118 119 120 121 122 165 284 338 539 586 
11 29 237 248 362 363 400 410 480 567 655 656 677 
72 73 74 75 76 83 157 159 228 229 230 384 667 
10 13 212 506 527 528 529 530 531 533 534 675 
234 236 238 240 241 242 244 245 246 265 266 268 
66 68 291 292 397 398 399 408 483 620 
70 71 308 309 310 438 439 440 626 658 
80 148 163 168 170 404 405 407 471 597 
193 221 223 224 225 500 514 647 668 
0 239 262 263 264 267 415 416 
15 280 281 282 283 285 286 329 
23 24 25 26 386 401 402 403 
94 95 201 202 425 617 641 642 
106 107 108 166 167 169 466 467 
123 124 494 564 565 600 601 602 
213 215 216 217 218 219 334 412 
227 576 577 578 591 592 593 594 
40 63 454 493 498 545 570 
49 99 322 323 324 325 326 
77 257 258 259 260 261 385 
222 340 341 342 343 344 646 
235 287 288 316 331 332 333 
269 270 271 335 336 337 364 
295 296 297 298 318 319 339 
444 496 497 540 588 589 670 
28 30 472 473 543 559 
89 110 111 112 114 624 
109 171 205 206 207 311 
220 470 523 524 631 632 
358 359 360 361 366 367 
5 6 9 12 14 
34 351 581 582 651 
67 250 252 253 445 
78 141 247 421 536 
125 126 127 129 130 
251 254 409 566 636 
275 276 277 278 606 
345 346 347 348 349 
371 372 373 374 458 
1 2 3 4 
87 113 195 378 
98 179 187 635 
101 627 628 629 
199 200 350 411 
203 204 464 465 
208 209 210 211 
448 450 451 452 
637 645 659 678 
16 17 243 
35 36 38 
39 214 299 
44 96 495 
47 48 505 
50 662 663 
79 376 657 
82 352 622 
97 102 105 
158 379 383 
232 377 676 
279 598 599 
315 486 572 
317 484 485 
356 357 553 
427 630 666 
431 432 449 
455 456 457 
515 516 517 
551 552 575 
607 608 609 
652 653 654 
