28 29 30 248 345 346 347 348 349 360 400 410 425 427 431 432 459 473 480 543 559 567 630 652 653 654 666 677 
179 180 181 182 183 184 185 186 187 188 189 190 191 192 194 387 388 389 390 391 392 499 538 550 590 611 650 
7 12 39 42 43 81 88 89 90 91 92 106 111 114 321 328 353 365 472 487 488 537 587 624 625 
41 133 199 201 246 300 330 362 363 375 462 490 492 503 504 522 610 617 621 644 
75 78 83 234 236 238 240 241 242 243 244 245 247 265 266 268 350 421 536 616 
66 67 68 254 291 292 397 398 399 408 409 444 445 483 496 540 566 620 636 
131 132 138 140 141 144 145 146 147 149 150 164 313 314 451 482 519 613 618 
37 69 103 172 173 174 176 177 178 249 272 273 415 426 428 429 430 574 
32 107 108 109 165 166 167 169 171 205 206 207 311 327 466 467 
33 134 135 136 137 142 143 148 274 470 471 523 524 631 632 
53 54 56 59 60 61 62 152 153 155 156 518 672 
193 221 222 223 224 225 226 227 461 500 514 647 668 
100 200 280 281 282 283 284 285 286 329 411 498 
115 116 117 118 119 120 121 122 338 539 571 
5 6 8 9 10 11 15 86 533 586 
13 14 506 527 528 529 530 532 534 675 
70 71 308 309 310 438 439 440 626 658 
87 93 94 95 195 202 378 481 641 642 
96 97 98 101 102 104 105 627 628 629 
448 449 450 452 453 454 549 612 619 671 
0 235 239 262 263 264 267 287 416 
19 20 21 22 151 368 441 479 661 
38 213 214 215 216 217 218 220 412 
31 34 175 351 560 581 582 651 
40 44 494 495 570 600 601 602 
123 124 257 258 261 546 564 565 
127 301 302 303 316 317 648 649 
417 418 419 420 531 579 580 603 
23 24 366 386 401 402 403 
49 99 322 323 324 325 326 
55 57 58 63 154 380 463 
72 80 159 163 230 384 667 
73 76 82 157 158 352 385 
168 170 377 404 405 407 597 
269 270 271 335 336 337 364 
288 331 332 333 356 357 553 
295 296 297 298 318 319 339 
110 112 113 279 320 555 
340 341 342 343 344 646 
369 370 458 512 513 554 
25 26 27 219 334 
125 126 128 129 130 
139 371 372 373 374 
208 209 210 211 212 
231 232 233 489 676 
260 315 484 486 572 
275 276 277 278 606 
289 290 561 638 639 
468 469 547 548 558 
474 475 476 520 521 
493 525 526 535 545 
1 2 3 4 
16 17 18 573 
74 79 376 657 
203 204 464 465 
237 299 655 656 
250 251 252 253 
358 359 361 367 
381 382 501 502 
393 394 395 460 
497 588 589 670 
591 592 593 594 
637 645 659 678 
45 46 437 
47 48 505 
50 662 663 
160 161 162 
196 197 198 
255 256 396 
306 307 312 
406 640 660 
422 423 424 
455 456 457 
507 508 509 
510 511 669 
515 516 517 
551 552 575 
568 569 623 
576 577 578 
583 584 585 
607 608 609 
