16 18 32 106 107 108 109 163 164 165 166 167 168 169 170 171 205 206 207 311 315 327 448 449 450 452 453 454 466 467 487 488 498 549 612 619 671 
0 7 12 41 42 248 299 301 302 303 321 328 362 363 425 426 427 431 432 459 462 472 489 503 504 537 625 630 643 648 649 652 653 654 666 
40 44 53 54 56 57 58 59 60 61 62 63 152 153 154 155 156 379 380 387 390 392 401 402 403 463 486 494 495 570 572 672 
30 132 138 140 141 145 146 147 149 313 314 345 346 347 349 397 398 399 400 408 409 410 451 482 519 567 613 618 620 
17 234 236 237 238 239 240 241 242 243 244 245 246 247 251 262 263 264 265 266 267 268 416 655 656 
72 73 74 75 76 77 78 79 80 81 82 83 157 158 159 195 228 229 230 383 384 385 622 667 
97 99 101 102 104 105 199 201 202 221 222 224 226 227 340 576 577 578 617 641 642 647 659 
8 39 43 86 87 88 90 91 92 93 94 95 122 353 378 481 586 587 600 
34 123 172 173 174 175 176 177 178 272 273 375 376 428 429 430 564 565 657 
23 27 37 69 125 128 203 204 249 282 284 286 369 370 415 554 573 574 
33 131 133 134 135 136 137 139 142 143 144 148 150 274 365 371 372 373 
119 120 300 330 490 491 492 522 539 544 571 581 582 610 621 644 
179 180 181 184 185 189 192 194 388 389 391 590 611 
14 419 527 528 529 530 531 532 534 579 580 675 
67 250 253 254 291 292 444 445 496 497 540 566 
15 28 29 212 350 351 352 506 533 616 651 
66 68 358 359 360 361 366 367 386 483 
182 183 186 190 191 193 500 514 550 
55 404 405 406 420 512 660 
113 257 258 259 260 261 320 
213 214 215 217 218 219 220 
231 232 233 377 407 597 676 
269 270 271 335 336 337 364 
295 296 297 298 318 319 339 
49 322 323 324 325 326 
115 116 117 118 121 338 
127 235 287 288 316 317 
223 461 591 592 593 594 
5 6 9 10 11 
89 110 111 114 624 
216 412 588 589 670 
252 636 637 645 678 
275 276 277 278 606 
348 473 480 543 559 
470 471 523 524 632 
493 525 526 535 545 
1 2 3 4 
24 25 26 334 
98 187 538 635 
208 209 210 211 
280 281 285 329 
341 343 626 646 
515 516 517 518 
13 650 677 
31 601 602 
35 36 38 
47 48 505 
50 662 663 
200 283 411 
417 418 603 
421 536 640 
551 552 575 
607 608 609 
627 628 629 
