27 37 41 47 48 66 68 69 103 123 124 128 133 172 173 174 175 176 177 178 199 249 300 301 302 303 330 358 359 360 361 366 367 369 370 375 377 483 490 491 492 503 504 505 522 525 526 535 544 551 552 554 564 565 571 573 574 575 601 602 610 621 644 648 649 
44 49 50 96 97 98 99 100 102 105 179 180 181 182 183 184 185 186 187 188 189 190 191 192 193 194 269 270 271 322 323 324 325 326 335 336 337 364 387 388 389 390 391 392 494 495 500 538 550 590 611 635 662 663 
43 51 52 90 91 92 93 94 95 104 201 202 221 222 223 224 225 226 227 353 425 427 459 461 481 499 514 532 576 577 578 591 592 593 594 600 617 630 637 641 642 645 647 659 666 668 678 
60 131 132 134 135 136 137 138 139 140 142 143 144 145 146 147 149 150 164 274 304 305 313 314 371 372 373 374 442 443 455 456 457 458 482 513 519 549 612 613 618 619 671 
72 73 74 75 76 79 80 82 83 106 107 108 109 157 158 159 163 166 167 168 169 170 171 205 206 207 228 229 230 311 352 376 384 385 466 467 622 657 667 
0 1 2 3 4 234 235 236 238 239 240 241 242 244 245 246 250 251 252 253 262 263 264 265 266 267 268 287 288 316 331 332 333 356 357 415 416 553 
8 31 32 33 34 35 36 86 115 116 117 118 119 120 121 122 165 272 273 284 293 294 338 351 365 428 429 430 539 560 581 582 586 651 
11 28 29 30 78 141 237 247 248 345 346 347 348 349 362 363 400 410 421 473 480 536 543 559 567 650 655 656 677 
7 38 39 42 81 84 85 88 214 231 232 233 299 321 327 328 426 472 487 488 489 537 587 625 643 676 
15 40 63 200 280 281 282 283 286 329 386 401 402 403 411 454 493 498 545 570 633 634 
5 6 9 10 12 13 14 208 209 210 211 212 506 527 528 529 530 531 533 534 675 
53 54 56 57 58 59 61 62 152 153 154 155 156 380 462 463 515 516 517 518 672 
67 216 254 291 292 397 398 399 408 409 444 445 496 497 540 566 588 589 620 636 670 
77 89 110 111 112 113 114 257 258 259 261 295 296 297 298 318 319 320 339 555 624 
55 148 404 405 406 407 417 418 419 420 471 512 541 542 579 580 597 603 640 660 
23 24 25 26 213 215 217 218 219 220 334 412 470 523 524 631 632 
87 195 378 379 383 431 432 448 449 450 451 452 453 546 652 653 654 
70 71 308 309 310 340 341 342 343 344 438 439 440 626 646 658 
260 315 317 484 485 486 572 607 608 609 
275 276 277 278 279 598 599 606 
101 285 627 628 629 
125 126 127 129 130 
16 17 18 243 
203 204 464 465 
