23 24 25 26 40 44 49 50 63 96 97 98 99 102 105 123 124 179 180 181 182 183 184 185 186 187 188 189 190 191 192 193 194 257 258 260 261 269 270 271 315 322 323 324 325 326 335 336 337 364 386 387 388 389 390 391 392 401 402 403 493 494 495 500 538 545 546 550 551 552 564 565 570 572 575 590 600 601 602 607 608 609 611 635 650 662 663 
27 31 34 35 36 37 38 41 47 48 69 78 79 100 128 172 173 174 175 176 177 178 203 204 232 247 249 272 273 293 294 300 301 302 303 330 351 362 363 369 370 375 376 377 421 428 429 430 455 456 457 458 464 465 503 504 505 512 513 525 526 535 536 554 560 571 573 574 581 582 610 621 644 648 649 651 657 676 
5 6 7 8 9 10 12 13 14 18 32 42 43 81 86 88 89 90 91 92 93 110 111 114 115 116 117 118 119 120 121 122 165 231 233 284 321 327 328 338 353 365 481 487 488 489 498 527 528 529 530 531 532 533 534 537 539 586 587 624 625 643 675 
0 1 2 3 4 16 17 125 126 127 129 130 234 235 236 238 239 240 241 242 243 244 245 246 262 263 264 265 266 267 268 287 288 316 317 331 332 333 356 357 371 372 373 374 415 416 553 
33 131 132 133 134 135 136 137 138 139 140 141 142 143 144 145 146 147 148 149 150 274 304 305 313 442 443 448 450 451 452 453 454 471 482 519 549 612 613 618 619 671 
53 54 55 56 57 58 59 60 61 62 152 153 154 155 156 380 462 463 490 491 492 515 516 517 518 522 672 
66 67 68 250 251 252 253 254 291 292 397 398 399 408 409 444 445 483 496 497 540 566 588 589 620 636 670 
28 29 30 82 352 406 410 417 418 419 420 426 459 472 480 541 542 544 579 580 603 616 622 640 660 666 
11 237 248 358 359 360 361 366 367 400 427 431 432 473 543 559 567 630 652 653 654 655 656 677 
72 73 74 75 76 77 83 87 113 157 158 159 195 228 229 230 259 378 379 383 384 385 449 667 
80 106 107 108 109 163 164 166 167 168 169 170 171 205 206 207 311 314 404 405 407 466 467 597 
70 71 222 224 225 308 309 310 340 341 342 343 344 438 439 440 626 646 658 668 
15 208 209 210 211 212 280 281 282 283 286 329 506 633 634 
213 215 216 217 218 219 220 334 412 470 523 524 631 632 
51 52 223 226 227 461 576 577 578 591 592 593 594 
295 296 297 298 318 319 320 339 555 
94 95 201 202 425 617 641 642 
103 104 221 499 514 637 647 659 
275 276 277 278 279 598 599 606 
39 84 85 214 299 
101 285 627 628 629 
112 199 200 350 411 
345 346 347 348 349 
484 485 486 
