132 138 140 141 145 146 147 149 164 313 314 345 346 347 349 397 398 399 400 408 409 410 482 519 567 613 618 619 620 671 
34 66 68 123 172 173 174 175 176 177 178 272 273 358 359 360 361 366 367 375 376 386 428 429 430 483 564 565 657 
17 234 235 236 237 238 239 240 241 242 243 244 245 246 247 262 263 264 265 266 267 268 287 288 316 416 655 656 
7 41 42 125 127 248 299 301 302 303 321 328 425 426 459 462 480 489 503 504 537 625 643 648 649 
23 24 25 26 27 37 69 128 203 204 249 280 281 282 284 285 286 329 334 369 370 415 554 573 574 
0 118 119 120 300 330 338 362 363 490 491 492 522 539 544 571 581 582 610 621 644 
97 99 104 199 201 202 221 222 223 224 226 227 340 576 591 617 641 642 647 659 
106 107 108 109 163 165 166 167 168 169 170 171 205 206 207 311 315 353 466 467 
213 214 215 216 217 218 219 220 412 470 471 523 524 588 589 631 632 670 
8 43 87 88 90 91 92 93 94 95 122 378 481 532 586 587 600 
53 54 56 57 58 59 60 61 62 152 153 155 156 380 463 672 
131 133 134 135 136 137 139 142 143 144 148 150 274 371 372 373 
14 212 419 506 527 528 529 530 531 534 579 580 675 
40 63 112 154 200 279 283 379 401 402 403 411 570 
67 250 251 253 254 291 292 444 445 496 497 540 566 
124 431 432 448 449 450 451 452 453 546 652 653 654 
44 317 387 389 390 392 484 485 486 572 590 
179 180 181 184 185 189 192 194 388 391 611 
16 18 348 472 473 487 488 543 559 
72 76 77 78 80 157 228 229 230 
182 183 186 190 191 193 500 514 550 
73 79 83 159 383 384 385 667 
113 257 258 259 260 261 320 555 
55 404 405 406 420 512 660 
74 75 81 82 158 195 622 
231 232 233 377 407 597 676 
269 270 271 335 336 337 364 
295 296 297 298 318 319 339 
5 6 9 10 11 12 
15 28 29 350 533 616 
32 327 454 498 549 612 
39 89 110 111 114 624 
49 322 323 324 325 326 
31 33 365 601 602 
252 636 637 645 678 
275 276 277 278 606 
493 525 526 535 545 
1 2 3 4 
98 187 538 635 
115 116 117 121 
208 209 210 211 
341 343 626 646 
515 516 517 518 
13 650 677 
35 36 38 
47 48 505 
50 662 663 
101 102 105 
351 352 651 
417 418 603 
421 536 640 
427 630 666 
455 456 457 
551 552 575 
607 608 609 
627 628 629 
