40 44 53 54 56 58 59 61 62 63 152 153 154 155 156 179 180 181 182 183 184 185 186 188 189 190 191 192 193 194 200 283 379 380 387 388 389 390 391 392 401 402 403 411 486 493 494 495 499 500 514 515 516 517 518 525 526 535 545 550 570 572 590 607 608 609 611 672 
17 66 68 123 124 172 173 174 175 176 177 178 231 232 233 234 235 236 237 238 239 240 241 242 243 244 245 246 247 262 263 264 265 266 267 268 287 316 358 359 360 361 366 367 375 376 377 386 407 416 483 551 552 564 565 575 597 655 656 657 676 
60 126 129 130 131 132 133 134 135 136 137 138 139 140 142 143 144 145 146 147 148 149 150 274 304 305 313 314 371 372 373 374 442 443 455 456 457 458 482 513 519 549 612 613 618 619 671 
49 50 96 98 99 100 103 115 116 117 118 119 120 121 187 269 270 271 300 322 323 324 325 326 330 335 336 337 338 364 490 492 522 538 539 560 571 581 582 610 621 635 644 662 663 
0 1 2 3 4 7 34 41 42 47 48 57 125 127 248 299 301 302 303 321 327 328 362 363 425 426 427 459 462 463 489 503 504 505 537 625 630 643 648 649 652 653 654 666 
23 24 25 26 27 31 32 33 35 36 37 38 69 128 203 204 249 280 281 282 284 285 286 329 334 365 369 370 415 454 464 465 498 554 573 574 601 602 633 634 
5 6 9 10 11 12 14 15 28 29 208 209 210 211 212 350 351 352 417 418 419 506 527 528 529 530 531 533 534 579 580 603 616 651 675 
8 39 43 84 85 87 88 89 90 91 92 93 94 95 110 111 112 114 122 275 276 277 278 279 378 481 532 586 587 598 599 600 606 624 
16 18 30 86 141 345 346 347 348 349 397 398 399 400 408 409 410 421 472 473 480 487 488 536 541 542 543 559 567 620 640 
55 113 257 258 259 260 261 295 296 297 298 318 319 320 339 404 405 406 420 491 512 544 555 660 
72 73 74 75 76 77 78 79 80 81 82 83 157 158 159 195 228 229 230 383 384 385 622 667 
97 101 102 104 105 199 201 202 221 222 223 224 225 226 227 340 576 617 641 642 647 659 
106 107 108 109 163 164 165 166 167 168 169 170 171 205 206 207 311 315 353 466 467 
213 214 215 216 217 218 219 220 412 470 471 523 524 588 589 631 632 670 
67 250 251 253 254 291 292 444 445 496 497 540 566 
431 432 448 449 450 451 452 453 546 
272 273 293 294 428 429 430 
288 331 332 333 356 357 553 
252 636 637 645 678 
13 650 677 
317 484 485 
627 628 629 
