41 47 48 53 54 55 56 57 58 59 61 62 78 82 94 95 141 152 153 154 155 156 199 200 201 202 247 301 302 303 350 352 380 406 411 417 418 419 420 421 425 426 427 459 462 463 491 503 504 505 512 515 516 517 518 536 541 542 544 579 580 603 616 617 622 630 640 641 642 648 649 660 666 672 
27 37 69 79 103 104 123 124 128 133 172 173 174 175 176 177 178 193 221 223 224 225 232 249 272 273 293 294 300 330 369 370 375 376 377 428 429 430 490 492 494 500 513 514 522 525 526 535 551 552 554 564 565 571 573 574 575 600 601 602 610 621 637 644 645 647 657 659 668 676 678 
44 49 50 96 97 98 99 102 105 179 180 181 182 183 184 185 186 187 188 189 190 191 192 194 269 270 271 322 323 324 325 326 335 336 337 364 387 388 389 390 391 392 495 499 538 635 650 662 663 
7 18 23 24 25 26 40 42 43 63 81 88 89 90 91 92 93 110 111 112 114 231 233 321 327 328 353 365 386 401 402 403 454 481 487 488 489 493 498 532 537 545 570 587 624 625 643 
33 60 131 132 134 135 136 137 138 139 140 142 143 144 145 146 147 149 150 164 274 304 305 313 314 442 443 482 519 549 612 613 618 619 671 
0 1 2 3 4 16 17 234 235 236 238 239 240 241 242 243 244 245 246 262 263 264 265 266 267 268 287 288 316 331 332 333 415 416 
51 52 70 71 222 226 227 308 309 310 340 341 342 343 344 438 439 440 461 576 577 578 591 592 593 594 626 646 658 
8 31 32 34 35 36 38 86 100 115 116 117 118 119 120 121 122 165 284 338 351 539 560 581 582 586 651 
66 67 68 250 251 252 253 254 291 292 397 398 399 408 409 444 445 483 496 497 540 566 588 589 620 636 670 
72 73 74 75 76 77 83 87 113 157 158 159 195 228 229 230 257 258 259 260 261 378 379 383 384 385 667 
80 106 107 108 109 148 163 166 167 168 169 170 171 205 206 207 311 404 405 407 466 467 471 597 
11 29 237 248 358 359 360 361 362 363 366 367 400 410 480 567 652 653 654 655 656 677 
5 6 9 10 12 13 14 208 209 210 211 212 506 527 528 529 530 531 533 534 675 
15 101 280 281 282 283 285 286 329 627 628 629 633 634 
213 215 216 217 218 219 220 334 412 470 523 524 631 632 
295 296 297 298 318 319 320 339 555 
431 432 448 449 450 451 452 453 546 
275 276 277 278 279 598 599 606 
371 372 373 374 455 456 457 458 
28 30 472 473 543 559 
315 486 572 607 608 609 
39 84 85 214 299 
125 126 127 129 130 
345 346 347 348 349 
203 204 464 465 
317 484 485 
356 357 553 
