179 180 181 182 183 184 185 186 187 188 189 190 191 192 193 194 387 388 389 390 391 392 499 500 514 538 550 590 611 650 
234 235 236 237 238 239 240 241 242 243 244 245 246 247 262 263 264 265 266 267 268 287 299 375 416 655 656 
72 73 74 75 76 77 78 79 80 81 82 83 157 158 159 195 228 229 230 379 383 384 385 622 667 
53 54 55 56 57 58 59 60 61 62 63 152 153 154 155 156 380 463 672 
8 32 39 43 87 90 91 92 93 94 95 378 481 532 586 600 601 602 
5 6 7 9 10 11 12 15 42 88 321 327 328 365 537 587 625 
66 67 68 254 291 292 397 398 399 408 409 410 445 483 566 620 636 
107 163 164 165 166 167 168 169 170 311 404 405 466 467 
33 131 133 134 135 136 137 142 143 144 145 148 274 
221 222 223 224 225 226 227 461 576 577 578 647 668 
13 14 506 527 528 529 530 533 534 675 677 
28 29 30 86 248 360 400 431 432 567 616 
115 116 117 118 119 120 121 122 338 539 571 
132 138 140 141 146 147 149 150 313 482 519 
70 71 308 309 310 438 439 440 626 658 
19 20 21 22 151 368 441 479 661 
106 108 109 171 205 206 207 315 353 
199 200 201 202 350 411 617 641 642 
213 214 215 216 217 218 219 220 412 
269 270 271 335 336 337 364 635 643 
280 281 282 283 284 285 286 329 498 
295 296 297 298 318 319 320 339 555 
34 425 426 427 459 462 630 666 
40 44 493 494 495 545 570 572 
49 98 99 322 323 324 325 326 
417 418 419 420 531 579 580 603 
96 97 101 102 103 104 105 
127 301 302 303 316 648 649 
172 173 174 175 176 177 178 
288 331 332 333 356 357 553 
314 549 612 613 618 619 671 
448 449 450 451 452 453 454 
23 24 25 26 27 334 
113 257 258 259 260 261 
340 341 342 343 344 646 
369 370 458 512 513 554 
470 471 523 524 631 632 
0 1 2 3 4 
37 69 249 415 574 
41 421 503 504 536 
89 110 111 114 624 
123 124 546 564 565 
125 126 128 129 130 
139 371 372 373 374 
208 209 210 211 212 
231 232 233 489 676 
272 273 428 429 430 
275 276 277 278 606 
289 290 561 638 639 
300 330 610 621 644 
345 346 347 348 349 
358 359 361 366 367 
468 469 547 548 558 
472 473 480 543 559 
474 475 476 520 521 
490 491 492 522 544 
16 17 18 573 
31 35 36 38 
112 279 598 599 
203 204 464 465 
250 251 252 253 
317 484 485 486 
381 382 501 502 
386 401 402 403 
393 394 395 460 
444 496 497 540 
515 516 517 518 
591 592 593 594 
637 645 659 678 
45 46 437 
47 48 505 
50 662 663 
160 161 162 
196 197 198 
255 256 396 
306 307 312 
351 352 651 
377 407 597 
406 640 660 
422 423 424 
455 456 457 
507 508 509 
510 511 669 
525 526 535 
551 552 575 
568 569 623 
583 584 585 
588 589 670 
607 608 609 
627 628 629 
652 653 654 
