5 6 7 8 9 10 11 12 13 14 15 32 39 40 42 43 44 81 84 85 87 88 89 90 91 92 93 94 95 114 159 202 321 327 328 365 378 379 383 384 481 493 494 495 506 525 526 527 528 529 530 532 533 534 535 537 545 570 586 587 600 601 602 624 625 641 642 667 675 
0 1 2 3 4 41 72 75 76 78 83 103 199 200 201 234 235 236 237 238 239 240 241 242 243 244 245 246 247 262 263 264 265 266 267 268 287 299 300 330 350 362 363 375 411 416 421 503 504 536 610 617 621 644 655 656 
28 29 30 66 67 68 86 248 254 291 292 345 346 347 348 349 360 397 398 399 400 408 409 410 425 427 431 432 444 445 459 473 480 483 496 540 543 559 566 567 620 630 636 652 653 654 677 
49 50 96 97 98 99 100 101 102 104 105 280 281 282 283 284 285 286 322 323 324 325 326 329 498 627 628 629 633 634 662 663 
80 106 107 108 109 163 164 165 166 167 168 169 170 171 205 206 207 228 229 230 311 315 353 377 404 405 407 466 467 597 
31 35 36 37 69 172 173 174 175 176 177 178 203 204 249 272 273 293 294 415 428 429 430 464 465 560 574 581 582 
179 180 181 182 183 184 185 186 187 188 189 190 191 192 193 194 387 388 389 390 391 392 500 538 550 590 611 650 
51 52 221 222 223 224 225 226 227 340 341 342 343 344 461 499 514 576 577 578 591 592 593 594 646 647 668 
131 132 138 140 141 144 146 147 149 150 195 313 314 448 449 450 451 452 453 454 519 549 612 613 618 619 671 
53 54 55 56 57 58 59 60 61 62 63 152 153 154 155 156 380 462 463 515 516 517 518 672 
33 133 134 135 136 137 142 143 145 148 274 304 305 442 443 470 471 482 523 524 631 632 
73 74 77 79 110 111 112 113 158 257 259 261 275 276 277 278 279 376 598 599 606 657 
23 24 25 26 27 219 334 358 359 361 366 367 386 401 402 403 
34 82 157 351 352 385 406 426 541 542 616 622 640 651 660 666 
47 48 127 301 302 303 316 317 484 485 486 505 648 649 
417 418 419 420 490 491 492 522 531 544 579 580 603 
250 251 252 253 497 588 589 637 645 659 670 678 
115 116 117 118 119 120 121 122 338 539 571 
70 71 308 309 310 438 439 440 626 658 
125 126 128 129 130 139 371 372 373 374 
19 20 21 22 151 368 441 479 661 
38 213 214 215 216 217 218 220 412 
123 124 258 546 551 552 564 565 575 
269 270 271 335 336 337 364 635 643 
295 296 297 298 318 319 320 339 555 
369 370 455 456 457 458 512 513 554 
288 331 332 333 356 357 553 
208 209 210 211 212 
231 232 233 489 676 
260 572 607 608 609 
289 290 561 638 639 
468 469 547 548 558 
474 475 476 520 521 
16 17 18 573 
381 382 501 502 
393 394 395 460 
45 46 437 
160 161 162 
196 197 198 
255 256 396 
306 307 312 
422 423 424 
472 487 488 
507 508 509 
510 511 669 
568 569 623 
583 584 585 
