49 98 99 102 179 180 181 182 183 185 186 187 188 189 190 191 192 193 194 322 323 324 325 326 388 389 391 500 550 590 611 635 
7 12 18 42 43 81 88 89 90 91 92 93 110 111 114 231 233 321 327 328 353 365 481 487 488 489 537 587 624 625 643 
11 29 237 248 358 359 360 361 362 363 366 367 400 410 473 480 543 559 567 652 653 654 655 656 677 
27 37 69 123 124 128 172 173 174 176 177 178 249 369 370 494 554 564 565 573 574 601 602 
5 6 8 9 14 32 86 115 116 117 118 119 120 121 122 165 284 338 539 586 
33 131 134 135 136 137 138 139 140 142 143 146 147 149 150 274 313 482 519 618 
34 41 301 302 303 375 406 426 427 459 462 503 504 616 630 640 648 649 660 666 
23 24 25 26 40 63 260 315 386 401 402 403 493 495 498 545 570 572 600 
53 54 55 56 57 58 59 61 62 152 153 154 155 156 380 463 518 672 
80 106 107 108 148 163 166 167 168 169 170 404 405 407 466 467 471 597 
0 235 239 262 263 264 267 287 288 316 317 331 332 333 415 416 
66 68 251 254 291 292 397 398 399 408 409 483 566 620 636 
133 300 330 490 491 492 522 525 526 535 544 571 610 621 644 
213 215 216 217 218 219 220 334 412 470 523 524 631 632 
72 74 75 76 77 83 157 158 159 228 229 259 385 
431 432 448 449 450 451 452 453 454 546 549 612 613 
234 236 238 240 241 242 244 245 246 265 266 268 
10 13 527 528 529 530 531 532 533 534 675 
70 71 308 309 310 438 439 440 626 658 
15 212 280 281 282 283 286 329 506 
44 96 97 100 105 387 390 392 560 
295 296 297 298 318 319 320 339 555 
94 95 201 202 425 617 641 642 
103 104 221 499 514 637 647 659 
222 224 340 341 342 343 344 646 
73 79 230 376 384 657 667 
269 270 271 335 336 337 364 
417 418 419 420 579 580 603 
444 496 497 540 588 589 670 
60 132 144 145 619 671 
109 171 205 206 207 311 
67 250 252 253 445 
78 141 247 421 536 
112 199 200 350 411 
175 351 581 582 651 
272 273 428 429 430 
275 276 277 278 606 
345 346 347 348 349 
1 2 3 4 
31 35 36 38 
87 113 195 378 
126 129 130 374 
203 204 464 465 
208 209 210 211 
227 576 577 578 
591 592 593 594 
16 17 243 
28 30 472 
39 214 299 
47 48 505 
50 662 663 
82 352 622 
184 538 650 
223 226 461 
232 377 676 
257 258 261 
279 598 599 
356 357 553 
371 372 373 
455 456 457 
458 512 513 
484 485 486 
515 516 517 
551 552 575 
607 608 609 
627 628 629 
