5 7 8 9 12 14 15 32 39 42 43 81 86 87 88 89 90 91 92 93 94 95 111 114 195 202 321 327 328 365 378 406 426 449 472 481 487 488 537 586 587 600 616 624 625 640 641 642 660 666 
6 11 28 29 30 248 345 346 347 348 349 360 400 410 425 427 431 432 459 473 480 543 559 567 630 652 653 654 677 
80 106 107 108 109 163 164 165 166 167 168 169 170 171 205 206 207 230 311 315 353 384 404 405 466 467 667 
31 37 69 172 173 174 175 176 177 178 203 204 249 272 273 415 428 429 430 560 574 
53 54 55 56 57 58 59 60 61 62 63 152 153 154 155 156 380 462 463 518 672 
66 67 68 254 291 292 397 398 399 408 409 444 445 483 496 540 566 620 636 
0 103 199 200 201 239 263 300 330 350 362 363 411 416 610 617 621 644 
179 180 181 185 187 189 191 192 194 387 388 389 390 391 392 550 590 611 
234 235 236 238 240 241 242 243 244 245 247 262 264 265 266 267 268 287 
182 183 186 190 193 221 222 223 224 226 227 461 500 514 647 
33 133 134 135 136 137 142 143 145 148 274 471 482 
23 24 25 26 27 219 334 366 386 401 402 403 
40 44 493 494 495 525 526 535 545 570 601 602 
72 73 74 75 76 82 83 157 159 352 385 622 
10 13 506 527 528 529 530 532 533 534 675 
70 71 308 309 310 438 439 440 626 658 
77 110 112 113 257 259 261 279 320 555 
19 20 21 22 151 368 441 479 661 
38 213 214 215 216 217 218 220 412 
280 281 282 283 284 285 286 329 498 
417 418 419 420 531 544 579 580 603 
41 78 246 375 421 503 504 536 
127 301 302 303 316 317 648 649 
132 138 141 144 146 147 150 519 
369 370 371 372 458 512 513 554 
97 98 99 101 102 104 105 
115 116 117 118 121 122 338 
269 270 271 335 336 337 364 
295 296 297 298 318 319 339 
49 322 323 324 325 326 
123 124 258 546 564 565 
131 140 314 549 612 618 
340 341 342 343 344 646 
34 351 581 582 651 
51 52 576 577 578 
125 126 128 129 130 
208 209 210 211 212 
231 232 233 489 676 
275 276 277 278 606 
289 290 561 638 639 
468 469 547 548 558 
470 523 524 631 632 
474 475 476 520 521 
1 2 3 4 
119 120 539 571 
149 454 619 671 
237 299 655 656 
250 251 252 253 
288 331 332 333 
358 359 361 367 
381 382 501 502 
393 394 395 460 
448 450 452 453 
490 491 492 522 
497 588 589 670 
591 592 593 594 
637 645 659 678 
45 46 437 
47 48 505 
50 662 663 
79 376 657 
139 373 374 
158 379 383 
160 161 162 
184 538 650 
196 197 198 
255 256 396 
306 307 312 
313 451 613 
356 357 553 
377 407 597 
422 423 424 
455 456 457 
484 485 486 
507 508 509 
510 511 669 
515 516 517 
551 552 575 
568 569 623 
583 584 585 
607 608 609 
627 628 629 
