0 1 2 3 4 31 34 35 36 37 41 69 73 75 76 78 82 83 103 133 157 158 172 173 174 175 176 177 178 203 204 228 229 234 235 236 237 238 239 240 241 242 243 244 245 246 247 249 262 263 264 265 266 267 268 272 273 287 293 294 299 300 330 350 351 352 362 363 375 385 406 415 416 421 426 428 429 430 462 464 465 490 491 492 503 504 522 536 541 542 544 560 574 581 582 610 616 621 622 640 644 651 655 656 660 
7 12 13 14 32 39 40 42 43 44 81 84 85 87 88 89 90 91 92 93 94 95 106 107 108 109 111 114 165 166 167 169 171 195 199 201 202 205 206 207 231 232 233 311 321 327 328 353 365 378 379 383 466 472 481 487 488 489 494 495 498 506 527 528 529 530 532 534 537 570 587 600 601 602 617 624 625 641 642 675 676 
33 72 80 131 132 134 135 136 137 138 140 141 142 143 144 145 146 147 148 149 150 159 163 164 168 170 230 274 304 305 313 314 377 384 404 405 407 442 443 448 449 450 451 452 453 454 470 471 482 519 523 524 549 597 612 613 618 619 631 632 667 671 
70 71 179 180 181 182 183 184 185 186 187 188 189 190 191 192 193 194 221 222 223 224 225 226 227 308 309 310 340 341 342 343 344 387 388 389 390 391 392 438 439 440 461 499 500 514 538 550 590 591 592 593 594 611 626 646 647 650 658 668 
77 110 112 113 123 124 257 258 259 260 261 275 279 295 296 297 298 315 318 319 320 339 486 546 551 552 555 564 565 572 575 598 599 607 608 609 
28 29 30 248 345 346 347 348 349 360 400 410 425 427 431 432 459 473 480 543 559 567 630 652 653 654 666 677 
66 67 68 250 251 252 253 254 291 292 397 398 399 408 409 444 445 483 496 540 566 620 636 637 645 659 678 
53 54 55 56 57 58 59 60 61 62 63 152 153 154 155 156 380 463 515 516 517 518 672 
49 50 96 97 98 99 101 102 104 105 322 323 324 325 326 627 628 629 662 663 
23 24 25 26 27 219 334 358 359 361 366 367 386 401 402 403 
139 369 370 371 372 373 374 455 456 457 458 512 513 554 
38 213 214 215 216 217 218 220 412 497 588 589 670 
47 48 127 301 302 303 316 317 484 485 505 648 649 
100 200 280 281 282 283 284 285 286 329 411 633 634 
115 116 117 118 119 120 121 122 338 539 571 
5 6 8 9 10 11 15 86 533 586 
19 20 21 22 151 368 441 479 661 
269 270 271 335 336 337 364 635 643 
417 418 419 420 531 579 580 603 
288 331 332 333 356 357 553 
51 52 576 577 578 
125 126 128 129 130 
208 209 210 211 212 
289 290 561 638 639 
468 469 547 548 558 
474 475 476 520 521 
493 525 526 535 545 
16 17 18 573 
74 79 376 657 
381 382 501 502 
393 394 395 460 
45 46 437 
160 161 162 
196 197 198 
255 256 396 
306 307 312 
422 423 424 
507 508 509 
510 511 669 
568 569 623 
583 584 585 
