7 10 12 32 42 43 44 88 89 90 91 92 110 111 114 321 327 328 472 527 528 529 530 532 534 537 587 624 625 675 
72 73 74 75 76 77 78 79 80 81 82 83 157 158 159 195 228 229 230 376 379 383 384 385 622 657 667 
31 37 69 172 173 174 175 176 177 178 203 204 249 272 273 351 415 428 429 430 574 581 582 651 
0 234 235 236 238 239 240 241 242 243 244 245 246 247 262 263 264 265 266 267 268 287 416 
39 40 87 93 95 365 378 481 493 494 495 525 526 535 545 570 600 601 602 
53 54 55 56 57 58 59 60 61 62 63 152 153 154 155 156 380 463 672 
49 96 97 98 99 101 102 103 104 105 322 323 324 325 326 627 628 629 
106 107 108 109 164 165 166 167 169 171 205 206 207 311 315 353 466 467 
179 180 181 185 189 191 192 194 387 388 389 390 391 392 550 590 611 
13 248 360 400 425 427 473 480 543 559 567 630 652 653 654 677 
131 132 138 140 141 144 146 147 150 313 314 519 618 619 671 
221 222 223 224 225 227 340 341 343 576 577 578 646 647 668 
66 67 68 291 292 397 398 399 408 409 410 445 483 620 
5 6 8 9 11 14 15 86 506 533 586 
115 116 117 118 119 120 121 122 338 539 571 
149 448 449 450 451 452 453 454 549 612 613 
280 281 282 283 284 285 286 329 487 488 498 
33 134 135 136 137 142 143 148 274 482 
35 36 38 213 214 215 216 217 218 412 
47 48 127 301 302 303 316 505 648 649 
70 71 308 309 310 438 439 440 626 658 
163 168 170 232 377 404 405 407 597 676 
19 20 21 22 151 368 441 479 661 
369 370 455 456 457 458 512 513 554 
219 220 470 471 523 524 631 632 
300 330 362 363 375 610 621 644 
23 24 366 386 401 402 403 
94 199 201 202 617 641 642 
182 183 186 190 193 500 514 
250 251 252 253 254 566 636 
269 270 271 335 336 337 364 
29 113 406 616 640 660 
34 352 426 459 462 666 
123 124 258 546 564 565 
41 421 503 504 536 
125 126 128 129 130 
139 371 372 373 374 
208 209 210 211 212 
257 259 260 261 572 
275 276 277 278 606 
289 290 561 638 639 
295 296 298 318 339 
344 591 592 593 594 
345 346 347 348 349 
419 420 531 579 580 
468 469 547 548 558 
474 475 476 520 521 
1 2 3 4 
25 26 27 334 
28 30 431 432 
112 200 350 411 
184 187 538 650 
237 299 655 656 
288 331 332 333 
297 319 320 555 
317 484 485 486 
358 359 361 367 
381 382 501 502 
393 394 395 460 
497 588 589 670 
515 516 517 518 
637 645 659 678 
45 46 437 
50 662 663 
160 161 162 
196 197 198 
226 342 461 
231 233 489 
255 256 396 
279 598 599 
306 307 312 
356 357 553 
417 418 603 
422 423 424 
444 496 540 
490 492 522 
507 508 509 
510 511 669 
551 552 575 
568 569 623 
583 584 585 
607 608 609 
