27 37 69 100 103 128 133 172 173 174 175 176 177 178 249 272 273 300 330 351 369 370 375 428 429 430 490 492 512 513 522 525 526 535 554 560 571 573 574 581 582 610 621 644 651 
7 12 18 40 42 43 63 81 88 90 91 92 93 231 233 260 315 321 327 328 353 365 481 486 487 488 489 493 498 537 545 570 572 587 600 625 643 
53 54 55 56 57 58 59 61 62 152 153 154 155 156 380 417 418 419 420 463 491 518 544 579 580 603 672 
180 181 182 183 184 185 186 188 189 190 191 192 193 194 387 388 389 390 391 392 500 538 550 590 611 650 
5 6 8 9 10 32 86 115 116 117 118 119 120 121 122 165 284 338 539 586 
34 41 301 302 303 406 426 427 459 462 503 504 616 630 640 648 649 660 666 
33 131 134 135 136 137 138 139 142 143 150 274 313 519 
213 215 216 217 218 219 220 334 412 470 523 524 631 632 
234 236 238 240 241 242 244 245 246 265 266 268 
13 14 527 528 529 530 531 532 533 534 675 
72 73 74 75 76 83 157 158 159 228 229 
11 237 248 362 363 400 567 655 656 677 
66 68 291 292 397 398 399 408 483 620 
15 101 280 281 282 283 285 286 329 
28 29 30 410 472 473 480 543 559 
70 71 308 309 310 438 439 440 658 
79 358 359 360 361 366 367 376 657 
295 296 297 298 318 319 320 339 555 
0 239 262 263 264 267 415 416 
23 24 25 26 386 401 402 403 
94 95 201 202 425 617 641 642 
104 221 225 499 514 637 647 659 
106 107 108 166 167 169 466 467 
140 149 549 612 613 618 619 671 
148 168 170 404 405 407 471 597 
227 576 577 578 591 592 593 594 
431 432 448 449 450 451 452 454 
49 99 322 323 324 325 326 
123 124 494 564 565 601 602 
235 287 288 316 331 332 333 
269 270 271 335 336 337 364 
371 372 373 455 456 457 458 
444 496 497 540 588 589 670 
77 230 259 384 385 667 
89 110 111 112 114 624 
109 171 205 206 207 311 
340 341 342 344 646 668 
60 132 144 145 147 
67 250 252 253 445 
78 141 247 421 536 
251 254 409 566 636 
275 276 277 278 606 
345 346 347 348 349 
1 2 3 4 
31 35 36 38 
87 113 195 378 
98 179 187 635 
199 200 350 411 
203 204 464 465 
208 209 210 211 
16 17 243 
39 214 299 
44 96 495 
47 48 505 
50 662 663 
82 352 622 
97 102 105 
222 224 226 
232 377 676 
257 258 261 
279 598 599 
317 484 485 
356 357 553 
515 516 517 
551 552 575 
607 608 609 
627 628 629 
652 653 654 
