60 131 132 134 135 136 137 138 139 140 142 143 144 145 146 147 148 149 150 164 274 313 314 404 405 407 471 482 519 549 597 612 613 618 619 671 
27 37 69 103 128 133 249 300 330 369 370 490 492 513 522 525 526 535 554 571 573 574 610 621 644 
15 23 24 25 26 40 63 200 280 281 282 283 286 329 350 386 401 402 403 411 493 545 570 
7 18 42 81 88 91 92 231 233 321 327 328 454 487 488 489 498 537 587 625 643 
72 73 74 75 76 77 83 87 157 158 159 195 228 229 230 378 379 383 384 385 667 
179 180 181 184 185 189 191 192 194 387 388 389 390 391 392 538 550 590 611 
80 106 107 108 109 163 166 167 168 169 170 171 205 206 207 311 466 467 
8 31 32 86 115 116 117 118 119 120 121 122 165 284 338 539 586 
79 172 173 174 175 176 177 178 358 359 360 361 366 367 375 376 657 
41 57 301 302 303 426 427 459 462 463 503 504 630 648 649 666 
53 54 56 58 59 61 62 152 153 154 155 156 380 672 
11 237 248 362 363 400 410 480 567 655 656 677 
66 67 68 291 292 397 398 399 408 445 483 620 
234 236 238 240 241 242 244 245 246 265 266 268 
93 94 95 199 201 202 425 481 617 641 642 
10 13 527 528 529 530 531 533 534 675 
34 272 273 351 428 429 430 581 582 651 
70 71 308 309 310 438 439 440 658 
0 239 262 263 264 267 415 416 
55 406 420 491 512 544 640 660 
123 124 494 564 565 600 601 602 
227 576 577 578 591 592 593 594 
250 251 252 253 254 409 566 636 
49 99 322 323 324 325 326 
104 221 223 225 637 647 659 
182 183 186 190 193 500 514 
235 287 288 316 331 332 333 
269 270 271 335 336 337 364 
295 296 297 298 318 319 339 
28 30 472 473 543 559 
340 341 342 344 646 668 
5 6 9 12 14 
78 141 247 421 536 
213 215 217 218 412 
216 497 588 589 670 
220 470 523 524 631 
257 258 259 260 261 
275 276 277 278 606 
345 346 347 348 349 
371 372 373 374 458 
448 450 451 452 453 
1 2 3 4 
43 90 353 532 
89 111 114 624 
98 187 635 650 
110 113 320 555 
203 204 464 465 
208 209 210 211 
222 224 226 461 
431 432 449 546 
515 516 517 518 
16 17 243 
35 36 38 
39 214 299 
44 96 495 
47 48 505 
50 662 663 
82 352 622 
97 102 105 
126 129 130 
219 334 632 
232 377 676 
315 486 572 
317 484 485 
356 357 553 
417 418 603 
419 579 580 
444 496 540 
455 456 457 
551 552 575 
607 608 609 
627 628 629 
652 653 654 
