5 7 8 9 12 14 15 32 39 42 43 81 86 87 88 89 90 91 92 93 94 95 111 114 195 202 321 327 328 365 378 449 472 481 487 488 537 586 587 600 624 625 641 642 
182 183 186 190 191 193 221 222 223 224 225 226 227 340 341 342 343 344 461 500 514 550 591 592 593 594 646 647 668 
41 75 78 83 173 199 200 201 246 300 330 350 351 362 363 375 411 421 503 504 536 581 582 610 617 621 644 651 
80 106 107 108 109 163 164 165 166 167 168 169 170 171 205 206 207 311 315 353 377 404 405 407 466 467 597 
6 11 248 345 346 348 349 400 425 427 431 432 459 473 543 559 567 630 652 653 654 666 677 
53 54 55 56 57 58 59 60 61 62 63 152 153 154 155 156 380 462 463 518 672 
66 67 68 254 291 292 397 398 399 408 409 444 445 483 496 540 566 620 636 
31 34 37 69 103 172 174 176 177 178 249 272 273 415 428 429 430 574 
49 96 97 98 99 101 102 104 105 322 323 324 325 326 627 628 629 
131 132 138 140 141 144 146 147 150 313 314 451 519 549 612 613 618 
179 180 181 185 187 189 192 194 387 388 389 390 391 392 590 611 
33 133 134 135 136 137 142 143 145 148 274 471 482 
234 236 238 240 241 242 243 244 245 247 265 266 268 
23 24 25 26 27 219 334 366 386 401 402 403 
10 13 506 527 528 529 530 532 533 534 675 
70 71 308 309 310 438 439 440 626 658 
72 73 74 76 158 159 379 383 384 667 
100 280 281 282 283 284 285 286 329 498 
0 235 239 262 263 264 267 287 416 
19 20 21 22 151 368 441 479 661 
38 213 214 215 216 217 218 220 412 
127 301 302 303 316 317 648 649 
417 418 419 420 531 579 580 603 
28 29 30 347 360 410 480 
40 44 494 495 570 601 602 
115 116 117 118 121 122 338 
269 270 271 335 336 337 364 
295 296 297 298 318 319 339 
123 124 258 546 564 565 
257 260 261 484 486 572 
369 370 458 512 513 554 
51 52 576 577 578 
82 157 352 385 622 
110 112 113 320 555 
125 126 128 129 130 
139 371 372 373 374 
208 209 210 211 212 
231 232 233 489 676 
275 276 277 278 606 
289 290 561 638 639 
406 426 616 640 660 
468 469 547 548 558 
470 523 524 631 632 
474 475 476 520 521 
493 525 526 535 545 
1 2 3 4 
119 120 539 571 
149 454 619 671 
203 204 464 465 
237 299 655 656 
250 251 252 253 
288 331 332 333 
358 359 361 367 
381 382 501 502 
393 394 395 460 
448 450 452 453 
497 588 589 670 
637 645 659 678 
45 46 437 
47 48 505 
50 662 663 
79 376 657 
160 161 162 
184 538 650 
196 197 198 
228 229 230 
255 256 396 
279 598 599 
306 307 312 
356 357 553 
422 423 424 
455 456 457 
490 492 522 
507 508 509 
510 511 669 
515 516 517 
551 552 575 
568 569 623 
583 584 585 
607 608 609 
