0 1 2 3 4 7 14 23 24 25 26 27 34 37 41 42 47 48 69 100 115 116 117 118 119 120 121 125 127 128 203 204 208 209 210 211 212 248 249 272 273 280 281 282 284 285 286 293 294 299 300 301 302 303 321 328 329 330 334 338 362 363 369 370 415 417 418 419 425 426 427 428 429 430 459 462 464 465 489 490 491 492 503 504 505 506 522 527 528 529 530 531 534 537 539 544 554 560 571 573 574 579 580 581 582 603 610 621 625 630 633 634 643 644 648 649 666 675 
40 44 53 54 56 57 58 59 60 61 62 63 112 152 153 154 155 156 179 180 181 182 183 184 185 186 188 189 190 191 192 193 194 200 283 379 380 387 388 389 390 391 392 401 402 403 411 463 486 493 494 495 499 500 514 515 516 517 518 525 526 535 545 550 570 572 590 607 608 609 611 672 
17 66 68 123 172 173 174 175 176 177 178 231 232 233 234 235 236 237 238 239 240 241 242 243 244 245 246 247 262 263 264 265 266 267 268 287 288 316 331 332 333 356 358 359 360 361 366 367 375 376 377 386 407 416 483 551 552 564 565 575 597 655 656 657 676 
8 39 43 84 85 87 88 89 90 91 92 93 94 95 106 107 108 109 110 111 114 122 163 164 165 166 167 168 169 170 171 205 206 207 311 315 353 378 466 467 481 532 586 587 600 601 602 624 
30 86 132 138 140 141 145 146 147 149 304 305 313 314 345 346 347 349 397 398 399 400 408 409 410 421 482 519 536 541 542 549 567 612 613 618 619 620 640 671 
16 18 31 32 33 35 36 38 124 327 365 431 432 448 449 450 451 452 453 454 487 488 498 546 652 653 654 
126 129 130 131 133 134 135 136 137 139 142 143 144 148 150 274 371 372 373 374 442 443 455 456 457 458 513 
72 73 74 75 76 77 78 79 80 81 82 83 157 158 159 195 228 229 230 383 384 385 622 667 
97 99 101 102 104 105 199 201 202 221 222 223 224 225 226 227 340 576 617 641 642 647 659 
49 50 96 98 103 187 269 270 271 322 323 324 325 326 335 336 337 364 538 635 662 663 
55 113 257 258 259 260 261 295 296 297 298 318 319 320 339 404 405 406 420 512 555 660 
213 214 215 216 217 218 219 220 412 470 471 523 524 588 589 631 632 670 
5 6 9 10 11 12 15 28 29 350 351 352 533 616 651 
67 250 251 253 254 291 292 444 445 496 497 540 566 
275 276 277 278 279 598 599 606 
348 472 473 480 543 559 
252 636 637 645 678 
13 650 677 
317 484 485 
627 628 629 
