179 180 181 182 183 184 185 186 188 189 190 191 192 193 194 387 388 389 390 391 392 499 500 514 550 590 611 
15 23 24 25 26 40 63 200 280 281 282 283 286 329 350 386 401 402 403 411 454 493 498 545 570 
27 37 69 103 128 133 199 249 300 330 369 370 490 492 522 525 526 535 554 571 573 574 610 621 644 
8 31 32 33 35 36 38 100 115 116 117 118 119 120 121 122 165 284 338 365 539 586 
7 18 39 42 81 88 214 299 321 327 328 487 488 489 537 587 625 643 
79 172 173 174 175 176 177 178 358 359 360 361 366 367 375 376 377 657 
5 6 9 10 12 13 14 212 506 527 528 529 530 531 533 534 675 
11 28 29 30 86 237 248 362 363 400 410 480 567 616 655 656 
104 221 222 223 224 225 226 227 461 576 577 578 637 647 659 668 
72 73 74 75 76 83 157 158 159 228 229 230 384 385 667 
55 148 168 170 404 405 406 407 420 471 512 597 640 660 
140 146 147 149 150 164 314 519 549 612 613 618 619 671 
41 47 48 301 302 303 462 503 504 505 648 649 
53 54 56 57 58 59 61 62 153 154 380 463 
131 139 313 371 372 373 374 455 456 457 458 513 
234 236 238 240 241 242 244 245 246 265 266 268 
34 272 273 351 428 429 430 560 581 582 651 
110 112 113 257 258 260 261 297 319 320 555 
43 90 91 92 93 94 353 481 532 
66 68 397 398 399 408 409 483 620 
70 71 308 309 310 438 439 440 658 
134 135 136 137 142 143 145 274 482 
0 239 262 263 264 267 415 416 
95 201 202 425 426 617 641 642 
106 107 108 166 167 169 466 467 
49 99 322 323 324 325 326 
67 291 292 444 445 496 540 
123 124 564 565 600 601 602 
250 251 252 253 254 566 636 
269 270 271 335 336 337 364 
109 171 205 206 207 311 
220 470 523 524 631 632 
78 141 247 421 536 
87 195 378 379 383 
101 285 627 628 629 
213 215 217 218 412 
216 497 588 589 670 
275 276 277 278 606 
295 296 298 318 339 
340 341 342 344 646 
345 346 347 348 349 
1 2 3 4 
60 132 138 144 
89 111 114 624 
98 187 538 635 
203 204 464 465 
208 209 210 211 
231 232 233 676 
235 287 288 316 
427 459 630 666 
448 450 451 452 
472 473 543 559 
515 516 517 518 
591 592 593 594 
16 17 243 
50 662 663 
82 352 622 
97 102 105 
126 129 130 
279 598 599 
315 486 572 
317 484 485 
331 332 333 
356 357 553 
417 418 603 
419 579 580 
431 432 449 
551 552 575 
607 608 609 
652 653 654 
