0 11 62 63 87 105 110 113 116 124 132 134 159 160 164 165 173 174 180 209 224 234 236 246 251 252 253 259 271 272 286 298 305 308 315 327 337 338 339 347 348 359 361 363 365 373 395 397 423 427 433 434 439 466 467 469 470 476 485 486 493 506 511 512 515 521 530 534 551 556 558 569 592 601 618 622 629 640 644 646 647 664 669 678 682 692 716 727 728 729 746 753 785 788 793 803 804 807 808 825 854 858 897 937 966 969 985 992 998 1007 1021 1022 1048 1059 1060 1071 1074 
26 68 69 73 75 91 94 100 108 109 114 115 120 127 128 131 157 188 189 194 195 199 214 216 235 257 258 265 277 290 294 295 313 319 330 353 354 362 380 403 404 430 435 436 445 449 453 482 487 507 535 544 579 585 596 609 626 627 637 649 673 674 703 704 714 726 735 736 778 790 792 798 800 805 827 832 834 835 842 852 855 864 869 872 875 882 899 923 925 946 954 980 981 1000 1005 1006 1013 1030 1046 1049 1056 1070 1075 1080 
14 71 92 93 97 98 118 121 125 143 149 155 170 185 190 191 192 198 200 204 212 213 228 254 263 280 287 288 341 346 372 405 409 410 415 416 419 432 481 495 499 518 539 548 553 562 600 605 606 607 630 645 648 650 657 658 661 670 710 730 744 756 787 797 813 817 819 838 853 870 885 886 893 894 904 907 916 927 928 931 934 935 948 956 963 974 979 982 983 987 988 1003 1025 1032 1033 1039 1040 1057 1076 
1 2 4 5 7 10 12 20 21 22 25 34 41 44 45 46 50 78 88 103 148 166 177 184 211 219 247 311 334 352 377 399 424 425 426 429 472 474 496 514 532 540 541 549 561 563 615 616 676 677 681 699 717 718 755 773 781 782 801 802 821 837 840 841 866 880 881 891 892 896 902 903 930 936 943 958 960 965 990 991 994 996 1023 1038 1054 1055 1058 1064 1066 1073 
58 86 89 101 102 111 112 117 162 169 176 181 207 210 215 275 276 283 285 289 291 312 320 321 340 366 369 370 376 387 392 398 414 446 460 463 464 471 517 527 528 546 554 568 573 586 594 599 612 617 628 631 633 636 651 660 665 668 686 693 707 712 719 720 754 775 776 814 828 829 843 849 851 859 876 911 933 941 942 944 947 950 972 977 978 1001 1037 1061 
15 42 43 49 51 59 76 77 106 107 122 123 147 156 167 179 186 187 217 221 222 227 232 261 266 267 278 357 382 389 391 393 394 396 406 421 428 447 450 451 494 526 537 538 571 575 591 610 621 634 643 659 709 725 738 772 774 784 791 815 820 836 839 845 850 860 861 913 929 940 986 1011 1027 1035 1052 1067 1072 1077 1081 
16 17 23 30 31 33 141 146 238 273 274 296 299 303 322 323 374 384 400 437 442 491 505 520 524 525 555 577 581 582 597 611 623 666 667 671 675 751 752 758 760 761 764 783 794 795 799 818 900 909 912 920 951 952 953 1008 1020 1053 1065 
24 29 32 40 47 84 85 96 119 126 133 183 220 237 270 309 310 329 335 342 388 412 479 480 501 522 614 619 620 653 654 679 690 706 715 737 743 750 766 770 780 789 796 806 810 811 844 847 848 879 887 888 905 939 967 993 1034 1062 
67 83 129 130 144 150 163 175 196 208 225 242 243 255 256 260 279 336 358 371 390 408 461 465 497 500 504 536 564 578 595 641 642 656 662 672 731 765 862 898 926 938 964 984 1002 1012 1047 
52 79 99 135 178 233 241 264 328 375 385 452 454 459 462 473 492 508 509 510 519 523 559 566 567 613 683 698 708 739 740 747 779 809 889 890 908 919 924 970 975 1041 1078 1082 
3 6 35 36 38 39 60 61 72 82 95 152 239 269 331 349 350 401 417 422 438 455 456 475 557 565 576 608 680 732 749 763 767 769 823 906 1015 1024 1043 1051 
13 18 48 140 168 197 325 326 343 381 477 478 483 484 488 498 529 552 574 587 588 603 655 687 689 705 713 721 757 762 816 824 846 867 871 922 955 959 
53 54 104 151 248 297 324 367 368 407 431 457 516 652 663 688 691 741 742 826 830 833 877 921 945 968 997 1004 1014 1026 1031 1042 
70 138 202 203 223 249 281 284 293 314 344 355 420 468 638 685 696 697 711 723 822 831 884 895 973 1018 
19 55 56 57 64 145 226 240 345 364 411 458 531 533 584 598 700 745 865 883 932 999 1019 1069 
9 27 28 37 80 139 171 262 302 333 418 444 593 602 624 625 635 701 734 786 910 1017 1050 
90 158 193 268 292 332 441 443 448 489 502 503 570 580 583 632 722 724 768 868 1079 1083 1084 
66 182 205 229 230 231 250 317 356 386 402 572 777 812 856 918 971 1063 
74 136 142 218 300 318 542 550 589 590 694 695 863 1010 1068 
172 206 351 490 560 702 733 748 771 874 957 1036 
81 161 301 316 378 379 543 545 639 857 878 
153 154 244 245 282 413 873 949 
8 65 360 440 513 976 995 
137 201 304 383 759 1016 
547 684 901 917 1009 
604 1028 1029 
