5 20 35 38 39 48 72 82 97 98 120 134 141 152 270 304 326 361 449 466 489 546 565 577 610 611 631 659 804 808 820 846 867 906 953 955 1065 
84 99 218 251 359 364 454 496 510 527 558 559 582 615 617 621 668 669 698 701 726 727 728 739 740 747 748 756 765 776 785 930 970 1055 
188 189 283 296 303 313 319 330 345 354 376 385 386 396 402 404 442 468 490 491 520 597 604 638 662 678 711 827 835 
68 69 109 116 133 196 199 214 216 239 257 265 277 289 290 388 421 430 482 535 609 703 763 778 800 879 1080 
148 167 190 212 312 545 556 625 675 712 797 802 817 852 853 855 870 911 916 917 974 988 995 1067 1076 1077 
73 74 163 175 208 245 279 350 367 368 378 379 586 606 607 648 670 694 695 744 1003 1004 1010 1068 
86 128 145 221 233 274 291 341 365 471 683 693 741 742 815 833 868 869 883 921 924 932 1007 1031 
0 3 9 10 11 13 14 15 19 22 29 32 34 47 119 373 605 690 806 905 979 994 
46 53 54 103 104 151 209 236 308 343 344 369 516 524 664 697 751 816 1059 
36 45 61 63 89 96 124 161 184 250 474 628 758 823 901 940 1051 1064 
51 281 391 393 415 463 470 517 575 646 671 719 779 843 878 949 1018 1027 
91 159 171 172 220 224 309 310 436 504 549 623 629 737 746 858 1002 1012 
273 317 318 327 346 424 425 444 485 498 499 534 571 651 722 825 828 
1 2 21 25 272 324 433 434 460 521 541 663 781 782 873 
157 158 168 183 193 292 305 332 443 590 608 626 927 1030 1070 
540 570 584 680 832 865 910 931 964 999 1006 1017 1049 1069 
142 186 232 269 476 493 511 515 551 632 634 640 850 
411 552 553 574 588 598 603 705 713 721 1019 1034 1062 
125 147 160 166 181 185 198 205 777 876 897 1063 
131 207 259 462 555 641 702 767 769 888 957 1005 
27 108 200 204 219 266 624 677 687 691 1039 
75 286 339 340 509 595 619 620 754 1043 1071 
234 538 589 616 723 724 822 863 948 956 1057 
254 398 399 418 696 738 773 818 845 884 1050 
33 380 514 530 642 709 755 936 985 998 
42 115 287 338 431 438 583 838 874 899 
52 377 483 681 757 871 890 996 1028 1029 
80 102 118 180 375 387 461 908 975 978 
452 459 561 568 614 716 725 796 960 963 
12 334 389 395 554 896 944 976 1021 
16 17 23 26 195 211 237 789 882 
37 94 95 285 406 851 859 937 1075 
70 90 105 110 113 117 153 244 1048 
226 400 440 531 533 666 760 844 1008 
253 282 408 446 494 591 839 862 928 
432 439 572 594 686 720 849 933 934 
465 467 707 752 799 807 918 935 938 
28 140 342 360 654 684 887 1001 
44 49 65 107 238 382 447 526 
50 101 129 130 144 246 390 1038 
56 202 492 637 780 824 954 980 
76 258 315 753 762 841 842 893 
78 448 455 706 770 791 971 993 
111 112 169 495 505 612 982 1040 
225 255 256 497 536 578 898 1047 
280 284 293 314 355 420 831 892 
43 77 165 230 247 488 532 
59 187 363 734 768 992 1083 
136 137 201 325 383 759 1016 
150 566 567 912 913 1041 1072 
276 278 427 692 814 966 1037 
322 323 847 848 902 903 1073 
384 419 580 630 801 1009 1084 
512 587 688 689 775 943 1074 
643 644 774 787 877 885 1033 
649 650 673 714 792 798 872 
55 57 164 240 348 1060 
114 374 519 599 860 861 
156 227 349 401 749 750 
223 682 840 891 929 1081 
297 347 469 486 508 661 
381 422 667 951 952 1020 
484 636 745 788 972 1036 
62 217 653 704 1035 
71 529 968 1015 1032 
88 135 506 660 1082 
100 178 264 881 909 
121 481 547 548 907 
122 352 362 656 1052 
176 295 372 403 875 
177 407 652 786 1058 
192 458 528 837 1054 
229 252 328 523 1078 
331 336 371 456 557 
451 472 522 602 950 
735 736 819 900 1024 
4 146 525 1053 
60 573 731 732 
64 231 633 665 
67 79 81 241 
83 263 539 1025 
87 228 658 710 
138 475 672 973 
174 335 743 856 
206 366 560 576 
213 457 543 795 
242 243 316 394 
249 311 895 939 
260 267 392 501 
298 351 435 981 
302 479 480 679 
337 790 836 969 
358 410 894 983 
397 562 635 809 
426 676 813 1023 
445 889 984 1013 
477 478 513 1056 
502 503 592 1079 
544 997 1026 1042 
639 766 810 811 
30 333 783 
40 441 805 
41 222 685 
58 294 1000 
66 132 708 
85 299 537 
92 487 507 
123 417 866 
126 329 450 
149 699 771 
154 288 409 
173 922 1022 
182 215 596 
191 405 518 
261 428 761 
271 370 622 
300 423 925 
301 569 593 
320 321 829 
356 357 926 
412 733 919 
453 579 834 
473 826 857 
563 564 821 
600 987 1014 
601 645 854 
647 717 718 
784 793 986 
830 904 945 
941 942 1061 
946 947 977 
990 991 1066 
