0 1 2 3 4 10 13 21 24 25 41 56 57 64 94 99 139 142 145 164 186 187 222 231 232 269 271 272 278 285 324 327 340 347 348 352 363 389 395 397 406 411 412 428 433 434 460 469 476 480 486 493 510 511 515 521 531 541 551 554 559 562 617 621 633 634 640 661 663 665 668 669 679 698 699 700 733 739 740 747 748 754 756 771 781 784 793 809 851 859 883 896 919 924 932 937 944 958 965 970 976 986 992 994 1021 1060 1075 
9 11 14 15 18 19 22 29 32 34 43 47 77 119 131 153 154 163 165 173 174 206 207 210 220 244 247 256 259 282 288 329 351 366 373 408 450 462 488 494 500 505 532 536 555 560 576 578 591 605 625 641 642 690 702 715 717 718 741 742 755 761 767 769 772 785 806 839 862 873 888 898 899 905 908 928 940 957 967 979 990 991 1005 1015 1022 1066 
42 46 53 54 92 100 103 104 129 130 144 151 178 179 205 209 218 236 264 266 276 297 301 308 338 343 344 359 364 369 374 390 427 431 453 454 458 487 496 507 508 516 524 528 558 561 568 569 583 593 615 664 691 692 697 701 709 725 726 734 751 765 776 814 816 834 837 838 874 930 960 963 1037 1055 1059 1063 
31 58 61 68 69 84 86 87 88 109 115 116 127 135 162 182 215 216 221 228 239 262 268 274 287 290 291 299 341 358 365 388 410 421 432 436 438 439 471 482 506 535 572 579 582 585 594 596 609 637 658 660 686 693 703 710 720 729 730 763 777 778 780 815 824 849 860 861 894 933 934 983 1080 1082 
5 12 16 17 20 23 26 33 35 38 39 48 72 97 98 120 141 195 211 237 240 270 304 326 334 380 391 449 466 514 527 530 540 546 565 570 577 584 610 611 631 659 680 789 820 865 867 881 882 906 909 910 931 936 953 955 964 985 998 999 1006 1017 1024 1065 1069 
73 74 156 175 188 189 208 227 279 280 283 284 296 303 313 314 319 330 336 349 350 354 355 368 371 376 378 379 386 396 401 402 404 420 422 442 468 490 491 520 586 597 604 606 607 638 662 667 670 694 711 744 749 750 813 822 827 835 951 952 1003 1004 1010 1020 
75 80 102 118 159 171 180 225 226 286 309 310 320 321 339 375 387 400 416 440 452 459 461 497 504 509 523 549 595 619 620 629 666 737 760 773 802 829 844 845 914 915 916 941 942 975 978 984 1002 1008 1026 1042 1043 1061 1071 
59 96 125 126 128 147 148 149 160 161 166 167 170 181 184 185 190 198 250 261 311 312 384 393 437 441 533 545 563 580 630 675 712 727 728 801 805 825 876 897 911 917 947 977 980 1009 1064 1067 1077 1084 
121 203 249 273 293 317 318 337 346 409 424 425 444 448 481 485 489 498 499 534 547 548 571 632 643 644 647 651 684 722 768 774 787 790 808 828 836 850 877 885 892 895 907 969 1014 1033 1083 
40 51 55 89 150 202 223 281 415 463 470 472 517 522 566 567 575 602 614 646 671 682 719 743 758 764 779 794 796 812 840 843 878 891 901 912 920 950 1018 1027 1041 
66 67 79 81 111 132 136 137 169 201 241 325 383 465 467 495 542 543 550 612 635 695 707 708 752 759 799 807 821 918 935 938 982 1016 1040 1068 
6 27 108 114 133 177 200 204 219 289 407 426 446 519 599 652 676 677 687 716 762 782 786 841 842 879 880 893 923 939 946 1000 1023 1039 1058 
28 52 140 172 194 224 294 295 298 342 353 360 377 403 435 445 592 623 654 678 681 757 887 889 890 966 981 996 1001 1013 1028 1029 1046 
49 65 85 91 176 234 238 251 252 253 356 357 367 372 447 451 526 537 538 589 616 723 724 746 858 863 875 926 948 956 1012 1057 
37 95 122 157 158 168 183 193 292 305 332 443 502 503 556 590 608 624 626 656 817 852 855 927 974 988 1030 1052 1070 1079 
44 50 78 101 107 143 242 243 246 300 316 370 382 394 419 423 455 479 618 622 657 706 770 791 823 925 993 1038 
7 93 212 235 245 254 398 399 418 484 636 696 738 745 788 797 818 853 870 884 886 972 995 1036 1050 1076 
8 30 60 76 146 258 302 315 333 525 573 581 639 731 732 753 766 783 810 811 831 904 913 1053 1072 
36 45 63 70 71 90 105 110 112 113 117 124 474 477 478 513 628 685 832 929 1048 1049 1051 1056 1081 
196 197 199 214 229 257 265 277 328 335 362 430 627 800 856 864 959 971 1078 
82 83 134 152 155 263 361 413 414 464 539 804 846 949 1025 1054 
106 123 255 417 483 529 544 564 655 830 866 945 968 997 1032 1047 
322 323 473 600 601 645 826 847 848 854 857 902 903 954 987 1073 
345 381 552 553 574 588 598 603 705 713 721 1019 1034 1062 
62 138 217 230 475 653 672 704 922 973 1035 
233 683 803 833 868 869 871 921 1007 1031 
275 429 512 587 688 689 775 943 1074 
649 650 673 674 714 792 798 872 1011 
248 260 267 385 392 492 501 613 
213 457 735 736 795 819 900 
191 192 405 518 648 
331 456 557 
