12 132 159 160 164 173 180 209 223 236 271 286 298 305 308 334 338 347 348 395 433 439 466 467 470 485 486 493 506 512 515 530 534 556 601 622 629 646 647 664 669 682 709 716 727 728 729 753 788 807 825 854 896 897 937 985 998 1007 1022 1059 1060 1071 1074 
101 111 112 117 169 181 207 210 215 275 276 285 289 312 340 366 369 370 376 406 414 446 460 463 464 517 527 528 546 554 568 573 599 610 612 617 628 631 633 636 651 660 665 668 693 707 712 719 720 725 772 776 814 820 828 849 876 911 929 944 1001 1037 1081 
5 20 44 45 46 54 78 148 192 377 424 425 474 483 484 514 549 553 606 607 616 648 670 681 782 797 837 840 866 880 891 892 916 936 943 996 1054 1076 
23 68 69 91 108 109 115 120 131 157 188 195 216 235 290 404 482 585 596 609 637 703 778 832 869 882 899 952 954 980 1005 1006 1049 1080 
238 296 299 303 322 323 374 400 442 491 520 524 581 582 597 751 752 795 799 902 903 912 1073 
0 11 62 63 87 105 113 165 174 251 252 327 339 373 397 423 434 569 754 804 1021 1048 
92 97 121 143 149 155 185 190 198 254 263 419 432 495 539 605 886 979 982 1025 1040 
179 253 359 363 427 469 551 558 559 618 621 644 659 692 746 747 858 966 970 992 
53 104 151 297 431 457 487 516 626 652 691 726 741 742 833 921 997 1030 1070 
15 42 43 49 51 76 77 156 187 227 278 394 447 526 537 913 1027 1072 
84 85 96 133 309 342 619 620 706 737 750 770 780 879 887 993 1026 1042 
93 125 200 245 280 562 600 645 744 787 817 870 885 935 988 1003 1033 1039 
52 186 222 267 375 393 454 473 508 509 634 708 779 890 908 919 975 
75 94 353 445 649 673 674 714 792 798 852 855 872 923 925 1013 1075 
98 287 295 372 403 426 650 676 813 838 875 931 934 948 956 1023 1057 
13 35 36 38 72 82 95 152 475 565 576 680 906 1015 1024 1051 
66 166 182 205 231 250 317 346 356 386 402 572 777 812 918 1063 
2 7 10 21 50 144 211 358 472 540 541 615 755 1038 1055 
4 141 146 525 577 666 667 671 760 949 951 953 1008 1020 1053 
61 124 134 234 259 337 361 365 438 476 511 640 785 835 969 
67 130 242 243 255 408 465 494 591 595 839 862 938 940 964 
40 218 237 270 300 318 388 412 538 589 789 796 800 863 
58 79 86 233 241 291 294 471 566 567 683 889 924 1041 
199 214 257 265 277 381 430 552 574 603 705 713 721 
22 24 29 32 34 47 119 310 690 806 888 905 
3 6 39 60 239 331 455 456 557 732 763 
26 73 189 258 313 319 330 354 544 827 1056 
88 103 177 219 561 677 773 802 960 965 1058 
106 107 122 123 382 389 421 791 860 861 1052 
158 168 193 292 332 443 502 503 592 868 1079 
18 48 325 477 478 498 529 655 871 
19 55 56 57 64 226 240 266 364 
302 333 418 593 602 635 701 734 1050 
324 336 368 371 407 663 826 1004 1031 
30 31 142 273 590 611 783 1065 
74 136 542 550 694 695 1010 1068 
129 163 260 390 641 642 662 765 
145 479 480 679 700 845 883 932 
150 196 500 504 672 731 984 1002 
206 351 490 560 702 748 874 957 
217 232 385 451 492 643 815 1035 
221 391 450 575 738 774 836 1011 
14 71 118 630 853 968 1032 
16 384 437 623 675 818 900 
70 110 153 244 282 413 873 
140 197 588 757 824 922 959 
162 398 586 594 686 775 933 
281 284 314 344 420 884 1018 
1 25 41 429 781 994 
9 139 171 625 910 1017 
17 33 274 555 764 909 
170 228 657 658 710 730 
247 496 532 841 930 958 
249 293 311 831 895 939 
256 461 497 536 578 898 
349 350 401 417 422 749 
441 570 580 583 722 1084 
452 459 462 767 769 809 
468 638 685 711 723 822 
8 65 360 513 976 
83 352 362 656 987 
114 735 736 842 1000 
116 272 521 793 808 
167 571 850 1067 1077 
246 315 405 416 803 
448 489 632 768 1083 
458 584 865 999 1069 
28 37 80 624 
100 399 699 881 
135 147 519 1082 
176 843 851 859 
184 563 821 1064 
201 304 383 759 
204 499 661 963 
220 715 1034 1062 
229 230 856 971 
261 428 505 761 
269 608 823 1043 
326 343 816 867 
345 411 598 1019 
415 819 927 928 
453 535 579 834 
59 396 967 
89 758 950 
90 268 724 
102 283 392 
154 288 409 
161 316 378 
175 208 279 
203 653 654 
320 321 829 
328 523 1078 
341 410 983 
357 784 986 
367 877 1014 
379 639 878 
380 449 805 
387 972 978 
481 756 907 
488 587 689 
531 533 745 
543 545 857 
604 1028 1029 
614 847 848 
698 739 740 
717 718 801 
766 810 811 
941 942 1061 
946 947 977 
990 991 1066 
