5 20 35 38 39 48 72 97 98 120 141 270 304 326 391 449 466 546 565 577 610 611 631 659 820 867 906 953 955 1024 1065 
46 53 54 103 104 151 209 236 301 308 343 344 369 516 524 568 569 614 664 725 726 743 751 796 816 963 1059 
2 196 199 214 248 257 265 272 277 340 362 428 430 433 434 460 486 521 541 559 663 709 754 800 
0 1 3 9 10 11 14 15 19 22 29 32 34 47 119 352 373 605 690 806 905 979 994 
218 221 359 364 454 496 527 558 561 615 617 668 701 727 728 747 748 765 776 930 960 970 1055 
142 186 266 269 412 469 476 493 511 515 551 621 634 640 669 733 779 784 793 794 919 986 
109 114 116 133 216 239 289 290 388 436 482 535 579 596 609 703 763 778 879 939 1080 
189 283 296 303 319 330 354 376 386 402 442 468 490 491 597 604 638 711 822 827 835 
86 228 291 341 393 411 415 463 470 471 517 533 575 646 671 719 843 849 878 
73 188 313 345 350 367 368 378 379 404 497 586 606 607 670 744 1003 1004 
122 157 158 168 183 193 292 305 332 443 590 608 626 656 927 1030 1052 1070 
80 102 118 180 226 375 387 400 440 461 666 760 844 908 975 978 1008 
94 145 187 232 276 278 406 427 531 692 814 883 924 932 937 1037 1075 
167 190 212 502 503 556 625 675 817 852 855 870 974 988 1067 1077 1079 
42 51 338 431 448 489 583 632 722 768 808 838 874 1027 1083 
96 126 128 147 161 166 181 184 250 261 311 876 947 977 1064 
206 210 298 351 366 435 560 576 592 641 702 957 981 1016 1017 
159 171 172 224 309 310 437 504 549 623 629 737 916 1002 
21 148 312 545 643 644 712 774 787 877 885 911 1033 
43 77 165 173 230 247 251 488 532 717 718 1022 
44 49 65 107 238 252 382 447 451 520 526 785 
75 286 339 416 452 459 509 595 619 620 1043 1071 
71 483 529 830 945 968 997 1015 1026 1032 1042 
234 268 538 589 723 724 730 863 948 956 1057 
245 484 636 696 738 745 773 788 845 972 1036 
540 570 680 832 865 910 931 964 999 1006 1049 
7 93 254 418 797 853 884 995 1050 1076 
33 163 380 514 530 642 755 936 985 998 
55 57 164 240 347 348 408 661 862 1060 
233 683 803 833 868 869 871 921 1007 1031 
381 552 553 574 598 603 705 713 721 1019 
16 17 23 26 195 211 237 789 882 
27 108 200 204 219 677 687 691 1039 
52 377 616 681 757 890 996 1028 1029 
273 299 317 318 498 499 534 571 850 
465 467 707 752 799 807 918 935 938 
68 69 182 215 421 777 860 861 
78 455 456 706 770 791 971 993 
125 150 185 198 566 567 912 1041 
131 207 259 462 767 769 899 1005 
28 140 342 360 654 887 1001 
66 67 79 81 132 241 708 
70 90 105 110 113 117 1048 
89 223 682 840 891 929 1081 
111 169 495 505 612 982 1040 
202 203 249 281 895 920 1018 
220 578 715 741 742 898 967 
280 284 293 314 355 420 892 
322 323 847 848 902 903 1073 
327 424 425 444 485 651 828 
649 650 673 714 792 798 872 
50 101 246 370 622 1038 
56 84 582 637 780 824 
58 294 295 403 584 1069 
59 271 363 593 734 992 
62 217 653 704 922 1035 
76 258 315 753 913 1072 
136 137 201 325 383 635 
154 244 282 329 450 591 
156 227 349 401 749 750 
177 407 446 652 786 1058 
253 288 494 839 928 940 
353 445 772 889 984 1013 
389 395 554 944 976 1021 
519 599 716 782 923 946 
25 41 222 685 781 
30 333 759 783 904 
36 45 63 474 1051 
40 472 522 602 950 
60 573 731 732 831 
88 135 506 660 1082 
121 481 548 756 907 
129 130 144 390 697 
191 192 405 518 648 
205 458 528 837 1063 
324 331 336 371 557 
337 647 790 836 969 
384 580 630 801 1084 
422 667 951 952 1020 
512 587 775 943 1074 
762 841 842 893 1000 
4 146 525 1053 
37 95 285 624 
64 231 633 665 
74 85 537 1010 
83 263 539 1025 
143 419 618 657 
179 297 374 508 
242 243 316 394 
255 256 544 1047 
260 267 392 501 
300 423 823 925 
302 479 480 679 
356 357 926 1012 
358 410 894 983 
413 414 949 1054 
426 676 813 1023 
432 439 720 933 
473 826 857 954 
477 478 513 1056 
572 594 686 934 
639 766 810 811 
735 736 819 900 
12 334 896 
13 688 689 
61 758 901 
87 658 710 
91 746 858 
100 178 264 
112 124 628 
115 287 438 
123 417 866 
149 699 771 
160 825 897 
170 700 980 
174 335 856 
176 372 875 
213 457 795 
229 328 1078 
274 764 812 
320 321 829 
397 562 809 
398 399 818 
453 487 834 
492 613 815 
542 543 550 
555 761 888 
563 564 821 
588 1034 1062 
600 987 1014 
601 645 854 
694 695 1068 
698 739 740 
941 942 1061 
990 991 1066 
