55 56 64 218 219 251 327 347 348 363 364 369 374 375 382 393 395 397 400 406 415 427 428 431 433 434 438 439 447 450 451 454 459 460 461 462 464 466 467 469 470 471 472 476 485 486 492 493 494 501 505 508 509 510 511 515 517 519 521 522 527 528 530 531 532 534 537 540 551 554 555 556 558 559 561 568 573 575 582 595 612 617 618 621 622 628 633 636 640 646 647 651 659 660 665 668 669 682 693 697 698 701 706 707 709 712 719 720 725 727 728 733 746 747 748 753 755 756 765 776 779 781 785 786 787 790 803 814 815 821 823 824 825 826 839 843 849 864 878 896 911 937 968 969 970 972 982 992 993 1021 1037 1039 1060 
68 69 108 109 114 115 116 127 131 136 137 201 215 216 234 235 289 290 304 325 334 337 338 359 360 365 380 388 421 422 429 482 506 535 579 585 596 634 637 703 704 716 729 763 777 778 788 812 834 857 863 899 950 954 978 980 996 998 1005 1028 1029 1036 1080 
38 45 46 60 72 75 82 83 92 93 97 120 121 125 143 147 148 149 150 155 170 185 190 198 204 205 253 254 263 269 270 315 329 341 350 384 391 401 412 417 419 432 441 661 820 832 836 881 925 926 933 956 966 981 984 1009 1011 1013 1016 1043 1049 1063 
188 189 208 258 259 266 283 296 303 313 319 330 345 354 361 376 386 396 402 404 442 445 468 477 481 490 491 520 524 544 581 597 604 638 662 678 685 711 714 730 783 795 822 827 835 884 907 983 1056 
0 1 2 3 4 5 6 7 9 10 12 13 14 15 21 22 25 29 41 44 50 52 193 352 368 426 545 652 782 902 903 906 917 960 973 994 1004 1038 1051 1073 
133 134 194 195 196 197 199 214 239 240 246 248 257 265 272 273 276 277 300 312 328 362 381 430 440 572 627 800 918 999 1010 1078 
58 59 76 77 86 118 135 145 146 162 167 217 221 233 267 268 274 275 291 385 392 411 608 643 644 784 860 861 1067 1077 1082 
39 40 61 88 89 96 124 126 128 161 166 176 177 181 184 228 250 261 311 514 565 645 671 749 805 862 879 939 949 1064 
317 318 322 323 484 498 499 529 570 571 583 632 680 722 757 758 762 801 802 840 846 850 901 920 931 940 963 1006 1046 
27 28 37 80 159 160 168 180 271 286 308 398 399 541 600 624 655 664 858 871 886 916 1001 1059 1071 
62 63 71 87 90 105 110 113 163 165 173 252 305 423 475 569 642 694 922 1022 1048 
42 43 49 51 65 156 200 237 238 504 538 539 770 819 865 971 1025 1027 
70 157 158 280 281 292 293 332 420 443 696 838 852 855 868 869 1018 1031 
294 295 353 372 403 435 518 584 656 681 735 736 774 875 987 1000 1024 1069 
8 11 18 19 24 32 34 47 119 373 609 690 806 859 905 1034 1062 
171 172 224 342 377 436 437 623 689 780 813 877 887 891 904 1014 
301 302 333 418 512 580 593 625 630 639 675 818 900 1050 1074 1084 
73 479 480 679 699 700 738 771 773 810 811 845 883 932 936 
335 424 425 448 449 489 663 734 768 808 856 873 986 1007 1083 
457 458 533 542 543 550 649 650 673 674 792 798 872 948 1057 
141 142 182 473 474 500 605 715 741 742 953 959 967 979 
229 230 247 378 379 672 708 731 732 809 831 880 965 975 
101 102 186 187 222 231 232 278 414 444 546 599 828 
151 152 227 324 331 336 358 371 688 830 927 928 945 
314 367 497 615 616 723 724 837 874 892 910 1054 1055 
35 36 48 98 140 463 577 631 769 804 976 1035 
53 54 78 103 104 209 236 284 297 387 866 943 
117 206 207 351 366 560 576 702 772 908 957 1015 
452 453 487 488 496 507 516 626 726 944 1030 1070 
16 17 20 23 26 33 211 789 882 951 952 
202 203 210 223 249 455 456 557 653 654 895 
212 213 657 658 686 687 710 842 870 934 935 
566 567 833 888 889 919 921 924 997 1041 
598 744 797 853 885 995 1019 1032 1033 1076 
66 67 79 81 132 241 683 955 
242 243 407 408 446 465 591 964 
309 310 549 629 737 876 1026 1042 
552 553 574 588 603 705 713 721 
30 31 610 611 670 759 1065 
74 84 85 91 220 1012 1079 
106 107 122 123 389 890 1052 
111 112 169 343 344 370 816 
129 130 144 260 390 523 938 
138 139 262 326 847 848 867 
339 340 619 620 750 754 958 
94 95 183 285 851 1075 
99 100 164 178 179 264 
153 154 244 245 282 413 
383 495 562 602 635 1040 
606 607 648 817 974 988 
666 667 760 844 1008 1020 
191 192 405 416 909 
717 718 764 929 1081 
287 288 346 409 
298 299 761 1017 
355 739 740 1058 
356 357 410 691 
394 525 526 1053 
586 587 594 775 
589 590 695 1068 
751 752 799 807 
923 946 947 977 
174 578 743 
255 256 536 
316 349 791 
320 321 829 
478 513 641 
502 503 592 
547 548 684 
563 564 1047 
601 854 985 
613 614 692 
676 677 1023 
912 913 1072 
941 942 1061 
961 962 989 
990 991 1066 
