55 56 64 218 219 251 327 347 348 363 364 369 374 375 382 393 395 397 400 406 415 427 428 431 433 434 438 439 447 450 451 454 459 460 461 462 464 466 467 469 470 471 472 476 485 486 492 493 494 501 505 508 509 510 511 515 517 519 521 522 527 528 530 531 532 534 537 540 551 554 555 556 558 559 561 568 573 575 582 595 612 617 618 621 622 628 633 636 640 646 647 651 659 660 665 668 669 682 693 697 698 701 706 707 709 712 716 719 720 725 727 728 733 746 747 748 753 755 756 765 776 779 781 785 786 787 790 803 814 815 821 823 824 825 826 839 843 849 860 861 864 878 896 911 937 968 969 970 972 982 992 993 1021 1037 1039 1060 
68 69 108 109 114 115 116 127 131 136 137 201 215 216 234 235 289 290 304 325 334 337 338 359 360 365 380 388 421 422 429 482 506 513 535 579 585 596 634 637 703 704 729 763 777 778 788 812 834 857 899 950 954 978 980 996 998 1005 1028 1029 1036 1080 
188 189 258 259 266 283 296 303 313 319 330 345 354 361 376 386 396 402 404 442 445 468 477 481 490 491 520 524 544 581 597 604 638 662 678 685 711 714 730 783 795 822 827 835 884 907 983 1056 
0 1 2 3 4 5 6 7 9 10 12 13 15 21 22 25 34 41 44 50 52 193 352 368 426 545 652 782 902 903 906 917 960 973 994 1004 1038 1051 1073 
70 280 281 293 317 318 322 323 420 484 498 499 529 570 571 583 632 680 696 722 757 758 762 838 840 846 852 855 868 901 920 931 940 1006 1018 
16 17 20 23 26 27 28 33 37 80 159 160 180 211 271 286 308 398 399 541 600 624 664 789 858 882 886 916 951 952 1001 1059 1071 
133 134 194 195 196 197 199 214 239 240 246 248 257 265 272 273 276 277 300 312 328 362 381 430 440 572 627 800 918 999 1010 1078 
39 40 61 88 89 96 124 126 128 161 166 176 177 181 184 228 250 261 311 514 565 645 671 749 805 862 879 939 949 1064 
58 59 76 77 86 118 135 145 146 162 167 217 221 233 267 268 274 275 291 385 392 411 608 643 644 784 967 1067 1077 1082 
45 46 82 83 92 93 97 120 121 125 143 155 190 253 254 263 341 350 384 401 417 419 432 820 832 836 926 933 1049 
552 553 574 588 598 603 606 607 648 705 713 721 744 797 817 853 885 974 988 995 1019 1032 1033 1076 
62 63 71 87 90 105 110 113 163 165 173 174 252 305 423 475 569 642 922 1022 1048 
35 36 38 48 98 140 414 444 463 546 577 589 599 631 769 804 828 976 1009 
8 11 14 18 19 24 29 32 47 119 373 609 690 806 859 905 1034 1062 
147 148 149 150 170 185 198 204 205 441 881 925 966 984 1013 1043 1063 
294 295 353 372 403 435 584 656 681 735 736 774 875 987 1000 1024 1069 
60 72 75 269 270 315 329 391 412 590 661 863 956 981 1011 1016 
171 172 224 342 377 436 437 623 689 780 813 877 887 891 904 1014 
117 206 207 351 366 479 560 576 702 772 810 811 908 957 1015 
229 230 247 378 379 639 672 708 731 732 809 831 880 965 975 
301 302 333 418 512 580 593 625 630 675 818 900 1050 1074 1084 
335 424 425 448 449 489 663 734 768 808 856 873 986 1007 1083 
457 458 533 543 649 650 673 674 792 798 872 929 948 1057 1081 
314 367 497 615 616 723 724 837 874 892 910 1017 1054 1055 
53 54 78 103 104 209 236 284 297 387 866 943 
73 480 679 699 700 738 771 773 845 883 932 936 
452 453 487 488 496 507 516 626 726 944 1030 1070 
566 567 741 742 833 888 889 919 921 924 997 1041 
42 43 49 51 65 156 200 504 819 865 1027 
141 142 182 473 474 500 605 715 953 959 979 
212 213 657 658 686 687 710 842 870 934 935 
191 192 287 288 346 405 409 416 518 909 
101 102 186 187 222 231 232 278 1035 
111 112 169 343 344 370 793 794 816 
66 67 79 81 132 241 683 955 
151 152 227 324 331 336 358 371 
242 243 407 408 446 465 591 964 
309 310 549 629 737 876 1026 1042 
30 31 610 611 670 759 1065 
74 175 208 279 694 695 1068 
106 107 122 123 389 890 1052 
129 130 144 260 390 523 938 
138 139 262 326 847 848 867 
157 158 292 332 443 869 1031 
237 238 538 539 770 971 1025 
339 340 619 620 750 754 958 
912 913 923 946 947 977 1072 
84 85 91 220 1012 1079 
94 95 183 285 851 1075 
99 100 164 178 179 264 
153 154 244 245 282 413 
202 203 210 223 249 895 
383 495 562 602 635 1040 
666 667 760 844 1008 1020 
801 802 963 1046 1058 
168 655 850 871 
226 927 928 945 
356 357 410 691 
394 525 526 1053 
586 587 594 775 
751 752 799 807 
298 299 761 
316 349 791 
320 321 829 
355 739 740 
455 456 557 
502 503 592 
547 548 684 
563 564 1047 
601 854 985 
613 614 692 
676 677 1023 
717 718 764 
941 942 1061 
961 962 989 
990 991 1066 
