73 74 175 188 189 208 279 280 283 284 296 303 313 314 319 330 345 350 354 355 368 376 378 379 386 396 402 404 420 442 468 490 491 586 597 604 606 607 638 662 670 694 711 744 813 822 827 835 1003 1004 1010 
5 16 17 20 23 26 33 35 38 39 48 72 97 98 141 211 237 270 304 326 449 466 527 530 546 565 577 610 611 631 789 820 867 906 953 955 985 998 1024 1065 
0 1 2 3 4 10 11 12 13 14 15 19 21 22 25 29 32 34 47 119 163 165 352 373 488 605 641 642 690 781 806 905 979 994 
58 59 86 142 162 186 221 232 269 291 365 393 411 412 471 476 493 511 515 531 533 551 621 634 640 727 728 784 793 919 986 
53 54 103 104 151 209 236 276 301 308 343 344 369 427 434 516 524 568 569 664 692 725 726 751 816 963 1037 1059 
92 120 125 148 149 167 170 185 190 198 312 419 545 712 774 787 870 877 885 911 917 980 1014 1033 1067 1077 
66 67 79 81 111 132 169 241 467 495 612 707 708 752 799 807 821 935 982 1040 
99 510 558 559 617 633 668 669 693 698 733 739 740 747 748 756 814 970 
68 69 109 116 216 239 290 388 421 482 535 579 585 763 777 778 1080 
80 102 118 180 225 226 375 387 400 440 461 497 666 760 844 978 1008 
202 281 463 470 517 575 646 671 719 764 779 812 843 878 1018 
218 266 359 364 454 561 615 701 709 734 765 776 930 960 1055 
157 158 168 193 292 332 443 502 503 608 626 1030 1070 1079 
213 233 457 683 795 803 819 833 868 869 871 921 1007 1031 
131 207 259 462 505 555 755 761 772 785 888 899 1005 
212 302 384 418 437 580 593 675 853 884 1009 1050 1084 
381 552 553 574 588 598 603 705 713 721 1019 1034 1062 
36 45 63 71 474 477 478 513 832 1049 1051 1056 
52 172 298 377 592 623 681 757 890 996 1028 1029 
75 286 339 416 452 459 509 595 619 620 1043 1071 
272 324 340 428 433 460 489 521 541 663 754 808 
196 197 199 214 257 265 277 362 430 800 959 
41 94 222 285 406 851 859 924 937 1075 
49 65 238 251 252 253 447 451 520 526 
121 317 318 346 409 481 498 499 548 907 
133 289 519 599 716 782 879 923 939 946 
154 210 288 366 408 494 839 862 928 940 
159 171 309 310 549 629 737 916 1026 1042 
245 484 636 696 738 745 771 788 972 1036 
341 358 410 432 439 720 849 894 933 983 
540 570 680 865 910 931 964 999 1006 1017 
42 46 338 431 507 583 691 838 874 
44 78 107 382 455 706 770 791 993 
56 57 64 164 327 347 348 661 1060 
96 128 161 184 250 261 311 563 1064 
234 538 589 767 769 863 948 956 1057 
273 424 425 444 485 534 571 651 828 
43 77 173 247 532 717 718 1022 
136 201 325 383 635 695 759 1068 
156 227 336 349 371 401 749 750 
174 220 578 715 741 742 898 967 
293 448 632 722 768 850 892 1083 
28 140 342 360 654 887 1001 
70 90 105 110 113 117 1048 
126 147 166 181 876 947 977 
145 480 679 699 700 883 932 
179 278 297 374 469 486 508 
206 351 560 576 702 957 1015 
229 230 328 335 856 971 1078 
322 323 847 848 902 903 1073 
483 529 830 945 968 997 1032 
649 650 673 714 792 798 872 
50 101 246 370 622 1038 
62 217 653 704 922 1035 
76 258 315 753 913 1072 
82 134 152 361 804 846 
112 124 628 685 929 1081 
114 762 841 842 893 1000 
155 413 414 464 949 1054 
177 407 446 652 786 1058 
235 254 797 886 995 1076 
389 395 554 944 976 1021 
473 601 826 854 857 954 
556 817 852 855 974 988 
8 146 525 581 1053 
88 135 506 660 1082 
122 305 590 656 1052 
129 130 144 390 697 
150 566 567 912 1041 
176 372 723 724 875 
204 219 677 687 1039 
205 458 528 837 1063 
294 295 403 584 1069 
337 647 790 836 969 
422 667 951 952 1020 
436 609 637 780 824 
512 587 775 943 1074 
27 108 200 624 
30 333 783 904 
37 95 183 927 
51 55 415 1027 
61 115 287 438 
83 263 539 1025 
87 228 658 710 
187 271 363 992 
223 682 840 891 
242 243 316 394 
260 267 385 492 
282 329 450 591 
300 423 823 925 
334 391 659 896 
353 445 889 1013 
356 357 926 1012 
453 487 496 834 
523 773 802 845 
572 594 686 934 
639 766 810 811 
24 965 975 
40 472 950 
60 573 815 
84 299 582 
89 758 901 
91 746 858 
100 178 264 
123 417 866 
127 262 703 
143 618 657 
153 244 873 
160 825 897 
182 215 596 
191 405 518 
195 240 882 
203 249 895 
224 678 966 
274 860 861 
320 321 829 
331 456 557 
380 514 936 
397 562 809 
398 399 818 
426 676 1023 
465 918 938 
504 984 1002 
542 543 550 
600 645 987 
614 743 796 
731 732 831 
735 736 900 
941 942 1061 
990 991 1066 
