116 132 159 160 164 180 209 236 246 271 272 286 308 334 347 348 359 363 395 427 439 466 467 470 485 486 493 506 512 521 530 534 551 556 558 559 601 618 622 629 644 646 647 664 669 682 692 716 727 728 729 746 793 803 807 825 854 858 896 897 937 966 985 992 998 1007 1059 1060 1071 1074 
89 101 102 111 112 117 169 207 210 215 275 276 283 289 291 340 366 369 370 414 446 460 463 464 471 517 527 528 546 554 568 573 599 612 617 628 631 633 636 651 660 665 668 693 707 719 720 776 814 815 828 849 911 944 950 1001 1037 
4 5 7 10 12 20 21 22 25 34 44 46 148 352 377 424 425 472 549 553 606 607 615 616 648 670 681 781 782 797 837 840 866 880 891 892 902 903 916 943 994 996 1054 1055 1073 1076 
24 29 32 47 84 85 96 119 133 220 309 310 342 479 480 619 620 679 690 706 737 750 770 780 806 879 887 888 905 939 993 1026 1034 1042 1062 
108 109 114 115 128 131 157 188 216 290 294 404 436 482 535 585 596 609 703 735 736 778 832 842 869 899 1000 1005 1006 1049 1080 
0 11 62 63 87 105 110 113 165 173 174 251 252 253 305 315 327 339 373 397 423 433 434 469 569 753 754 1021 1022 1048 
53 54 104 151 152 248 297 324 336 371 407 431 457 487 516 626 652 663 691 726 741 742 826 833 921 997 1030 1031 1070 
15 42 43 49 51 76 77 156 187 222 227 261 278 394 406 428 447 526 537 538 709 747 913 970 1027 1072 
61 68 69 124 234 235 259 298 337 338 361 365 438 476 511 515 640 785 788 808 835 969 
92 97 121 143 149 155 185 190 198 254 263 419 432 495 539 605 886 979 982 983 1025 1040 
93 125 200 426 562 600 645 676 744 787 813 817 870 885 904 935 974 988 1003 1023 1033 1039 
3 6 35 36 38 39 60 72 95 239 331 455 456 475 557 732 763 767 769 1051 
23 91 120 134 194 195 199 214 257 265 277 362 430 637 800 882 952 954 980 1046 
238 296 299 303 322 323 374 400 442 491 520 524 581 582 597 751 752 795 799 912 
52 186 266 375 454 473 508 509 621 634 708 779 890 908 919 975 
66 182 205 231 250 317 356 386 402 572 777 812 918 1063 
141 146 525 577 666 667 671 758 760 951 953 1008 1020 1053 
19 55 56 57 64 226 240 364 458 584 865 999 1069 
26 73 189 258 313 319 330 354 544 827 1056 
58 86 217 232 267 385 451 492 613 643 1035 
67 130 242 243 255 408 465 595 862 938 964 
106 107 122 123 382 389 421 791 860 861 1052 
158 168 193 292 332 443 502 503 592 868 1079 
1 2 41 50 211 429 540 541 755 1038 
75 94 649 673 674 714 792 798 872 1075 
206 351 490 560 702 748 771 874 957 1036 
103 177 219 561 773 802 960 965 1058 
129 163 208 260 390 641 642 662 765 
221 391 450 575 738 774 836 845 1011 
247 496 532 717 718 801 841 930 958 
302 333 418 593 602 635 701 734 1050 
17 33 274 505 555 761 764 909 
74 136 542 550 694 695 1010 1068 
79 233 241 393 533 683 889 924 
98 295 372 403 838 875 931 934 
150 196 500 504 672 731 984 1002 
153 154 244 245 282 413 873 949 
162 392 398 586 594 686 775 933 
353 445 852 855 923 925 946 1013 
441 498 570 580 583 722 762 1084 
14 71 118 630 853 1015 1032 
16 384 437 623 675 818 900 
88 166 311 474 514 677 936 
140 197 588 757 824 922 959 
147 167 571 772 850 1067 1077 
170 228 280 657 658 710 730 
191 192 346 405 409 416 518 
281 284 314 344 420 884 1018 
288 341 410 415 819 927 928 
381 552 574 603 705 713 721 
9 139 171 625 910 1017 
18 48 325 477 478 529 
30 31 273 611 783 1065 
40 237 270 388 412 789 
82 565 576 680 906 1024 
135 519 566 567 1041 1082 
145 531 700 745 883 932 
224 494 591 678 839 940 
349 350 401 417 422 749 
468 638 685 711 723 822 
8 65 360 513 976 
70 249 293 831 895 
179 218 300 589 659 
181 285 876 947 977 
287 650 948 956 1057 
367 368 877 1004 1014 
448 489 632 768 1083 
481 547 548 756 907 
610 725 820 929 1081 
28 37 80 624 
99 178 264 510 
100 453 579 834 
176 843 851 859 
184 563 821 1064 
201 304 383 759 
202 203 223 973 
204 499 661 963 
229 230 856 971 
269 608 823 1043 
326 343 816 867 
345 411 598 1019 
452 459 462 809 
461 497 578 898 
483 484 655 871 
688 830 945 968 
83 656 987 
90 268 724 
161 316 378 
225 256 536 
312 376 712 
320 321 829 
328 523 1078 
335 743 796 
357 784 986 
379 639 878 
380 449 805 
387 972 978 
399 699 881 
543 545 857 
604 1028 1029 
614 847 848 
698 739 740 
766 810 811 
941 942 1061 
990 991 1066 
