0 11 61 62 63 68 69 87 116 124 132 159 160 164 165 173 174 179 180 209 234 235 236 246 251 252 253 259 271 272 286 298 305 308 315 327 337 338 339 347 348 359 361 363 365 373 395 397 405 416 423 427 433 434 438 439 466 467 469 470 476 485 486 493 501 506 511 512 515 521 530 534 551 556 558 569 601 618 622 629 640 644 646 647 659 664 669 682 692 709 716 727 728 729 746 753 785 788 803 804 807 808 825 844 846 854 858 897 937 966 969 985 992 998 1007 1021 1022 1059 1060 1071 1074 
52 59 79 86 99 106 107 122 123 135 145 147 167 178 186 217 221 222 232 233 241 264 267 291 328 345 375 382 385 389 391 393 396 406 411 421 450 451 452 454 459 462 471 473 479 480 492 508 509 510 519 523 531 533 559 566 567 571 575 598 610 634 643 679 683 698 700 708 725 738 739 740 745 747 766 772 774 779 791 809 810 811 815 820 836 845 850 860 861 883 889 890 908 919 924 929 932 967 970 975 1011 1019 1035 1041 1052 1067 1077 1078 1081 1082 
1 2 5 7 10 12 20 21 25 41 44 45 46 50 53 54 78 88 103 104 144 148 151 166 177 192 211 219 247 297 334 358 377 399 424 425 426 429 472 474 483 484 496 514 516 532 540 541 549 553 561 591 606 607 615 616 648 670 676 677 681 699 717 718 755 773 781 782 797 801 802 837 840 841 866 880 881 891 892 896 916 930 936 943 958 960 965 990 991 994 996 1023 1038 1054 1055 1058 1066 1076 
89 101 102 111 112 117 162 169 176 181 207 210 215 275 276 283 285 289 312 320 321 340 366 369 370 376 387 392 398 414 446 460 463 464 494 517 527 528 546 554 568 573 586 594 599 612 617 628 631 633 636 651 660 665 668 686 693 707 712 719 720 754 775 776 814 828 829 839 843 849 851 859 876 911 933 940 941 942 944 947 950 972 977 978 1001 1037 1061 
26 73 75 91 94 108 109 115 120 127 131 134 157 188 189 194 195 199 214 216 239 257 258 265 277 290 313 319 330 353 354 380 404 430 445 449 482 507 544 585 596 609 627 637 649 673 674 703 704 714 763 778 790 792 798 800 805 827 832 835 852 855 864 869 872 882 899 923 925 946 954 980 1005 1006 1013 1046 1049 1056 1075 1080 
92 93 97 121 125 143 149 155 170 185 190 198 200 204 212 213 228 254 263 280 341 410 415 419 432 495 499 539 562 600 605 645 657 658 661 710 730 744 787 813 817 819 870 885 886 893 894 904 927 928 935 963 974 979 982 983 988 1003 1025 1033 1039 1040 
40 74 90 126 136 158 168 193 218 237 268 270 292 300 318 329 332 335 388 412 441 443 448 489 498 502 503 538 542 550 570 580 583 589 592 614 632 655 687 694 695 722 724 743 762 768 789 796 847 848 863 868 871 955 1010 1068 1079 1083 1084 
16 17 30 31 33 142 238 261 273 274 296 299 303 322 323 374 384 400 428 437 442 491 505 520 524 555 581 582 590 597 611 623 675 751 752 761 764 783 794 795 799 818 900 902 903 909 912 920 1065 1073 
3 6 13 35 36 38 39 60 72 82 95 152 184 269 331 349 350 401 417 422 455 456 475 557 563 564 565 576 608 680 732 749 767 769 821 823 906 1015 1024 1043 1047 1051 1064 
22 24 29 32 34 47 84 85 96 119 133 183 203 220 223 224 309 310 342 522 619 620 653 654 678 690 706 715 737 750 770 780 806 879 887 888 905 939 993 1026 1034 1042 1062 
67 83 129 130 150 163 175 196 208 225 242 243 255 256 260 279 390 408 461 465 497 500 504 536 578 595 641 642 656 662 672 765 862 898 926 938 964 984 987 1002 1012 
4 9 23 27 28 37 80 139 141 146 171 262 302 333 418 444 525 577 593 602 624 625 635 666 667 671 701 734 758 760 786 910 951 952 953 1008 1017 1020 1050 1053 
18 48 140 197 325 326 343 381 477 478 487 488 529 552 574 587 588 603 626 684 689 705 713 721 726 757 816 824 867 901 917 922 959 1009 1030 1070 
14 71 98 118 191 287 295 372 403 435 518 630 650 696 697 838 853 875 931 934 948 956 981 1032 1057 
248 324 367 368 407 431 457 613 652 663 688 691 741 742 826 830 833 877 921 945 968 997 1004 1014 1031 
138 202 249 281 284 293 311 314 344 355 420 468 638 685 711 723 731 822 831 884 895 973 1018 
15 42 43 49 51 76 77 156 187 227 278 336 371 394 447 526 537 913 1027 1072 
66 182 205 229 230 231 250 317 346 356 386 402 572 777 812 856 918 971 1063 
70 105 110 113 153 154 244 245 282 288 357 409 413 784 793 873 949 986 1048 
19 55 56 57 64 226 240 266 364 458 584 621 865 999 1069 
172 206 351 490 560 702 733 748 771 874 957 1036 
81 161 301 316 378 379 543 545 639 857 878 
100 137 201 304 383 453 535 579 759 834 1016 
58 114 128 294 436 735 736 842 1000 
8 65 360 440 513 976 995 
481 547 548 756 907 
604 1028 1029 
