0 11 62 63 87 105 110 113 116 124 132 134 159 160 164 165 173 174 180 209 234 236 246 251 252 253 259 271 272 286 298 305 308 315 327 337 338 339 347 348 359 361 363 365 373 395 397 423 427 433 434 439 466 467 469 470 476 485 486 493 501 506 511 512 515 521 530 534 551 556 558 569 592 601 618 622 629 640 644 646 647 664 669 682 692 716 727 728 729 746 753 754 767 769 785 788 793 803 804 807 808 825 844 854 858 897 916 937 969 985 992 998 1007 1021 1022 1048 1059 1060 1071 1074 
15 42 43 49 51 52 58 76 77 79 86 99 106 107 122 123 135 145 156 178 179 186 187 217 222 227 232 233 241 261 264 266 267 278 328 357 375 382 385 389 393 394 406 421 428 447 450 451 452 454 459 462 473 480 492 508 509 510 519 526 531 533 537 559 566 567 591 610 613 621 634 643 659 683 698 700 708 709 725 739 740 747 779 784 791 809 815 820 845 860 861 883 889 890 908 919 924 929 932 970 975 986 1027 1035 1041 1052 1078 1081 1082 
14 71 82 92 93 98 118 121 125 143 149 152 155 170 185 190 191 192 198 200 204 212 213 228 254 263 280 287 288 341 345 346 372 405 409 410 415 416 419 426 432 495 499 518 539 553 562 598 600 605 606 607 630 645 648 650 657 658 661 670 676 710 730 744 787 797 813 817 819 838 853 870 875 885 886 893 894 904 927 928 931 933 934 935 948 956 963 974 979 982 983 987 988 1003 1019 1023 1025 1033 1039 1040 1057 1076 
23 26 68 69 73 75 91 94 97 100 108 109 114 115 120 127 128 131 157 188 189 194 195 199 214 216 235 257 258 265 277 290 294 295 313 319 330 353 362 380 403 404 430 436 445 449 453 482 507 535 544 579 585 596 609 627 637 649 673 674 703 704 714 735 736 778 790 792 798 800 805 827 832 834 835 842 852 855 864 869 872 882 899 912 913 923 925 946 952 954 980 1000 1005 1006 1013 1049 1072 1075 1080 
1 2 4 5 7 10 12 20 21 22 25 34 41 44 45 46 50 78 88 103 148 166 177 184 211 219 247 311 334 352 377 399 424 425 429 472 474 496 514 523 532 540 541 549 561 563 615 616 677 681 699 717 718 755 773 781 782 801 802 821 837 840 841 866 880 881 891 892 896 902 903 930 936 943 958 960 965 990 991 994 996 1038 1054 1055 1058 1064 1066 1073 
101 102 111 112 117 162 169 176 181 207 210 215 275 276 283 285 289 291 312 320 321 340 366 369 370 376 387 392 398 414 446 460 463 464 471 494 517 528 546 554 568 573 586 594 599 612 617 628 631 633 636 651 660 665 668 686 693 707 712 719 720 775 776 814 828 829 839 843 849 851 859 876 911 940 941 942 944 947 972 977 978 1001 1037 1061 
24 29 32 40 47 84 85 96 119 126 133 183 220 237 270 309 310 318 342 388 412 479 522 538 619 620 653 654 690 706 715 737 750 766 770 780 789 806 810 811 863 879 887 888 905 939 967 993 1034 1062 
53 54 104 151 225 248 256 297 324 367 368 407 431 457 461 487 497 516 536 626 652 663 688 691 726 741 742 826 830 833 877 921 945 968 997 1004 1014 1015 1026 1030 1031 1032 1042 1070 
16 17 30 31 33 238 273 274 296 299 303 322 323 374 384 400 437 442 491 505 520 524 555 581 582 597 611 623 675 751 752 761 764 783 794 795 799 818 900 909 920 1065 
19 55 56 57 59 61 64 137 147 167 201 221 226 240 304 364 383 391 396 411 435 438 458 571 575 584 738 745 759 772 774 836 850 865 981 999 1011 1016 1067 1069 1077 
13 18 48 140 168 197 325 326 343 477 478 483 484 488 498 529 552 574 587 588 603 655 687 689 705 713 721 757 762 816 824 846 867 871 922 955 959 1046 
3 6 35 36 38 39 60 72 95 239 269 300 331 417 455 456 475 557 565 576 608 680 732 763 823 906 1024 1043 1051 
67 83 129 130 163 175 208 242 243 255 260 279 390 408 465 564 595 641 642 656 662 765 862 926 938 964 1012 1047 1079 
70 138 202 203 223 249 281 284 293 314 344 354 355 420 468 638 685 711 723 731 822 831 884 895 973 1018 1056 
9 27 28 37 80 139 171 262 302 329 333 418 444 593 602 624 625 635 679 701 734 786 910 1017 1050 
89 141 146 335 525 527 577 578 614 666 667 671 743 758 760 796 847 848 898 950 951 953 1008 1020 1053 
90 158 193 268 292 332 441 443 448 489 502 503 570 580 583 632 722 724 768 868 1083 1084 
66 182 205 229 230 231 250 317 356 386 402 572 777 812 856 918 971 1063 
81 161 301 316 378 379 542 543 545 639 857 878 
172 206 351 490 560 702 733 748 771 874 957 1036 
74 136 142 218 550 589 590 694 695 1010 1068 
481 547 548 684 756 901 907 917 1009 
153 154 244 245 282 413 873 949 
8 65 360 440 513 976 995 
150 196 500 504 672 984 1002 
144 336 358 371 696 697 
349 350 381 401 422 749 
224 678 966 
604 1028 1029 
