99 142 186 232 269 412 433 469 476 493 510 511 515 531 533 551 559 617 621 634 640 668 669 698 733 739 740 747 748 756 784 793 896 919 970 986 
5 20 35 38 39 48 72 97 98 120 141 270 304 326 449 466 546 565 577 610 611 631 820 867 906 953 955 1024 1065 
88 109 114 116 128 133 135 216 239 289 290 388 436 482 506 535 579 596 609 660 703 763 778 879 939 1080 1082 
0 1 2 3 4 9 10 11 14 15 19 22 25 29 32 34 47 119 352 373 605 690 806 905 979 994 
46 53 54 103 104 151 179 209 236 297 301 308 343 344 369 508 516 524 568 569 664 725 751 816 963 1059 
148 167 190 212 225 312 376 545 625 630 675 712 717 718 801 817 843 852 855 870 911 917 974 988 1067 1077 
43 77 154 165 173 210 230 244 247 251 282 329 366 408 446 450 488 494 532 591 726 839 1022 
86 202 228 281 291 341 393 411 415 463 470 471 517 575 646 671 719 779 849 878 1018 
189 283 296 303 319 330 354 386 402 442 468 490 491 597 604 638 711 822 827 835 
42 51 293 338 431 448 489 583 632 691 722 768 808 838 874 892 1027 1083 
122 157 158 168 183 193 292 305 332 443 590 608 626 656 927 1030 1052 1070 
80 102 118 180 226 375 387 400 440 461 666 760 844 908 975 978 1008 
131 207 259 288 462 505 555 641 702 761 767 769 888 899 928 957 1005 
73 188 280 284 313 314 345 355 404 420 586 606 607 670 744 1003 
21 84 218 359 454 527 558 561 582 615 701 765 776 960 1055 
66 111 132 169 467 495 612 707 708 752 799 807 935 982 1040 
96 126 147 161 166 181 184 250 261 311 862 876 947 977 1064 
121 273 299 317 318 346 409 481 498 499 534 548 571 850 907 
159 171 172 224 309 310 437 504 549 623 629 737 916 1002 
272 324 340 428 434 460 486 521 541 663 709 754 781 
322 323 473 601 826 847 848 854 857 902 903 954 1073 
540 570 584 680 832 865 910 931 964 999 1006 1049 1069 
44 49 65 107 238 252 382 447 451 520 526 785 
75 286 339 416 452 459 509 595 619 620 1043 1071 
37 94 95 187 285 406 851 859 924 937 1075 
245 484 636 696 738 745 773 788 845 972 1036 
33 163 380 514 530 642 755 936 985 998 
233 683 803 833 868 869 871 921 1007 1031 
234 538 589 616 723 724 863 948 956 1057 
381 552 553 574 598 603 705 713 721 1019 
483 529 830 945 968 997 1015 1026 1032 1042 
16 17 23 26 195 211 237 789 882 
55 56 57 164 240 347 348 661 1060 
196 199 214 257 265 277 362 430 800 
50 101 246 370 622 727 728 1038 
52 377 681 757 890 996 1028 1029 
70 71 90 105 110 113 117 1048 
78 455 456 706 770 791 971 993 
125 150 185 198 566 567 912 1041 
145 302 479 480 679 700 883 932 
156 227 336 349 371 401 749 750 
384 418 580 853 884 1009 1050 1084 
28 140 342 360 654 887 1001 
206 298 351 560 576 592 1017 
220 578 715 741 742 898 967 
327 424 425 444 485 651 828 
350 367 368 378 379 497 1004 
374 519 599 716 782 923 946 
643 644 774 787 877 885 1033 
649 650 673 714 792 798 872 
36 45 63 419 474 1051 
59 271 363 593 734 992 
62 217 653 704 922 1035 
76 258 315 753 913 1072 
221 253 266 364 496 930 
276 278 427 692 814 1037 
389 395 554 944 976 1021 
8 146 525 581 1053 
27 108 200 624 677 
40 472 522 602 950 
60 573 731 732 831 
92 453 487 507 834 
112 124 628 929 1081 
129 130 144 390 697 
136 137 201 325 383 
177 407 652 786 1058 
205 458 528 837 1063 
337 647 790 836 969 
422 667 951 952 1020 
492 637 780 815 824 
512 587 775 943 1074 
762 841 842 893 1000 
12 334 391 659 
61 115 287 438 
64 231 633 665 
67 79 81 241 
68 69 421 777 
74 85 537 1010 
83 263 539 1025 
89 758 901 940 
204 219 687 1039 
213 457 795 819 
223 682 840 891 
242 243 316 394 
254 797 995 1076 
260 267 392 501 
295 353 403 772 
300 423 823 925 
356 357 926 1012 
358 410 894 983 
397 562 635 809 
413 414 949 1054 
426 676 813 1023 
432 439 720 933 
445 889 984 1013 
477 478 513 1056 
502 503 556 1079 
572 594 686 934 
600 645 987 1014 
639 766 810 811 
13 688 689 
30 759 904 
41 222 685 
87 658 710 
91 746 858 
100 178 264 
123 417 866 
143 618 657 
149 699 771 
160 825 897 
174 335 856 
176 372 875 
192 405 648 
203 249 895 
229 328 1078 
255 544 1047 
274 860 861 
320 321 829 
398 399 818 
435 981 1016 
465 918 938 
542 543 550 
563 564 821 
588 1034 1062 
614 743 796 
694 695 1068 
735 736 900 
941 942 1061 
990 991 1066 
