86 99 128 228 281 291 341 393 411 415 463 470 471 476 510 517 531 558 559 575 615 617 646 668 669 671 698 719 739 740 747 748 756 779 794 843 849 878 920 970 1018 1055 
5 20 35 38 39 48 72 97 98 120 141 270 304 326 391 449 466 489 546 565 577 610 611 631 659 808 820 867 906 953 955 1024 1065 
0 1 2 3 4 9 10 11 12 13 14 15 19 21 22 25 29 32 34 47 119 352 373 605 690 781 806 905 973 979 994 
188 189 283 296 303 313 319 330 354 376 385 386 396 402 404 442 468 490 491 520 597 604 638 662 711 822 827 835 
7 93 254 384 398 399 418 419 580 630 696 738 773 797 801 818 845 853 884 995 1050 1076 1084 
199 214 248 257 265 272 277 324 334 430 433 434 460 519 521 541 663 782 800 860 861 896 923 
89 174 335 452 459 527 561 568 578 614 709 716 725 727 728 743 796 856 898 960 963 
109 114 116 133 216 239 289 290 388 436 482 535 579 596 609 703 763 778 879 1080 
142 186 269 412 493 511 515 551 621 632 634 640 733 768 784 793 850 919 986 1083 
273 317 318 327 346 353 409 424 425 444 485 498 499 534 571 651 722 772 825 828 
122 157 158 168 183 193 292 305 332 362 443 590 608 626 656 927 1030 1052 1070 
51 94 187 232 276 278 406 427 428 692 814 815 851 859 937 1027 1037 1075 
80 102 118 180 226 375 387 400 440 461 533 666 760 844 908 975 978 1008 
91 159 171 172 220 224 309 504 549 623 629 715 737 746 858 916 967 1002 
148 167 190 212 312 545 625 675 712 817 852 855 870 911 974 988 1067 1077 
234 253 366 494 538 560 589 616 723 724 767 769 839 863 940 948 956 1057 
84 218 221 251 359 364 423 454 496 582 701 726 765 776 930 
131 207 259 288 462 555 641 702 785 888 928 957 1005 
73 163 345 586 606 607 670 694 695 744 1003 1068 
75 286 339 340 416 509 595 619 620 754 1043 1071 
233 683 741 742 803 833 868 869 921 924 1007 1031 
540 570 680 832 865 910 931 964 999 1006 1017 1049 
103 209 308 343 344 369 524 664 751 816 1059 
33 129 380 514 530 642 755 936 985 998 
55 57 164 178 240 264 348 408 862 1060 
78 310 448 455 479 706 770 791 971 993 
126 147 160 166 181 876 897 946 947 977 
381 552 553 574 598 603 705 713 721 1019 
16 17 23 26 195 211 237 789 882 
43 77 165 173 230 247 488 532 1022 
52 377 681 757 871 890 996 1028 1029 
465 467 707 752 799 807 918 935 938 
44 49 65 107 238 382 447 526 
280 284 293 314 355 420 831 892 
28 140 342 360 654 887 1001 
42 46 338 431 583 838 874 
50 101 246 271 370 622 1038 
66 67 79 81 132 241 708 
70 90 105 110 113 117 1048 
111 169 495 505 612 982 1040 
125 150 185 198 566 567 1041 
179 297 347 469 486 508 661 
203 210 223 249 311 895 939 
245 484 636 745 788 972 1036 
298 351 435 592 761 981 1016 
322 323 847 848 902 903 1073 
350 367 368 378 379 497 1004 
512 587 688 689 775 943 1074 
649 650 673 714 792 798 872 
27 108 200 624 677 691 
40 451 472 522 602 950 
53 54 104 151 236 516 
56 96 202 637 780 824 
58 294 295 403 584 1069 
62 217 653 704 922 1035 
68 69 182 215 421 777 
136 137 201 325 383 550 
154 244 282 329 450 591 
156 227 349 401 749 750 
177 407 446 652 786 1058 
260 267 365 392 501 693 
389 395 554 944 976 1021 
830 945 968 997 1026 1042 
8 146 525 581 1053 
36 45 63 474 1051 
59 363 593 734 992 
74 175 208 279 1010 
82 134 152 361 804 
88 135 506 660 1082 
92 453 487 507 834 
161 184 250 261 1064 
194 252 523 802 1046 
204 219 266 687 1039 
205 458 528 837 1063 
331 336 371 456 557 
422 667 951 952 1020 
426 676 813 904 1023 
643 644 774 787 877 
682 840 891 929 1081 
762 841 842 846 893 
30 333 759 783 
60 573 731 732 
64 231 633 665 
76 258 315 753 
83 263 539 1025 
115 287 438 899 
130 144 390 697 
145 480 883 932 
192 648 885 1033 
242 243 316 394 
255 256 544 1047 
337 790 836 969 
356 357 926 1012 
358 410 894 983 
397 562 635 809 
413 414 949 1054 
432 439 720 933 
473 826 857 954 
477 478 513 1056 
502 503 556 1079 
572 594 686 934 
639 766 810 811 
735 736 819 900 
37 95 285 
41 222 685 
61 758 901 
71 483 529 
85 299 537 
87 658 710 
100 881 909 
112 124 628 
121 481 907 
123 417 866 
138 475 672 
176 372 875 
191 405 518 
206 576 1000 
213 457 795 
229 328 1078 
274 764 812 
300 823 925 
320 321 829 
445 889 1013 
547 548 684 
563 564 821 
588 1034 1062 
600 987 1014 
601 645 854 
647 717 718 
912 913 1072 
941 942 1061 
990 991 1066 
