15 42 43 49 51 52 58 59 76 77 86 99 106 107 114 122 123 128 135 145 147 156 167 186 187 217 221 222 227 232 233 238 261 267 268 278 291 294 296 299 303 322 323 328 345 351 363 374 375 382 385 389 391 393 394 396 400 406 411 428 436 442 447 448 450 451 452 454 459 462 471 473 480 491 492 505 508 509 510 519 520 523 524 526 531 533 537 558 559 561 566 567 571 575 581 582 597 598 610 632 634 643 644 669 698 700 708 709 725 727 728 738 739 740 745 747 751 752 761 768 772 774 779 791 794 795 796 799 809 820 836 842 845 850 883 890 902 903 908 912 913 919 920 929 932 960 967 968 970 975 992 1011 1019 1027 1052 1067 1072 1073 1077 1078 1081 1082 1083 
0 11 62 63 68 69 87 105 113 116 124 132 159 160 164 165 173 174 178 179 180 191 209 223 224 234 235 236 246 251 252 253 259 264 271 272 286 297 298 305 308 315 327 337 338 339 347 348 359 361 365 373 395 397 405 416 421 423 427 433 434 438 466 467 469 470 476 485 486 493 501 506 511 512 515 521 530 534 551 556 569 601 618 621 622 629 640 646 659 664 678 682 692 716 729 746 753 754 767 769 785 788 803 804 807 808 835 844 854 858 897 899 937 966 969 981 985 998 1007 1021 1022 1048 1059 1060 1071 1074 
1 2 5 7 10 12 20 21 25 41 44 45 46 50 53 54 78 88 90 103 104 144 148 151 152 177 192 211 219 247 266 331 334 336 358 371 377 424 425 426 429 456 472 474 483 484 487 496 514 516 532 540 541 549 553 557 615 616 623 626 647 676 677 681 717 718 724 726 755 773 781 782 797 801 802 837 840 841 866 871 880 891 892 896 916 930 936 943 958 965 990 991 994 1023 1030 1038 1046 1054 1055 1066 1070 1076 
16 70 92 93 97 110 121 125 143 149 153 154 155 170 185 190 198 200 204 212 213 228 244 245 254 263 280 282 288 341 357 384 409 410 413 415 419 432 437 481 495 499 539 547 548 562 600 605 606 607 645 648 657 658 661 670 675 710 730 744 756 784 787 793 817 818 819 870 873 885 886 893 894 900 907 927 928 935 963 979 982 983 986 988 1003 1025 1033 1039 1040 
23 26 73 74 75 91 94 108 109 115 120 127 131 134 157 163 175 188 189 194 195 199 202 208 214 216 257 258 265 277 279 290 313 319 330 353 380 404 430 445 449 482 489 507 544 585 596 609 627 637 649 653 673 674 691 694 703 704 714 778 790 792 798 800 805 827 832 852 855 864 869 872 882 923 924 925 952 954 973 980 1005 1006 1010 1013 1049 1075 1080 
101 102 111 112 117 162 169 176 181 203 206 207 210 215 275 276 283 285 289 312 320 321 340 366 369 370 376 387 392 398 414 439 446 460 463 464 494 517 528 546 554 568 573 586 594 599 612 617 628 631 633 636 651 660 665 668 686 693 707 712 719 720 775 776 814 815 828 829 839 843 849 851 859 876 911 933 940 941 942 944 972 978 1001 1037 1061 
22 24 29 32 34 40 47 84 85 96 119 126 133 183 220 237 270 300 309 310 318 329 342 388 412 479 522 538 619 620 654 690 706 715 737 766 770 780 789 806 810 811 863 879 887 888 889 905 993 1026 1034 1042 1062 
19 55 56 57 64 79 225 226 240 241 248 324 364 367 368 407 431 457 458 584 591 613 652 663 683 741 742 826 833 865 877 921 974 997 999 1004 1014 1031 1069 
3 6 13 35 36 38 39 60 72 82 95 239 269 349 350 401 417 422 455 475 565 576 608 680 732 735 736 749 750 763 823 906 1000 1015 1024 1043 1051 
9 17 27 28 33 37 80 139 171 262 274 302 333 418 444 555 593 602 624 625 635 679 701 734 764 786 825 860 861 909 910 1017 1050 
18 48 140 197 325 326 343 381 477 478 498 529 552 574 588 603 655 687 705 713 721 757 762 816 824 846 867 922 955 959 
4 61 89 141 146 184 335 525 527 563 564 577 666 667 671 743 758 760 821 949 950 951 953 1008 1020 1035 1047 1053 1064 
14 71 98 118 287 295 372 403 435 518 630 650 696 697 813 838 853 875 931 934 948 956 1032 1057 
138 249 281 284 293 311 314 344 355 420 468 638 685 711 723 822 831 884 895 939 1018 1058 
66 166 182 205 229 230 231 250 317 346 356 386 402 572 777 812 856 918 971 1063 
158 168 193 292 332 441 443 502 503 570 580 583 592 722 868 946 947 977 1079 1084 
30 31 136 142 218 273 550 589 590 611 695 783 904 945 1065 1068 
67 83 129 130 260 352 362 390 465 641 642 656 662 765 938 987 
242 243 255 256 408 461 497 536 578 595 862 898 926 964 1012 
81 161 301 316 378 379 542 543 545 639 857 878 
172 490 560 702 733 748 771 874 957 1036 
8 65 360 440 513 976 995 996 
100 399 453 535 579 699 834 881 
150 196 500 504 672 731 984 1002 
137 201 304 383 759 1016 
488 587 688 689 830 
684 901 917 1009 
354 1041 1056 
604 1028 1029 
614 847 848 
