86 101 102 111 112 117 169 181 203 206 207 210 233 267 275 276 283 285 291 340 366 369 370 392 393 446 460 463 464 471 517 528 546 554 568 573 599 612 617 628 631 636 651 660 665 668 707 712 719 720 776 814 828 849 876 911 944 1001 1037 
0 11 62 63 87 105 110 113 165 173 174 251 252 259 315 327 335 339 365 373 397 423 433 434 466 485 486 512 534 569 621 693 743 754 804 899 981 1007 1016 1021 1022 1048 1074 
132 159 160 164 180 209 223 224 271 286 308 347 348 395 467 470 493 504 506 530 556 622 629 664 682 716 727 728 729 753 788 807 897 929 937 985 998 1002 1059 1060 1071 1081 
5 20 44 45 46 53 54 78 104 148 151 236 377 419 424 425 448 472 483 484 489 514 516 549 553 602 616 635 681 782 791 797 840 866 880 891 916 936 943 958 1076 
1 2 7 10 12 21 50 144 192 230 247 334 358 532 540 541 615 837 841 892 896 930 1038 1054 1055 
24 74 84 85 96 133 220 309 310 342 479 619 620 654 706 715 737 770 780 879 887 888 971 993 1010 
93 125 200 280 562 600 601 606 607 645 648 670 744 787 817 853 854 870 885 934 935 988 1003 1033 1039 
26 75 94 115 330 445 482 649 673 674 714 792 798 852 855 872 889 923 924 925 1013 1075 
68 69 124 134 234 337 338 361 421 438 476 511 515 632 640 646 768 808 969 1083 
179 253 359 469 494 527 551 558 582 618 659 669 709 746 747 839 858 940 970 
49 51 232 261 278 394 427 428 447 492 526 613 692 761 815 966 1027 
91 120 194 195 199 202 214 240 257 265 277 430 637 800 882 954 973 
108 109 114 131 188 216 258 289 290 404 596 609 691 703 778 1005 1080 
4 89 141 146 525 577 666 667 671 701 760 951 953 1008 1020 1053 
8 22 29 32 34 47 65 119 360 513 690 806 905 976 996 
13 35 36 38 72 82 95 152 417 475 565 576 680 906 1051 
19 56 57 64 226 322 323 364 400 461 533 559 902 903 1073 
221 345 391 411 450 575 598 738 774 790 836 845 1011 1019 
238 296 303 442 491 520 524 581 597 751 752 799 835 912 
52 186 375 451 454 473 508 509 634 708 779 890 919 
66 166 182 205 250 317 346 386 402 777 812 918 1063 
67 130 242 243 255 256 408 465 595 926 938 1012 1047 
88 103 177 219 266 474 677 773 802 965 1046 1058 
147 297 431 591 652 741 742 833 921 997 1026 1042 
441 502 503 570 580 583 592 722 964 1079 1084 
18 48 325 477 478 498 529 655 1034 1062 
40 237 270 300 318 388 412 538 789 863 
59 363 385 396 418 593 734 967 992 1050 
70 153 154 244 245 282 413 414 873 949 
97 121 155 190 254 263 432 539 625 1025 
248 324 336 368 371 407 663 826 1004 1031 
3 6 39 60 239 455 456 732 763 
14 71 118 630 688 830 968 1015 1032 
30 31 142 273 590 611 783 904 1065 
106 107 122 123 382 389 860 861 1052 
158 183 193 292 305 332 443 522 927 
15 42 43 76 77 842 913 1072 
98 295 372 403 813 838 875 931 
162 398 585 586 594 686 775 933 
167 212 213 571 675 850 1067 1077 
136 218 550 589 694 695 1068 
140 197 588 757 824 922 959 
281 284 314 344 420 884 1018 
288 341 409 415 819 928 945 
381 552 574 603 705 713 721 
16 23 384 818 900 952 
17 274 333 555 764 909 
73 189 313 319 544 678 
176 215 312 376 827 843 
185 198 204 499 661 963 
249 293 311 831 895 939 
349 350 401 422 749 750 
452 459 462 767 769 809 
487 496 626 726 1030 1070 
495 505 605 979 982 1040 
9 139 171 497 910 
83 352 362 656 987 
100 149 399 699 881 
129 208 260 390 662 
135 519 566 567 1082 
137 201 304 383 759 
156 227 299 374 537 
172 733 771 874 1036 
228 657 658 710 730 
287 650 948 956 1057 
294 735 736 1000 1024 
357 410 784 983 986 
457 458 501 795 844 
468 638 711 723 822 
481 547 548 756 907 
490 641 702 748 957 
28 37 80 624 
61 184 758 1064 
99 178 264 510 
116 272 521 793 
145 480 883 932 
150 500 672 731 
217 643 644 1035 
231 356 572 633 
246 405 416 803 
298 351 435 1017 
326 343 816 867 
328 523 950 1078 
453 535 579 834 
542 543 545 857 
584 865 999 1069 
647 717 718 801 
868 946 947 977 
33 211 755 
41 429 994 
55 439 785 
79 241 683 
90 268 724 
92 127 507 
126 329 862 
143 437 623 
161 316 378 
163 642 765 
170 700 980 
225 536 974 
269 823 1043 
320 321 829 
354 1041 1056 
367 877 1014 
379 639 878 
380 449 805 
387 972 978 
426 676 1023 
444 786 825 
488 587 689 
560 908 975 
561 796 960 
563 564 821 
604 1028 1029 
610 725 820 
614 847 848 
698 739 740 
766 810 811 
832 1006 1049 
941 942 1061 
990 991 1066 
