3 5 12 16 17 20 23 26 33 35 38 39 48 72 97 98 120 141 163 195 211 233 237 270 304 326 334 380 391 449 466 514 530 540 546 565 570 577 610 611 631 642 647 659 680 683 717 718 755 789 803 820 832 833 865 867 868 869 871 881 882 896 906 909 910 921 931 936 953 955 964 985 990 991 998 999 1006 1007 1017 1024 1031 1049 1065 1066 
24 59 75 80 91 102 118 159 171 172 180 220 224 226 271 286 309 310 320 321 339 340 363 375 387 400 411 416 437 440 452 459 461 504 509 549 575 593 595 619 620 623 629 666 715 734 737 741 742 746 754 760 764 812 829 844 858 908 914 915 916 941 942 965 967 975 978 992 1002 1008 1012 1043 1061 1071 
73 74 156 175 188 189 208 225 227 279 280 283 284 296 303 313 314 319 330 345 349 350 354 355 367 368 378 379 385 386 396 401 402 404 420 422 426 442 468 490 491 497 520 536 586 597 604 606 607 638 662 667 670 676 678 694 695 711 744 749 750 813 822 827 835 951 952 966 1003 1004 1010 1020 1023 1068 
6 28 68 69 88 109 114 116 127 128 133 135 140 162 182 196 197 199 214 215 216 239 257 262 265 275 277 289 290 312 342 360 362 376 388 421 429 430 436 482 506 512 535 579 585 587 596 609 627 654 660 703 763 775 777 778 800 843 860 861 864 879 880 887 911 939 943 959 984 1001 1074 1080 1082 
0 43 77 86 87 125 150 153 154 165 173 174 185 198 202 203 210 223 228 230 244 247 249 251 281 282 291 329 335 341 365 393 415 450 463 470 471 488 517 532 533 566 567 591 646 658 671 682 693 710 719 726 794 840 849 856 873 878 891 895 912 920 929 1018 1022 1041 1081 
21 56 84 89 99 100 178 191 192 205 221 260 264 267 274 300 346 359 364 392 405 409 423 454 458 492 496 501 510 518 527 528 558 559 561 582 613 615 617 637 648 668 669 701 709 727 728 747 748 756 765 780 815 823 824 837 925 930 960 970 1055 1063 
31 40 46 53 54 78 92 103 104 129 130 144 151 179 209 229 236 297 301 308 328 343 344 369 390 453 455 456 472 487 507 508 516 522 524 568 569 578 602 614 664 697 706 725 729 743 751 770 791 796 816 834 898 950 963 971 993 1059 1078 
7 93 148 167 190 212 245 254 384 398 399 418 419 484 502 503 545 556 580 625 630 636 643 644 675 696 712 738 745 773 774 787 788 797 801 817 818 845 852 853 855 870 877 884 885 972 974 988 995 1033 1036 1050 1067 1076 1077 1079 1084 
37 64 94 95 142 145 186 187 231 232 269 276 278 285 397 406 412 427 469 476 479 480 493 511 515 531 551 562 621 624 633 634 635 640 665 692 698 733 739 740 779 784 793 809 814 851 859 883 919 924 932 937 986 1037 1075 
131 139 176 207 218 234 253 259 268 288 372 389 395 462 494 538 554 555 589 639 641 702 723 724 730 761 766 767 769 776 810 811 839 863 875 888 899 928 940 944 948 956 957 958 976 1005 1021 1057 
1 2 36 45 55 57 63 164 177 240 248 272 324 347 348 374 407 408 428 433 434 446 460 474 486 519 521 541 599 652 661 663 716 782 786 862 923 946 1051 1058 1060 
42 51 96 126 147 160 161 166 181 184 250 261 293 311 338 431 448 489 563 564 583 632 722 768 808 821 825 838 874 876 892 897 947 977 1027 1064 1083 
9 10 11 13 14 15 18 19 22 29 32 34 47 119 352 373 477 478 500 513 605 688 689 690 806 905 979 994 1056 
27 44 49 65 107 108 194 200 204 219 238 252 266 356 357 382 447 451 523 526 677 687 691 785 802 926 1039 1046 
70 71 90 105 106 110 113 117 123 255 256 417 483 529 544 655 830 850 866 945 968 997 1015 1026 1032 1042 1047 1048 
52 58 206 294 295 298 351 366 377 403 435 560 576 584 592 616 681 757 890 981 996 1016 1028 1029 1069 
85 121 273 299 317 318 327 337 424 425 444 481 485 498 499 534 537 548 571 651 790 828 836 907 969 
66 67 79 81 111 132 169 241 465 467 495 505 612 707 708 752 799 807 918 935 938 982 1040 
122 157 158 168 183 193 292 305 332 443 590 608 626 656 927 1030 1052 1070 
4 8 30 60 146 333 525 573 581 731 732 759 783 831 904 1053 
82 83 134 152 155 263 361 413 414 464 539 804 846 949 1025 1054 
62 138 217 331 336 371 475 557 653 672 704 922 973 1035 
322 323 473 601 645 826 847 848 854 857 902 903 954 1073 
381 552 553 574 588 598 603 705 713 721 1019 1034 1062 
358 410 432 439 572 594 686 720 894 933 934 983 
76 258 315 753 762 841 842 893 913 1000 1072 
61 115 287 438 547 684 758 901 917 1009 
149 170 302 441 679 699 700 771 805 980 
50 101 143 246 370 618 622 657 1038 
649 650 673 674 714 792 798 872 1011 
25 41 112 124 222 628 685 781 
136 137 201 325 383 542 543 550 
213 457 735 736 795 819 900 
235 600 886 987 1014 
353 445 772 889 1013 
242 243 316 394 
