218 219 251 327 347 348 363 364 369 374 375 382 393 395 397 400 406 415 427 428 431 433 434 438 439 447 450 451 454 459 460 461 462 464 466 467 469 470 471 472 476 485 486 492 493 494 501 505 508 509 510 511 515 517 519 521 522 527 528 530 531 532 534 537 540 551 554 555 556 558 559 561 568 573 575 582 595 612 617 618 621 622 628 633 636 640 644 646 647 651 659 660 665 668 669 682 693 697 698 701 706 707 709 712 716 719 720 725 727 728 733 746 747 748 753 755 756 765 776 779 781 785 786 787 790 803 814 815 821 823 824 825 826 839 843 849 864 878 896 911 937 968 969 970 972 982 992 993 1021 1037 1039 1060 
70 71 90 105 110 113 117 153 154 206 207 212 213 244 245 280 281 282 284 293 314 317 318 322 323 351 355 366 398 399 413 414 420 483 484 498 499 502 503 529 552 553 560 570 571 574 576 583 588 592 598 603 606 607 615 616 632 648 655 657 658 680 686 687 696 702 705 710 713 721 722 723 724 735 736 739 740 744 745 757 758 762 772 797 801 802 817 837 838 840 842 850 852 853 855 868 869 870 871 874 885 892 893 894 900 901 908 910 916 920 931 934 935 940 957 963 974 988 995 1000 1006 1015 1017 1018 1019 1024 1032 1033 1036 1046 1048 1054 1055 1058 1076 
35 36 38 45 46 48 60 72 75 82 83 92 93 97 98 101 102 120 121 125 140 143 147 148 149 150 155 170 185 186 187 190 198 204 205 222 231 232 253 254 263 269 270 278 315 329 341 384 391 401 412 417 419 432 441 444 463 546 547 548 577 589 590 599 631 661 684 769 782 804 820 828 832 836 846 856 863 881 925 926 933 956 966 976 981 984 1009 1011 1013 1016 1035 1043 1049 1063 
68 69 108 109 114 115 116 127 131 136 137 201 215 216 234 235 289 290 298 299 304 325 334 335 337 338 359 360 365 380 383 388 421 422 424 425 429 448 449 482 489 495 506 535 562 579 585 596 602 634 635 637 663 703 704 729 734 761 763 768 777 778 788 808 812 834 857 860 861 873 899 941 942 950 954 978 980 986 998 1005 1007 1040 1061 1080 1083 
39 40 58 59 61 76 77 86 88 89 96 118 124 126 128 135 141 142 145 146 161 162 166 167 176 177 181 182 184 217 221 228 233 250 261 267 268 274 275 291 311 385 392 411 473 474 500 514 563 565 566 567 605 613 614 643 671 692 715 741 742 749 784 805 833 879 888 889 919 921 924 939 949 953 959 965 967 979 1041 1064 1067 1077 1082 
16 17 20 23 26 27 28 33 37 53 54 78 80 94 95 103 104 159 160 180 209 211 236 271 285 286 297 308 320 321 387 407 408 446 465 541 591 600 601 624 645 664 714 789 829 851 854 858 859 862 866 882 886 914 915 943 951 952 985 1001 1014 1031 1059 1071 1075 
42 43 49 51 65 129 130 144 156 171 172 200 224 237 238 260 309 310 342 377 390 436 437 477 478 504 513 523 538 539 549 623 629 641 642 676 677 688 689 737 770 780 813 819 830 865 876 877 887 891 904 938 945 971 996 997 1023 1025 1026 1027 1028 1029 1042 1056 
0 1 2 3 4 5 6 7 8 9 10 11 12 13 14 15 18 19 21 22 24 25 29 32 34 41 44 47 50 52 119 193 255 256 352 367 368 373 426 497 536 545 564 578 609 652 690 743 806 902 903 905 906 917 960 973 994 1004 1038 1047 1051 1073 
188 189 258 259 266 283 296 303 313 319 330 345 354 361 376 386 396 402 404 442 445 468 481 490 491 520 524 544 581 597 604 638 662 678 685 711 730 783 795 822 827 835 884 907 983 
229 230 247 301 302 333 378 379 418 512 580 586 587 593 594 625 630 639 666 667 672 675 708 731 732 760 766 767 775 809 818 831 844 880 975 1008 1020 1050 1074 1084 
66 67 79 81 132 138 139 241 262 326 452 453 487 488 496 507 516 626 683 726 841 847 848 867 897 898 930 944 955 1002 1003 1030 1070 
133 134 194 195 196 197 199 214 239 246 248 257 265 272 273 276 277 300 312 328 362 381 430 440 572 627 800 918 999 1010 1078 
55 56 57 64 106 107 122 123 240 294 295 353 372 389 403 435 518 584 656 681 774 796 875 890 987 1052 1069 
84 85 91 202 203 210 220 223 249 339 340 455 456 557 619 620 653 654 750 754 895 958 1012 1034 1062 1079 
111 112 169 343 344 370 457 458 533 542 543 550 649 650 673 674 792 793 794 798 816 872 948 1057 
73 74 163 175 208 279 479 480 679 694 695 699 700 738 771 773 810 811 845 883 932 936 1068 
62 63 87 157 158 165 168 173 174 183 252 292 305 332 423 443 475 569 608 922 1022 
242 243 316 349 350 394 525 526 717 718 764 791 929 964 990 991 1053 1066 1081 
99 100 164 178 179 264 912 913 923 946 947 977 1072 
151 152 225 226 227 324 331 336 358 371 927 928 
30 31 610 611 670 751 752 759 799 807 1065 
191 192 287 288 346 405 409 416 909 
356 357 410 691 
961 962 989 
