36 37 41 45 63 94 95 99 186 222 231 266 269 272 278 285 324 340 397 406 412 419 428 433 434 460 469 474 476 510 511 515 521 541 551 559 562 617 621 633 634 640 663 665 668 669 698 733 739 740 747 748 754 756 781 784 793 809 832 851 859 919 924 937 970 986 1049 1051 1075 
5 12 16 17 20 23 26 33 35 38 39 48 72 97 98 112 120 124 141 195 211 240 270 304 326 334 380 391 449 466 514 527 530 540 546 565 570 577 610 611 628 631 641 642 659 680 685 789 820 865 867 882 896 906 910 929 931 936 953 955 964 985 998 999 1006 1024 1065 1081 
73 74 156 175 188 189 208 225 227 279 280 283 284 296 303 313 314 319 330 336 349 350 354 355 367 368 371 376 378 379 386 396 401 402 420 422 442 468 490 491 497 536 586 597 604 606 607 638 662 667 670 694 711 744 749 750 813 822 827 835 951 952 1003 1004 1010 1020 
24 75 80 102 118 159 171 180 187 226 271 286 309 310 320 321 339 363 375 387 400 416 440 452 459 461 504 509 523 549 593 595 619 620 629 666 734 737 760 773 802 829 844 845 876 914 915 916 938 941 942 965 975 978 984 992 1002 1008 1026 1042 1043 1061 1071 
27 44 49 65 85 107 108 139 176 200 204 219 234 238 252 356 357 372 382 389 395 404 426 447 451 502 503 520 526 537 538 554 556 589 616 624 676 677 687 723 724 817 852 855 863 875 926 944 948 956 958 974 976 988 1012 1021 1023 1039 1057 1079 
40 86 87 89 150 202 223 228 260 267 268 281 291 341 365 392 393 463 470 471 472 501 517 522 533 566 567 575 602 614 646 658 671 682 693 710 719 727 728 730 743 758 764 779 794 796 812 840 843 878 891 901 912 920 940 950 1018 1041 
46 53 54 92 103 104 129 130 142 144 145 151 179 209 232 236 276 297 301 308 343 344 369 374 390 411 427 453 480 486 487 493 507 508 516 524 531 568 569 664 692 697 699 700 725 726 751 771 814 816 834 883 932 963 1037 1059 
42 153 154 205 218 221 244 253 282 293 329 338 359 364 385 431 448 450 454 458 489 492 494 496 528 558 561 583 591 615 632 637 691 701 703 709 722 765 768 776 780 808 824 837 838 839 873 874 892 930 960 1055 1063 1083 
21 58 59 96 125 126 128 147 148 149 160 161 166 167 170 181 184 185 190 198 250 261 311 312 384 441 545 563 580 630 675 712 801 805 825 897 911 917 947 977 980 1009 1064 1067 1077 1084 
31 61 84 115 121 239 273 287 299 317 318 346 388 409 424 425 438 444 481 482 485 498 499 534 535 547 548 571 579 582 651 684 729 763 778 828 850 907 1080 
131 203 206 207 210 249 259 288 351 353 366 445 462 505 555 560 576 639 702 755 761 766 767 769 772 785 810 811 888 889 895 899 908 928 957 1005 1013 1015 
28 52 91 140 172 194 224 294 295 298 342 360 377 403 435 437 584 592 623 654 678 681 746 757 858 887 890 966 981 996 1001 1017 1028 1029 1046 1069 
0 1 2 3 4 9 10 11 13 14 15 18 19 22 25 29 32 34 47 119 352 373 500 605 625 688 689 690 806 905 979 994 
6 114 133 177 274 289 407 446 519 599 652 716 762 782 786 841 842 860 861 879 880 881 893 909 923 939 946 1000 1058 
43 76 77 163 165 173 174 220 247 251 258 315 488 532 578 715 717 718 741 742 753 898 913 967 990 991 1022 1066 1072 
50 78 101 143 242 243 246 300 316 370 394 423 455 456 479 618 622 657 706 770 791 823 925 993 1038 
70 71 90 105 110 113 117 136 137 201 325 383 477 478 513 542 543 550 635 695 759 1016 1048 1056 1068 
7 93 212 245 254 398 399 418 484 636 696 738 745 788 797 818 853 870 884 972 995 1036 1050 1076 
66 67 79 81 111 132 169 241 465 467 495 612 707 708 752 799 807 821 918 935 982 1040 
88 109 135 216 358 410 432 436 439 506 572 594 609 660 686 720 849 894 933 934 983 1082 
196 197 199 214 229 248 257 265 277 328 335 362 430 613 627 800 856 864 959 971 1078 
51 55 56 57 64 100 164 178 264 327 347 348 408 415 661 862 1027 1060 
122 157 158 168 183 193 292 305 332 443 590 608 626 656 927 1030 1052 1070 
82 83 134 152 155 237 263 361 413 414 464 539 804 846 949 1025 1054 
322 323 473 600 601 645 826 847 848 854 857 902 903 954 987 1014 1073 
8 30 60 146 333 525 573 581 731 732 783 815 831 904 1053 
68 69 116 127 162 182 215 235 262 290 421 585 596 777 886 
106 123 255 256 417 483 529 544 655 830 866 945 968 997 1032 
345 381 552 553 574 588 598 603 705 713 721 1019 1034 1062 
337 643 644 647 774 787 790 836 877 885 969 1033 
62 138 217 230 475 653 672 704 922 973 1035 
233 683 803 833 868 869 871 921 1007 1031 
275 302 429 512 587 679 775 943 1074 
649 650 673 674 714 792 798 872 1011 
213 457 735 736 795 819 900 
191 192 405 518 648 
