116 132 159 160 164 180 209 223 236 246 259 271 272 286 298 308 334 347 348 359 365 395 405 416 427 439 466 467 470 485 486 493 512 515 521 530 534 551 556 558 561 601 621 622 629 647 664 669 682 692 716 727 728 729 746 753 785 793 803 807 854 858 896 897 937 960 966 985 998 1007 1059 1060 1071 1074 
101 111 112 162 169 181 206 207 210 215 275 276 285 289 340 351 366 369 370 406 414 446 460 463 464 494 517 527 528 546 554 568 573 599 612 617 628 631 633 636 651 660 665 668 693 707 719 720 776 814 828 839 849 876 911 940 944 968 1001 1037 
1 5 10 12 21 25 41 44 88 103 148 177 219 377 425 429 472 474 483 484 514 549 553 606 607 616 670 677 681 773 781 782 797 802 840 866 880 891 916 936 943 965 996 1076 
0 11 62 63 87 105 110 113 165 173 174 251 252 305 315 327 339 373 397 423 433 434 569 754 804 1021 1022 1048 
75 94 115 353 445 482 585 649 673 674 714 792 798 832 872 889 899 924 925 1006 1013 1049 1075 
52 375 452 454 459 462 473 508 509 559 708 709 747 767 769 779 809 890 908 919 970 975 
92 97 121 143 149 155 185 190 198 254 263 419 432 495 539 605 886 979 982 983 1025 1040 
84 85 96 133 309 310 342 479 619 620 706 737 750 770 780 879 887 993 1026 1042 
13 35 36 38 72 82 95 475 565 576 680 735 736 906 1000 1015 1024 1051 
23 91 120 134 194 195 199 214 257 265 277 430 637 800 882 952 954 980 
93 125 200 562 600 645 648 744 787 817 870 885 935 988 1003 1033 1039 
66 166 182 205 231 250 317 346 356 386 402 572 777 812 918 1063 
106 107 122 123 186 217 232 382 389 393 451 634 643 791 1035 1052 
4 141 146 525 577 666 667 671 760 951 953 994 1008 1020 1053 
8 238 296 303 442 491 520 524 581 597 751 752 795 799 912 
40 90 218 237 270 300 318 388 412 538 589 724 789 796 863 
67 130 150 242 243 255 408 465 500 595 672 731 862 938 964 
108 109 131 157 188 216 290 404 596 609 703 778 869 1005 1080 
158 168 193 292 332 443 502 503 592 868 946 947 977 1079 
2 7 22 50 144 211 358 540 541 615 755 1038 1055 
20 45 46 78 192 424 431 458 691 837 892 1054 
15 42 43 49 76 77 156 227 537 913 1072 
24 29 32 34 47 119 690 806 888 905 
58 79 86 233 241 268 291 294 471 683 
152 324 336 368 371 407 663 826 1004 1031 
19 55 56 57 64 226 240 266 364 
73 189 258 313 319 330 544 827 835 
247 496 532 717 718 801 841 930 958 
299 322 323 374 400 582 902 903 1073 
302 333 418 593 602 635 701 734 1050 
3 6 39 60 239 455 732 763 
30 31 142 273 590 611 783 1065 
68 69 234 235 361 476 640 808 
70 153 244 245 282 413 873 949 
98 295 372 403 838 875 931 934 
117 147 167 571 772 850 1067 1077 
140 197 588 757 824 922 959 1046 
221 391 450 575 738 774 836 1011 
457 591 652 741 742 833 921 997 
490 560 702 748 771 874 957 1036 
16 384 437 623 675 818 900 
53 54 104 151 297 469 516 
59 187 363 396 644 967 992 
129 260 390 641 642 662 765 
145 480 679 700 845 883 932 
170 228 280 657 658 710 730 
281 284 314 344 420 884 1018 
381 552 574 603 705 713 721 
9 139 171 625 910 1017 
14 71 118 630 853 1032 
17 33 274 555 764 909 
18 48 325 477 478 529 
27 28 37 80 262 624 
51 278 394 447 526 1027 
61 124 337 438 511 969 
136 542 550 694 695 1068 
178 179 253 264 618 659 
249 293 311 831 895 939 
256 461 497 536 578 898 
338 501 506 646 788 844 
349 350 401 417 422 749 
398 586 594 686 775 933 
441 570 580 583 722 1084 
468 638 685 711 723 822 
83 352 362 656 987 
89 335 743 758 950 
135 519 566 567 1082 
222 267 385 492 815 
287 650 948 956 1057 
481 547 548 756 907 
487 626 726 1030 1070 
488 587 688 689 830 
498 655 762 846 871 
610 725 820 929 1081 
26 852 855 923 
65 360 513 976 
100 399 699 881 
176 843 851 859 
184 563 821 1064 
196 504 984 1002 
201 304 383 759 
204 499 661 963 
220 715 1034 1062 
229 230 856 971 
261 428 505 761 
269 608 823 1043 
326 343 816 867 
345 411 598 1019 
380 449 489 805 
415 819 927 928 
448 632 768 1083 
453 535 579 834 
584 865 999 1069 
74 163 1010 
102 283 392 
138 355 1058 
154 288 409 
161 316 378 
175 208 279 
203 653 654 
312 376 712 
320 321 829 
328 523 1078 
331 456 557 
354 1041 1056 
357 784 986 
367 877 1014 
379 639 878 
387 972 978 
421 860 861 
426 676 1023 
444 786 825 
531 533 745 
543 545 857 
604 1028 1029 
614 847 848 
698 739 740 
766 810 811 
813 904 945 
941 942 1061 
990 991 1066 
