58 59 77 86 92 96 120 125 126 128 135 147 148 149 161 162 166 167 170 181 184 185 190 198 250 261 274 291 311 316 419 441 543 545 712 805 862 870 876 917 947 977 980 1064 1067 1077 1082 
5 20 23 26 35 38 39 48 72 97 98 141 195 211 240 326 343 449 466 489 497 527 540 546 565 570 577 631 659 680 808 816 865 867 882 906 910 931 953 955 964 999 1024 
73 74 175 188 189 208 279 280 283 284 296 303 313 314 319 330 354 376 386 396 402 404 420 442 468 490 491 520 597 604 638 662 694 711 744 813 822 827 835 904 1003 1010 
27 37 49 65 80 85 99 107 108 186 187 200 226 238 251 252 253 278 363 382 394 440 447 469 510 511 526 537 568 624 753 992 
68 69 109 116 127 182 215 216 235 239 262 290 312 388 421 482 535 579 585 596 703 763 777 778 843 911 1080 
359 454 551 558 561 617 633 651 668 669 693 698 733 739 740 747 748 756 765 790 814 815 824 896 960 970 
53 54 81 103 151 209 236 276 301 308 344 369 427 434 524 569 664 692 725 751 886 963 966 1037 1059 
9 11 14 15 19 22 29 32 34 47 119 163 165 373 488 605 625 642 690 806 905 979 
102 118 159 171 180 309 310 375 461 549 629 737 773 802 845 908 916 975 1026 1042 
0 1 2 3 4 10 12 13 21 25 41 44 275 352 426 429 512 994 1074 
7 93 254 600 601 643 644 645 774 787 797 853 854 877 885 987 1014 1033 1076 
40 202 281 393 433 463 470 472 476 517 533 575 646 671 719 779 878 1018 
43 173 329 366 450 494 532 591 610 611 820 839 940 1022 1065 
75 286 339 340 416 452 459 499 509 595 619 620 754 1043 1071 
131 206 207 259 351 462 560 576 641 702 785 899 957 1005 1015 
381 552 553 574 588 598 603 705 713 721 1019 1034 1062 
158 168 193 292 332 443 502 608 626 1030 1070 1079 
28 140 342 360 513 654 887 995 996 1028 1029 
143 153 154 244 245 282 288 618 657 873 986 
174 220 225 256 536 578 715 741 742 898 967 
234 538 589 723 724 767 769 863 948 956 1057 
374 460 519 599 716 782 860 861 923 943 946 
56 64 164 242 243 327 348 408 709 1060 
136 137 201 325 383 542 550 635 695 1068 
384 437 580 675 735 736 818 900 1009 1084 
465 467 563 707 752 799 807 821 935 938 
17 248 324 334 425 446 529 541 663 
122 123 417 830 866 968 997 1032 1052 
294 295 403 435 584 981 1000 1016 1069 
322 323 847 848 857 902 903 954 1073 
16 387 400 666 760 844 978 1008 
50 101 246 370 622 727 728 1038 
94 222 285 406 851 924 937 1075 
145 411 480 531 699 700 883 932 
203 210 223 249 682 840 891 895 
204 218 219 676 677 687 776 1039 
345 422 606 667 670 951 952 1020 
36 45 63 71 474 478 1051 
42 46 338 431 507 640 691 
52 377 623 681 757 880 890 
61 115 287 438 832 1006 1049 
70 90 105 110 113 117 1048 
78 455 479 706 770 791 993 
84 299 436 582 609 637 780 
121 317 318 481 498 548 907 
156 227 331 336 349 371 750 
191 192 346 405 409 607 648 
196 199 214 257 265 277 430 
270 272 380 514 521 530 936 
271 484 583 636 745 838 972 
273 424 444 485 534 571 828 
293 448 632 722 768 850 1083 
358 410 432 439 720 849 933 
392 501 572 586 594 686 934 
398 399 696 738 771 788 1036 
649 650 673 674 792 798 872 
8 146 525 581 859 1053 
51 55 304 391 415 1027 
57 221 364 458 930 1011 
66 67 79 132 241 708 
83 263 539 894 983 1025 
111 169 495 612 982 1040 
112 124 628 685 929 1081 
142 217 232 451 493 1035 
205 528 837 892 1001 1063 
269 412 634 784 793 919 
389 395 554 944 976 1021 
6 133 289 879 939 
76 258 315 913 1072 
82 134 152 361 804 
91 559 746 781 858 
100 178 179 264 508 
129 130 144 390 697 
150 566 567 912 1041 
177 407 652 786 1058 
260 267 385 492 613 
298 503 515 592 1017 
353 445 772 889 1013 
453 487 496 726 834 
593 615 701 734 1055 
614 743 758 796 901 
683 803 833 921 1007 
30 333 759 783 
33 555 755 888 
62 653 704 922 
87 228 658 710 
104 516 852 855 
114 841 842 893 
160 355 825 897 
176 372 518 875 
297 347 486 661 
300 423 823 925 
305 362 590 656 
337 647 836 969 
356 357 926 1012 
368 378 379 1004 
413 414 949 1054 
556 817 974 988 
587 688 689 775 
630 717 718 801 
639 766 810 811 
60 573 732 
88 506 660 
95 183 927 
106 483 655 
157 869 1031 
212 213 819 
224 678 714 
229 335 856 
231 428 665 
233 868 871 
237 789 971 
320 321 829 
328 523 1078 
341 365 471 
350 401 749 
397 562 809 
418 884 1050 
504 984 1002 
941 942 1061 
990 991 1066 
