218 219 327 347 348 363 364 369 374 375 382 393 395 397 400 406 415 427 428 431 433 434 438 439 447 450 451 454 459 460 461 462 464 466 467 469 470 471 472 476 485 486 492 493 494 501 505 508 509 510 511 515 517 519 521 522 527 528 530 531 532 534 537 540 541 551 554 555 556 558 559 561 568 573 575 582 595 612 617 618 621 622 628 633 636 640 646 647 651 659 660 665 668 669 682 693 697 698 701 706 707 709 712 716 719 720 725 733 747 748 753 755 756 765 776 779 781 785 786 787 790 803 814 815 821 823 824 825 826 839 843 849 864 878 896 911 937 968 969 970 972 982 992 993 1021 1037 1039 1060 
39 40 58 59 61 76 77 86 88 89 96 118 124 126 128 135 145 146 161 162 166 167 176 177 181 184 217 221 228 233 250 261 267 268 274 275 291 311 385 392 411 474 514 565 671 749 784 805 879 939 949 965 967 1064 1067 1077 1082 
68 69 108 109 114 115 116 127 131 215 216 234 235 289 290 337 338 359 360 365 380 388 421 429 482 506 535 579 585 596 634 637 703 704 729 763 777 778 788 812 834 857 899 950 954 978 980 998 1005 1080 
188 189 258 259 266 283 296 303 313 319 330 345 354 361 376 386 396 402 404 442 445 468 481 490 491 520 524 544 581 597 604 638 662 678 685 711 730 783 795 822 827 835 884 907 983 
45 46 82 83 92 93 97 120 121 125 143 147 148 149 150 155 170 185 190 198 204 205 253 254 263 341 384 419 432 441 836 881 886 926 933 966 984 1013 1063 
0 1 2 3 4 5 6 7 10 12 13 21 25 41 44 50 52 193 352 368 426 545 652 782 906 917 960 973 994 1004 1038 
133 134 194 195 196 197 199 214 239 246 248 257 265 272 273 276 277 300 312 328 362 381 430 440 572 627 800 999 1010 1078 
35 36 38 48 60 72 75 98 140 444 463 546 577 599 631 769 804 820 828 846 922 925 976 1035 1051 
171 172 224 309 310 342 377 436 437 549 623 629 737 780 813 876 877 887 891 904 996 1014 1026 1042 
317 318 483 484 498 499 529 570 571 583 632 655 680 722 745 757 758 762 850 901 940 
8 9 11 14 15 18 19 22 24 29 32 34 47 119 373 609 690 806 905 
744 797 801 802 817 852 853 855 870 916 934 963 974 988 995 1032 1046 1076 
42 43 49 51 65 156 200 237 238 504 538 539 865 1025 1027 
334 335 424 425 448 449 489 663 734 768 808 873 986 1007 1083 
294 295 353 372 403 435 518 584 656 681 774 875 987 1069 
301 302 333 418 512 580 593 625 630 675 818 1050 1074 1084 
62 63 87 165 173 174 251 252 423 475 569 746 1022 
269 270 315 329 391 412 661 863 956 981 1011 1016 1043 
280 281 284 293 314 355 420 696 838 931 935 1018 1058 
615 616 723 724 837 840 874 892 910 1017 1036 1054 1055 
452 453 487 488 496 507 516 626 726 944 1030 1070 
136 137 201 304 325 383 495 562 602 635 1040 
206 207 351 366 560 576 702 772 908 957 1015 
53 54 78 103 104 209 236 297 866 943 
141 142 182 473 500 605 715 953 959 979 
151 152 227 324 331 336 358 371 927 928 
159 160 180 271 286 308 664 858 1059 1071 
552 553 574 588 598 603 705 713 721 1019 
649 650 673 674 714 792 798 872 948 1057 
16 17 20 23 26 33 211 789 882 
73 74 163 175 208 279 694 695 1068 
84 85 91 220 770 971 1012 1034 1062 
101 102 186 187 222 231 232 278 856 
129 130 144 260 390 523 641 642 938 
157 158 168 183 292 305 332 443 608 
699 700 738 771 773 845 883 932 936 
66 67 79 81 132 241 683 955 
70 71 90 105 110 113 117 1048 
106 107 122 123 389 796 890 1052 
255 256 367 497 536 578 743 1047 
407 408 446 465 591 862 918 1031 
30 31 610 611 670 759 1065 
153 154 244 245 282 413 414 
229 230 247 672 708 809 880 
339 340 619 620 750 754 958 
27 28 37 80 624 1001 
94 95 285 851 859 1075 
99 100 164 178 179 264 
202 203 210 223 249 895 
242 243 316 394 791 964 
666 667 760 844 1008 1020 
55 56 57 64 240 
138 139 262 326 867 
191 192 405 416 909 
349 350 401 417 422 
600 601 645 854 985 
606 607 648 885 1033 
688 689 830 945 997 
717 718 764 929 1081 
735 736 900 1000 1024 
111 112 169 370 
287 288 346 409 
320 321 387 829 
356 357 410 691 
378 379 639 975 
477 478 513 1056 
502 503 592 1079 
547 548 684 1009 
586 587 594 775 
751 752 799 807 
833 919 921 924 
923 946 947 977 
212 213 819 
298 299 761 
322 323 920 
343 344 816 
455 456 557 
457 458 533 
479 480 679 
525 526 1053 
542 543 550 
566 567 1041 
613 614 692 
657 658 710 
676 677 1023 
731 732 831 
832 1006 1049 
841 842 930 
868 869 871 
902 903 1073 
912 913 1072 
941 942 1061 
961 962 989 
990 991 1066 
