101 102 111 112 117 162 169 181 203 207 210 215 275 276 283 285 289 340 366 369 370 414 439 446 460 463 464 517 528 546 554 568 573 599 612 617 628 631 633 636 651 660 665 668 669 693 707 719 720 776 814 815 828 849 876 911 944 1001 1037 
0 11 62 63 87 105 113 116 165 173 174 178 179 236 251 252 253 264 272 305 327 339 347 359 373 397 423 433 434 466 485 486 512 521 534 551 558 569 618 621 659 746 754 793 804 1021 1022 1048 1074 
132 159 160 164 180 209 223 271 286 308 348 395 467 470 493 506 530 556 600 601 622 629 645 664 682 716 729 753 788 807 854 858 897 929 937 985 998 1059 1060 1071 1081 
43 49 51 156 186 187 217 227 232 278 363 394 406 447 451 454 526 537 559 632 634 643 709 747 768 970 992 1027 1035 1083 
3 6 13 35 36 38 39 60 72 82 239 269 455 565 576 608 680 732 735 736 763 823 906 1000 1015 1024 1043 1051 
1 2 12 22 41 50 144 192 211 247 334 358 429 496 532 540 541 755 837 841 892 896 930 958 994 1038 1054 
20 44 148 377 424 425 474 483 484 514 549 553 616 623 681 782 797 840 866 871 880 891 936 943 1076 
68 69 108 109 115 131 157 188 216 235 290 404 482 585 596 609 691 703 778 832 869 1005 1006 1049 1080 
84 85 96 133 220 309 310 342 479 619 620 654 706 715 737 770 780 879 887 993 1026 1034 1042 1062 
4 89 141 146 335 525 527 577 666 667 671 727 728 743 760 949 951 953 1008 1020 1053 
92 97 121 149 155 185 190 198 254 263 419 432 481 539 547 548 756 886 907 983 1025 
66 166 182 205 231 250 317 346 356 386 402 572 777 812 918 1063 
98 287 294 295 372 403 435 518 650 838 875 931 934 948 956 1057 
5 7 10 21 45 46 53 54 78 104 151 472 516 615 1055 
75 94 353 445 649 673 674 714 792 798 872 924 925 1013 1075 
238 296 303 442 491 520 524 581 597 751 752 795 799 835 912 
58 59 77 86 145 233 291 393 471 480 883 932 967 1007 
158 168 193 292 332 443 502 503 592 868 946 947 977 1079 
79 241 431 457 458 591 652 683 741 742 833 921 997 
234 259 365 421 494 515 767 769 785 839 899 940 968 
19 23 55 56 57 64 195 226 240 364 882 952 
40 218 237 270 300 318 388 412 538 589 789 863 
88 103 177 219 266 677 773 802 916 965 1046 1058 
93 125 200 562 744 787 817 870 935 988 1003 1039 
299 322 323 374 400 533 582 847 848 902 903 1073 
24 29 32 34 47 119 690 806 888 889 905 
52 375 473 508 509 708 779 890 908 919 975 
152 248 324 336 368 371 407 663 826 1004 1031 
338 361 427 476 501 640 646 692 808 844 966 
73 163 189 258 313 319 330 544 694 827 
134 199 214 257 265 277 430 440 800 995 
221 391 450 575 644 738 774 836 845 1011 
106 107 122 123 382 389 860 861 1052 
170 228 280 657 658 700 710 730 980 
206 490 560 702 748 771 874 957 1036 
255 256 536 564 578 898 926 1012 1047 
18 140 197 588 757 824 922 959 
30 31 142 273 590 611 783 1065 
333 418 593 602 635 701 734 1050 
16 143 384 437 675 818 900 
70 153 244 245 282 413 873 
91 120 194 202 637 954 973 
129 260 390 641 642 662 765 
191 246 315 405 416 803 981 
281 284 314 344 420 884 1018 
349 350 401 417 422 749 750 
381 552 574 603 705 713 721 
392 398 586 594 686 775 933 
441 570 580 583 722 964 1084 
9 139 171 625 910 1017 
14 71 118 630 853 1032 
17 33 274 555 764 909 
27 28 37 80 262 624 
137 201 304 383 759 1016 
147 167 571 772 1067 1077 
222 267 385 396 492 613 
249 293 311 831 895 939 
468 638 685 711 723 822 
495 505 605 979 982 1040 
606 607 648 670 885 1033 
8 65 360 976 996 
15 42 76 913 1072 
74 175 208 279 1010 
83 352 362 656 987 
135 519 566 567 1082 
242 243 408 595 862 
487 626 726 1030 1070 
498 655 762 846 850 
26 852 855 923 
67 130 465 938 
90 110 268 724 
100 399 699 881 
124 337 511 969 
136 550 695 1068 
150 500 672 731 
176 843 851 859 
184 563 821 1064 
196 504 984 1002 
204 499 661 963 
229 230 856 971 
326 343 816 867 
328 523 950 1078 
345 411 598 1019 
380 449 489 805 
415 819 927 928 
426 676 813 1023 
452 459 462 809 
453 535 579 834 
542 543 545 857 
561 614 796 960 
584 865 999 1069 
647 717 718 801 
48 325 529 
154 288 409 
161 316 378 
261 428 761 
297 438 469 
312 376 712 
320 321 829 
331 456 557 
354 1041 1056 
357 784 986 
367 877 1014 
379 639 878 
387 972 978 
444 786 825 
477 478 513 
488 587 689 
604 1028 1029 
610 725 820 
653 704 790 
698 739 740 
766 810 811 
941 942 1061 
990 991 1066 
