124 132 134 159 160 164 180 209 234 236 246 259 271 286 298 308 315 337 338 347 348 361 363 365 395 427 439 466 467 470 476 485 486 493 506 511 512 515 530 534 556 592 601 622 629 640 644 646 647 664 669 682 692 716 727 728 729 753 767 769 785 788 803 807 825 854 858 897 916 937 969 985 992 998 1007 1059 1060 1071 1074 
101 102 111 112 117 169 181 207 210 215 275 276 283 285 289 291 312 340 366 369 370 376 387 414 446 460 463 464 471 494 517 528 546 554 568 573 599 612 617 628 631 633 636 651 660 665 668 693 707 712 719 720 776 814 828 839 849 876 911 940 944 947 972 977 978 1001 1037 
68 69 108 109 114 115 128 131 157 188 216 235 290 294 295 353 403 404 436 445 482 535 585 596 609 703 735 736 778 832 842 852 855 869 899 923 925 946 1000 1005 1006 1013 1049 1080 
0 11 62 63 87 105 110 113 165 173 174 251 252 253 305 327 339 359 373 397 423 433 434 469 551 558 569 618 746 754 804 1021 1022 1048 
93 200 280 426 553 562 600 606 607 645 648 670 676 744 787 797 813 817 853 870 885 904 934 935 963 974 987 988 1003 1023 1033 1039 1076 
1 4 5 10 12 20 22 25 34 41 44 46 352 377 424 425 429 549 616 681 781 782 866 880 902 903 994 996 1073 
53 54 104 151 297 431 457 487 516 626 652 688 691 726 741 742 830 833 921 945 968 997 1015 1026 1030 1032 1042 1070 
2 7 21 50 211 247 334 472 496 532 540 541 615 717 718 755 837 841 892 896 930 958 1038 1054 1055 
82 92 121 125 143 149 152 155 185 190 198 254 263 419 432 495 539 605 886 933 979 982 983 1025 1040 
88 103 148 166 177 184 219 311 474 514 523 561 677 773 801 802 840 891 936 960 965 1058 1064 
52 328 375 452 454 459 462 473 508 509 559 708 747 779 809 890 908 970 975 1078 
23 91 97 120 194 195 199 214 257 265 277 362 430 637 800 882 952 954 980 
3 6 35 36 38 39 60 72 95 239 331 455 456 475 557 732 763 1051 
84 85 96 133 309 342 479 619 620 706 737 750 770 780 879 887 939 993 
49 51 187 222 232 261 278 394 406 428 447 526 531 709 815 1027 
141 146 335 525 527 577 666 667 671 758 760 951 953 1008 1020 1053 
140 197 552 574 588 603 705 713 721 757 824 922 959 1046 
158 193 292 332 441 443 502 503 570 580 583 722 868 1084 
19 55 56 57 64 226 240 364 458 584 865 999 1069 
186 217 266 357 393 451 533 621 634 643 784 986 1035 
238 296 303 442 491 520 524 581 597 751 752 795 799 
66 182 205 250 317 386 402 777 812 918 1063 
67 130 242 243 255 408 465 595 862 938 964 
106 107 122 123 382 389 421 791 860 861 1052 
24 29 32 47 119 310 690 806 888 905 
26 73 189 258 313 319 330 544 827 835 
40 126 237 270 318 388 412 538 789 863 
75 94 649 673 674 714 792 798 872 1075 
79 233 241 566 567 683 889 919 924 1041 
129 163 208 260 390 641 642 662 765 
221 391 411 575 738 745 774 836 1011 
329 333 418 593 602 635 701 734 1050 
17 33 274 505 555 761 764 909 
153 154 244 245 282 413 873 949 
206 351 490 560 702 748 874 957 
354 468 638 685 711 723 822 1056 
16 384 437 623 675 818 900 
58 77 86 267 385 492 613 
74 136 550 694 695 1010 1068 
147 167 571 772 850 1067 1077 
162 392 398 586 594 686 775 
191 192 346 405 409 416 518 
229 230 231 356 572 856 971 
281 284 314 344 420 884 1018 
288 341 410 415 819 927 928 
9 139 171 625 910 1017 
18 48 325 477 478 529 
30 31 273 611 783 1065 
70 249 293 731 831 895 
145 480 700 845 883 932 
168 498 655 762 846 871 
170 228 657 658 710 730 
248 324 407 663 826 1031 
299 322 323 374 400 582 
417 565 576 680 906 1024 
8 65 360 513 976 
98 372 838 875 931 
116 272 521 793 808 
269 300 608 823 1043 
287 650 948 956 1057 
367 368 877 1004 1014 
448 489 632 768 1083 
610 725 820 929 1081 
14 71 118 630 
28 37 80 624 
43 156 227 537 
99 178 264 510 
100 453 579 834 
142 218 589 590 
144 336 358 371 
176 843 851 859 
196 504 984 1002 
201 304 383 759 
202 203 223 973 
326 343 816 867 
349 350 401 749 
481 548 756 907 
542 543 545 857 
578 743 796 898 
15 42 76 
45 78 943 
90 268 724 
135 519 1082 
150 500 672 
161 316 378 
204 499 661 
220 1034 1062 
224 678 966 
225 256 536 
320 321 829 
345 598 1019 
379 639 878 
380 449 805 
399 699 881 
547 684 901 
604 1028 1029 
614 847 848 
698 739 740 
766 810 811 
912 913 1072 
926 1012 1079 
941 942 1061 
990 991 1066 
