0 11 62 63 87 105 113 116 124 132 159 160 164 165 173 174 178 179 180 191 209 223 224 234 236 246 251 252 253 259 264 271 272 286 297 305 308 315 327 337 338 339 347 348 359 361 365 373 395 397 405 416 421 423 427 433 434 438 466 467 469 470 476 485 486 493 494 501 506 511 512 515 521 530 534 551 556 558 569 600 601 618 621 622 629 640 645 646 659 664 678 682 692 716 729 746 753 754 767 769 785 788 793 803 804 807 808 839 844 854 858 897 899 929 937 940 966 968 969 981 985 998 1021 1022 1048 1059 1060 1071 1074 1081 
1 2 5 7 10 12 20 21 22 25 41 44 45 46 50 53 54 78 88 103 104 144 148 151 177 192 211 219 247 266 334 358 377 424 425 429 472 474 483 484 487 496 514 516 532 540 541 549 553 615 616 623 626 647 677 681 717 718 726 755 773 781 782 797 801 802 837 840 841 866 871 880 891 892 896 916 930 936 943 958 965 990 991 994 1030 1038 1046 1054 1055 1058 1066 1070 1076 
15 42 43 49 51 76 99 106 107 122 123 156 186 187 217 227 232 238 261 278 296 299 303 322 323 328 345 363 374 382 389 394 400 406 411 428 442 447 448 451 454 491 510 520 523 524 526 531 533 537 559 581 582 597 598 610 632 634 643 709 725 745 747 751 752 761 768 791 794 795 799 820 835 847 848 860 861 902 903 912 913 920 950 970 992 1019 1027 1035 1052 1072 1073 1078 1083 
24 29 30 31 32 34 40 47 84 85 96 119 126 133 136 142 158 168 183 193 218 220 237 270 273 292 300 309 310 318 329 332 342 388 412 441 443 479 502 503 522 538 550 570 580 583 589 590 592 611 619 620 654 690 695 706 715 722 737 766 770 780 783 789 806 810 811 863 868 879 887 888 889 905 946 947 964 977 993 1026 1034 1042 1062 1065 1068 1079 1084 
101 102 111 112 117 162 169 176 181 203 207 210 215 275 276 283 285 289 312 320 321 340 366 369 370 376 387 392 398 414 439 446 460 463 464 517 528 546 554 568 573 586 594 599 612 617 628 631 633 636 651 660 665 668 669 686 693 707 712 719 720 775 776 814 815 828 829 843 849 851 859 876 911 933 941 942 944 972 978 1001 1037 1061 
3 6 13 18 35 36 38 39 48 60 61 72 82 95 140 184 197 239 269 325 326 343 349 350 381 401 417 422 455 475 477 478 498 513 529 552 563 565 574 576 588 603 608 655 680 687 705 713 721 732 735 736 749 750 757 758 762 763 816 821 823 824 846 850 867 906 922 955 959 1000 1015 1024 1043 1051 1064 
16 92 93 97 121 125 143 149 155 170 185 190 198 200 204 212 213 228 254 263 280 341 384 410 415 419 432 437 481 495 499 505 539 547 548 562 605 606 607 648 657 658 661 670 675 700 710 730 744 756 787 817 818 819 870 885 886 893 894 900 907 927 928 935 963 979 980 982 983 988 1003 1025 1033 1039 1040 
26 68 69 73 74 75 94 108 109 115 127 131 157 163 175 188 189 208 216 235 258 279 290 313 319 330 353 357 380 404 445 449 482 489 507 544 585 596 609 627 649 653 673 674 691 694 703 704 714 778 784 790 792 798 805 827 832 852 855 864 869 872 923 924 925 986 1005 1006 1010 1013 1049 1075 1080 
58 59 77 86 90 110 114 128 135 145 147 167 221 222 233 267 268 291 298 351 385 391 393 396 436 450 471 480 492 519 566 567 571 575 613 644 724 738 772 774 836 842 845 883 932 967 1007 1011 1067 1077 1082 
4 9 27 28 37 80 89 139 141 146 171 262 302 333 335 418 444 525 527 577 593 602 624 625 635 666 667 671 679 701 727 728 734 743 760 786 825 910 949 951 953 1008 1017 1020 1050 1053 
17 33 79 152 241 248 274 324 331 336 367 368 371 407 431 456 457 458 555 557 584 591 652 663 683 741 742 764 826 833 865 877 909 921 997 999 1004 1014 1031 1069 
14 71 98 118 287 294 295 372 403 426 435 518 630 650 676 696 697 813 838 853 875 931 934 948 956 1023 1032 1057 
52 375 452 459 462 473 508 509 561 614 698 708 739 740 779 796 809 890 908 919 960 975 
19 23 55 56 57 64 91 120 194 195 202 225 226 240 364 637 882 952 954 973 974 
138 249 281 284 293 311 314 344 355 420 468 638 685 711 723 822 831 884 895 939 1018 
66 166 182 205 229 230 231 250 317 346 356 386 402 572 777 812 856 918 971 1063 
67 130 242 243 255 256 408 461 465 497 536 564 578 595 862 898 926 938 1012 1047 
8 65 134 199 214 257 265 277 360 430 440 800 976 995 996 
81 161 301 316 378 379 542 543 545 639 857 878 
83 129 260 352 362 390 641 642 656 662 765 987 
172 206 490 560 702 733 748 771 874 957 1036 
70 153 154 244 245 282 288 409 413 873 
100 399 453 535 579 699 834 881 
150 196 500 504 672 731 984 1002 
488 587 688 689 830 904 945 
137 201 304 383 759 1016 
684 901 917 1009 
354 1041 1056 
604 1028 1029 
