5 12 16 17 20 23 26 33 35 38 39 48 72 97 98 120 139 141 163 195 211 233 237 270 304 326 334 380 389 391 395 449 466 514 530 540 554 565 570 577 610 611 631 642 659 680 683 789 803 820 832 833 865 867 868 869 871 881 882 896 906 909 910 921 931 936 944 953 955 958 964 976 985 998 999 1006 1007 1021 1024 1031 1049 1065 
24 59 75 80 102 118 159 171 172 180 224 226 271 286 309 310 320 321 339 363 375 385 387 396 400 416 437 440 452 459 461 504 509 549 558 559 593 595 617 619 620 623 629 666 668 669 734 737 747 748 760 829 844 908 914 915 916 941 942 965 970 975 978 992 1002 1008 1043 1061 1071 
28 68 69 88 109 114 116 127 133 135 140 162 182 196 197 199 214 215 216 239 257 262 265 277 289 290 312 342 360 362 376 388 421 430 436 482 506 535 579 585 596 609 627 654 660 703 763 777 778 800 843 864 879 887 911 939 959 996 1001 1028 1029 1080 1082 
7 21 93 148 167 190 212 225 245 254 384 398 399 418 484 502 503 545 556 580 625 630 636 643 644 675 696 712 738 745 773 774 787 788 797 801 817 818 845 852 853 855 870 877 884 885 917 972 974 988 995 1009 1033 1036 1050 1067 1076 1077 1079 1084 
40 51 86 87 89 150 202 203 223 228 249 260 267 268 281 291 341 365 392 393 411 415 463 470 471 472 501 517 522 566 567 575 602 646 658 671 682 693 710 719 730 743 758 764 794 796 812 840 849 878 891 895 901 912 920 940 950 1018 1027 1041 
37 41 64 94 95 99 100 142 178 186 187 222 231 232 264 266 269 276 278 285 397 406 412 427 433 469 476 493 510 511 515 531 533 551 562 621 624 633 634 640 665 692 698 733 739 740 779 784 793 809 814 851 859 919 924 937 986 1037 1075 
73 156 188 189 227 280 283 284 293 296 303 313 314 319 330 349 350 354 355 367 368 378 379 386 401 402 404 420 422 442 468 490 491 586 597 604 606 607 638 667 670 678 711 744 749 750 813 822 827 835 892 951 952 966 1003 1004 1020 
84 153 154 177 205 218 221 244 253 282 329 359 364 407 446 450 454 458 465 467 492 494 496 527 528 546 561 563 564 582 591 615 637 652 701 707 709 752 765 776 780 786 799 807 815 821 824 837 839 873 918 930 935 960 1055 1058 1063 
27 44 49 65 74 85 91 107 108 176 200 204 219 234 238 252 356 357 372 382 426 447 451 520 523 526 537 538 589 616 676 677 687 694 695 723 724 746 802 858 863 875 926 938 948 956 1010 1012 1023 1039 1057 1068 
36 45 55 56 57 63 112 124 164 240 272 274 324 340 347 348 408 419 428 434 460 474 486 519 521 541 628 661 663 685 716 754 781 782 860 861 923 929 946 1051 1060 1081 
31 46 53 54 92 103 104 129 130 144 151 179 209 236 297 301 308 343 344 369 374 390 453 487 507 508 516 524 568 569 599 664 697 725 729 751 816 834 963 1059 
30 131 206 207 210 259 288 333 351 366 462 505 555 560 576 639 641 702 755 761 766 767 769 783 785 810 811 888 899 904 928 957 1005 
0 1 2 3 4 9 10 11 13 14 15 18 19 22 25 29 32 34 47 119 352 373 500 605 688 689 690 806 905 979 994 
43 76 77 165 173 174 230 247 251 258 315 335 488 532 717 718 726 753 762 841 842 856 893 913 990 991 1000 1022 1066 1072 
50 78 101 143 242 243 246 300 316 370 394 423 455 456 618 622 657 706 727 728 770 791 823 925 971 993 1038 
70 71 90 105 106 110 113 117 123 255 417 483 529 544 655 830 866 945 968 997 1015 1026 1032 1042 1047 1048 
121 273 299 317 318 327 346 409 424 425 444 481 485 498 499 534 547 548 571 651 684 756 828 850 907 
220 256 345 381 497 536 552 553 574 578 588 598 603 705 713 715 721 741 742 898 967 1019 1034 1062 
42 61 115 287 337 338 431 438 448 489 583 632 647 691 722 768 790 808 836 838 874 969 1083 
96 126 128 147 160 161 166 181 184 250 261 311 825 862 876 897 947 977 1064 
52 58 194 294 295 298 377 403 435 584 592 681 757 890 981 1017 1046 1069 
122 157 158 168 183 193 292 305 332 443 590 608 626 656 927 1030 1052 1070 
125 145 149 170 185 198 302 441 479 480 679 699 700 771 805 883 932 980 
248 322 323 473 601 613 614 826 847 848 854 857 902 903 954 1073 
331 336 358 371 410 432 439 557 572 594 686 720 894 933 934 983 
136 137 201 325 383 477 478 513 542 543 550 635 759 1016 1056 
66 67 79 81 111 132 169 241 495 612 708 982 1040 
82 83 134 152 155 263 361 464 539 804 846 1025 
8 60 146 525 573 581 731 732 831 1053 
62 138 217 475 653 672 704 922 973 1035 
6 275 429 512 587 775 880 943 1074 
649 650 673 674 714 792 798 872 1011 
213 457 735 736 795 819 900 
235 600 645 886 987 1014 
353 445 772 889 984 1013 
191 192 405 518 648 
175 208 279 662 
413 414 949 1054 
229 328 1078 
