73 74 156 163 175 188 189 191 192 208 225 227 245 279 280 283 284 293 296 303 313 314 319 330 345 349 350 354 355 367 368 378 379 385 386 396 401 402 404 405 420 422 442 468 490 491 497 518 536 586 597 604 606 607 638 648 662 667 670 678 694 695 711 744 749 750 822 827 835 885 892 951 952 966 1003 1004 1010 1020 1033 1068 
5 12 16 17 20 23 26 33 35 38 39 48 72 97 98 100 120 141 178 195 211 237 264 270 304 326 334 380 391 449 466 489 514 530 540 546 565 570 577 584 610 631 642 647 659 680 717 718 755 789 808 820 832 865 867 881 882 896 906 909 910 931 936 953 955 964 985 990 991 998 999 1006 1017 1049 1066 1069 
75 76 80 102 118 159 171 180 194 224 226 252 258 286 309 310 315 320 321 339 340 375 387 400 416 440 461 504 509 523 531 533 549 595 619 620 629 666 737 753 754 760 773 802 803 829 841 842 844 845 893 908 912 913 914 915 916 941 942 975 978 1002 1008 1043 1046 1061 1071 1072 
6 28 68 69 88 109 116 127 133 135 140 162 182 196 197 199 214 215 216 239 257 262 265 275 277 289 290 312 342 360 376 388 421 429 430 453 482 506 512 535 579 585 587 596 609 654 660 688 689 703 763 775 778 800 834 843 879 880 887 911 943 959 984 1001 1074 1080 1082 
43 56 77 84 99 165 173 174 202 230 247 251 301 335 359 364 423 452 454 459 487 488 492 496 510 527 532 558 559 561 568 569 582 593 614 615 617 621 637 668 669 698 701 709 716 725 726 727 728 739 740 747 748 756 765 780 785 796 815 824 856 930 960 963 970 1022 1055 
2 55 57 114 139 142 153 164 179 186 240 248 269 272 297 324 347 348 374 389 395 408 412 433 434 460 469 476 486 493 508 511 515 519 521 541 551 554 599 613 632 634 640 661 663 733 782 784 793 850 860 861 862 873 919 923 944 958 976 986 1021 1060 
7 21 93 148 167 190 212 254 337 384 398 399 418 419 502 503 545 556 580 625 630 643 644 675 696 712 738 774 787 790 797 801 817 818 836 852 853 855 870 877 884 969 974 988 995 1050 1067 1076 1077 1084 
31 46 53 54 78 92 103 104 129 130 144 151 209 229 236 308 328 343 344 369 390 448 451 455 472 479 484 507 516 522 524 602 636 664 697 706 729 745 751 770 788 791 816 950 971 972 993 1036 1059 1078 
30 40 131 176 206 207 218 234 253 259 333 366 372 441 462 494 538 555 560 576 589 616 627 639 641 702 723 724 759 766 767 769 783 805 810 811 839 863 864 875 888 928 948 956 957 1005 1057 
42 51 125 126 147 160 166 181 185 198 205 260 267 281 338 392 393 411 415 431 458 463 470 501 517 528 575 583 646 671 719 764 777 779 794 812 837 838 874 876 878 897 920 1018 1027 1063 
58 86 87 128 145 150 221 228 233 268 274 291 294 295 341 365 403 471 480 566 567 658 683 693 710 730 741 742 833 868 869 883 921 924 932 946 947 977 1000 1007 1031 1041 
70 71 85 90 105 106 110 113 115 117 121 244 273 287 299 317 318 327 346 424 425 438 444 481 485 498 499 529 534 537 571 651 655 722 825 828 899 907 968 1015 1032 1048 
0 1 3 4 8 9 10 11 13 14 15 18 19 22 29 32 34 47 60 119 146 373 500 525 573 581 605 690 731 732 806 831 905 979 994 1053 
25 36 41 45 61 63 89 96 124 161 184 222 223 250 261 474 563 564 578 628 682 685 743 758 781 821 840 891 898 901 929 940 1051 1064 1081 
37 59 64 94 95 187 231 232 276 278 285 363 397 406 427 428 562 633 635 665 692 734 761 768 776 809 814 851 859 937 992 1037 1075 1083 
66 67 79 81 111 112 132 169 241 465 467 495 505 611 612 707 708 752 799 807 918 935 938 982 1040 1065 
27 44 49 65 107 108 200 204 219 238 266 356 357 382 447 520 526 624 677 687 691 926 1039 
91 220 381 552 553 574 588 598 603 705 713 715 721 746 858 967 1012 1019 1034 1062 1079 
122 157 158 168 183 193 292 305 332 352 362 443 590 608 626 656 927 1030 1052 1070 
52 172 298 351 377 435 436 483 592 623 681 757 871 890 981 996 1016 1028 1029 
123 255 256 417 426 544 676 813 830 866 904 945 997 1023 1026 1042 1047 
62 138 217 331 336 371 456 475 557 653 672 704 922 973 1035 
82 83 134 152 155 263 361 413 414 464 539 804 949 1025 1054 
322 323 473 601 645 826 847 848 854 857 902 903 954 1073 
154 177 282 288 329 407 409 446 450 591 652 786 1058 
358 410 432 439 572 594 686 720 849 894 933 934 983 
136 137 201 325 383 477 478 513 542 543 550 1056 
24 50 101 246 271 370 622 965 1038 
649 650 673 674 714 792 798 872 1011 
149 170 302 679 699 700 771 980 
213 457 735 736 795 819 900 1024 
143 300 437 618 657 823 925 
203 210 249 311 895 939 
235 600 886 987 1014 
353 445 772 889 1013 
547 548 684 917 1009 
242 243 316 394 
