5 16 17 20 23 26 33 35 38 39 48 72 97 98 120 141 163 195 211 233 237 270 304 326 380 391 449 466 514 530 540 546 565 570 577 610 611 631 642 659 680 683 755 789 803 820 832 833 865 867 868 869 871 881 882 906 909 910 921 931 936 953 955 964 985 998 999 1006 1007 1024 1031 1049 1065 
43 77 86 87 89 125 150 165 173 174 185 198 202 203 223 228 230 247 249 251 274 281 291 335 341 365 393 411 415 463 470 471 488 517 532 533 566 567 575 646 658 671 682 693 710 717 718 719 764 812 840 843 849 856 878 891 895 912 920 929 990 991 1018 1022 1041 1066 1081 
73 156 188 189 225 227 280 283 284 293 296 303 313 314 319 330 345 349 350 354 355 367 368 376 378 379 386 401 402 404 420 422 426 442 468 490 491 497 536 586 597 604 606 607 638 667 670 676 678 711 744 749 750 813 822 827 835 892 951 952 966 1003 1004 1020 1023 
24 59 75 80 91 102 118 159 171 172 180 224 226 271 286 309 310 320 321 339 363 375 385 387 396 400 416 437 440 452 459 461 504 509 549 593 595 619 620 623 629 666 734 737 746 760 829 844 858 908 914 915 916 941 942 965 975 978 992 1002 1008 1043 1061 1071 
7 21 93 148 167 190 212 245 254 312 384 398 399 418 484 502 503 545 556 580 625 630 636 643 644 675 696 712 738 745 773 774 787 788 797 801 817 818 845 852 853 855 870 877 884 885 911 917 972 974 988 995 1009 1033 1036 1050 1067 1076 1077 1079 1084 
37 64 94 95 99 100 142 145 178 186 187 231 232 264 266 269 276 278 285 397 406 412 427 469 476 493 510 511 515 531 551 562 621 624 633 634 640 665 669 692 698 733 739 740 779 784 793 794 809 814 851 859 883 919 924 932 937 986 1037 1075 
56 84 153 154 191 192 205 218 221 244 253 260 267 282 288 329 359 364 392 405 450 454 458 492 494 496 501 518 527 528 558 561 582 591 613 615 617 637 648 668 701 727 728 747 748 765 776 780 815 824 837 839 873 928 930 940 960 970 1055 1063 
2 36 45 55 57 63 139 164 177 196 199 214 240 248 257 265 272 277 340 347 348 362 389 395 407 408 428 430 433 434 446 460 474 486 519 521 541 554 559 599 652 661 663 709 716 754 782 786 800 862 923 944 946 958 976 1021 1051 1058 1060 
6 28 68 69 88 109 114 116 127 133 135 140 162 182 197 215 216 239 262 275 289 290 342 360 388 421 429 436 482 506 512 535 579 585 587 596 609 654 660 703 763 775 777 778 860 861 879 880 887 939 943 959 1001 1074 1080 1082 
31 40 46 53 54 92 103 104 129 130 144 151 179 209 229 236 297 301 308 328 343 344 369 374 390 453 472 487 507 508 516 522 524 568 569 602 614 664 697 725 726 729 743 751 796 816 834 950 963 1059 1078 
27 44 49 65 74 85 107 108 176 200 204 219 234 238 252 268 356 357 372 382 447 451 520 523 526 537 538 589 677 687 691 694 695 723 724 730 785 802 863 875 926 948 956 1010 1012 1039 1057 1068 
42 51 96 126 128 147 160 161 166 181 184 250 261 311 338 431 448 489 563 564 583 632 722 768 808 821 825 838 874 876 897 947 977 1027 1064 1083 
52 58 194 206 210 294 295 298 351 366 377 403 435 560 576 584 592 616 641 681 702 757 890 957 981 996 1016 1017 1028 1029 1046 1069 
0 1 3 9 10 11 13 14 15 18 19 22 29 32 34 47 119 352 373 500 605 688 689 690 806 905 979 994 
70 71 90 105 106 110 113 117 123 255 256 417 483 529 544 655 830 866 945 968 997 1015 1026 1032 1042 1047 1048 
61 115 121 273 287 299 317 318 346 409 438 481 498 499 534 547 548 571 684 756 758 850 901 907 
66 67 79 81 111 132 169 241 465 467 495 505 612 707 708 752 799 807 918 935 938 982 1040 
50 78 101 143 246 300 370 419 423 455 456 618 622 657 706 770 791 823 925 971 993 1038 
220 381 552 553 574 578 588 598 603 627 705 713 715 721 741 742 864 898 967 1019 1034 1062 
131 207 259 353 445 462 555 639 761 766 767 769 772 810 811 888 889 899 984 1005 1013 
122 157 158 168 183 193 292 305 332 443 590 608 626 656 927 1030 1052 1070 
324 331 336 358 371 410 432 439 557 572 594 686 720 894 933 934 983 
4 8 30 60 146 333 525 573 581 731 732 759 783 831 904 1053 
82 83 134 152 155 263 361 413 414 464 539 804 846 949 1025 1054 
12 327 334 337 424 425 444 485 647 651 790 828 836 896 969 
322 323 473 601 645 826 847 848 854 857 902 903 954 1073 
136 137 201 325 383 477 478 513 542 543 550 635 1056 
149 170 302 441 479 480 679 699 700 771 805 980 
76 258 315 753 762 841 842 893 913 1000 1072 
62 138 217 475 653 672 704 922 973 1035 
649 650 673 674 714 792 798 872 1011 
25 41 112 124 222 628 685 781 
213 457 735 736 795 819 900 
235 600 886 987 1014 
175 208 279 662 
242 243 316 394 
