73 74 175 188 189 208 279 280 283 284 296 303 313 314 319 330 354 355 376 386 396 402 404 420 442 468 490 491 520 586 597 604 606 607 638 662 670 694 711 744 813 822 827 835 1003 1010 
99 142 186 187 232 269 271 278 363 411 469 476 493 510 511 515 531 551 617 621 634 640 668 669 698 739 740 747 748 756 784 793 896 970 986 992 
5 20 35 38 39 48 72 97 98 120 141 211 270 304 326 449 466 527 546 565 577 610 611 631 820 867 906 953 955 1024 1065 
53 54 103 104 151 209 236 276 301 308 343 344 369 427 516 524 568 569 664 692 725 726 751 814 816 963 1037 1059 
0 1 2 3 4 10 13 21 25 272 324 340 352 428 433 434 460 486 521 541 559 663 754 781 994 
68 69 88 109 116 135 162 216 239 290 388 421 436 482 506 535 579 585 609 660 763 777 778 1080 1082 
80 102 118 159 171 180 225 226 309 310 375 387 440 461 497 549 629 737 916 975 978 1026 1042 
11 14 15 19 22 29 32 34 47 119 163 165 373 488 605 641 642 690 806 905 979 
75 286 339 400 416 452 459 509 595 619 620 666 760 844 1008 1043 1071 
218 266 359 364 454 558 561 593 615 701 709 734 765 776 930 960 1055 
96 126 128 147 161 166 181 184 250 261 311 563 876 947 977 1064 
202 281 463 470 517 575 646 671 719 764 779 812 843 878 1018 
157 158 168 193 292 332 443 502 503 608 626 1030 1070 1079 
49 65 238 251 252 253 447 451 526 538 948 956 1057 
121 273 317 318 346 409 481 498 499 534 548 571 907 
203 249 293 448 489 632 722 768 808 850 892 895 1083 
70 71 90 105 110 113 117 477 478 513 1048 1056 
540 570 584 680 865 910 931 964 999 1006 1017 1069 
131 207 259 462 755 767 769 772 785 899 1005 
148 167 190 312 545 675 712 911 917 1067 1077 
196 197 199 214 257 265 277 362 430 800 959 
41 94 222 285 406 851 859 924 937 1075 
42 46 92 338 431 507 583 691 838 874 
44 78 107 382 455 479 706 770 791 993 
52 172 377 623 681 757 890 996 1028 1029 
133 289 519 599 716 782 879 923 939 946 
136 137 201 325 383 635 695 759 1016 1068 
465 467 707 752 799 807 821 918 935 938 
56 57 64 164 327 347 348 661 1060 
58 86 221 291 341 365 471 693 815 
210 288 366 408 494 839 862 928 940 
245 484 636 696 738 745 788 972 1036 
358 410 432 439 720 849 894 933 983 
27 108 200 204 219 677 687 1039 
43 77 173 247 532 717 718 1022 
145 480 679 699 700 771 883 932 
156 227 336 349 371 401 749 750 
174 220 578 715 741 742 898 967 
206 351 560 576 702 908 957 1015 
212 398 399 418 818 853 884 1050 
381 552 553 574 603 705 713 721 
28 140 342 360 654 887 1001 
33 380 514 530 936 985 998 
66 67 79 81 132 241 708 
100 178 179 264 297 374 508 
322 323 847 848 902 903 1073 
384 437 580 630 801 1009 1084 
483 529 830 945 968 997 1032 
649 650 673 714 792 798 872 
16 17 23 26 237 789 
50 101 246 370 622 1038 
62 217 653 704 922 1035 
76 258 315 753 913 1072 
82 134 152 361 804 846 
111 169 495 612 982 1040 
112 124 628 685 929 1081 
114 762 841 842 893 1000 
154 244 282 329 450 591 
155 413 414 464 949 1054 
177 407 446 652 786 1058 
229 328 335 856 971 1078 
345 588 598 1019 1034 1062 
389 395 554 944 976 1021 
424 425 444 485 651 828 
473 601 826 854 857 954 
556 817 852 855 974 988 
774 787 877 885 1014 1033 
37 95 183 624 927 
40 472 522 602 950 
59 393 533 727 728 
60 573 731 732 831 
122 305 590 656 1052 
129 130 144 390 697 
150 566 567 912 1041 
176 372 723 724 875 
205 458 528 837 1063 
254 797 870 995 1076 
337 647 790 836 969 
350 368 378 379 1004 
422 667 951 952 1020 
512 587 775 943 1074 
12 334 391 659 
36 63 474 1051 
51 55 415 1027 
61 115 287 438 
83 263 539 1025 
87 228 658 710 
125 149 185 198 
143 419 618 657 
223 682 840 891 
242 243 316 394 
260 267 385 492 
298 435 592 981 
300 423 823 925 
353 445 889 1013 
356 357 926 1012 
453 487 496 834 
505 555 761 888 
523 773 802 845 
572 594 686 934 
639 766 810 811 
683 803 833 921 
735 736 819 900 
868 869 871 1031 
45 832 1049 
84 299 582 
89 758 901 
91 746 858 
123 417 866 
127 262 703 
146 525 1053 
160 825 897 
182 215 596 
192 405 648 
195 240 882 
213 457 795 
224 678 966 
230 475 672 
231 633 665 
234 589 863 
274 860 861 
294 295 403 
302 333 783 
320 321 829 
331 456 557 
397 562 809 
412 733 919 
426 676 1023 
504 984 1002 
542 543 550 
600 645 987 
614 743 796 
637 780 824 
941 942 1061 
990 991 1066 
