73 156 175 188 189 208 227 279 280 283 284 293 296 303 313 314 319 324 330 331 336 345 349 350 354 355 367 368 371 376 378 379 386 401 402 404 420 422 426 442 468 490 491 497 557 586 597 604 606 607 638 662 667 670 676 678 694 695 711 744 749 750 813 822 827 835 892 951 952 966 1003 1004 1020 1023 1068 
43 77 86 87 89 125 150 165 173 174 185 198 202 203 223 228 230 247 249 251 274 281 291 335 341 365 393 411 415 453 463 470 471 487 488 517 532 566 567 575 646 658 671 682 693 710 717 718 719 726 764 779 794 812 834 840 843 849 856 878 891 895 912 920 929 990 991 1018 1022 1041 1066 1081 
6 28 68 69 88 109 114 116 127 128 133 135 140 162 182 196 197 199 214 215 216 239 248 257 262 265 275 277 289 290 312 342 360 362 388 421 429 430 436 482 506 512 535 579 585 587 596 609 627 654 660 703 763 775 777 778 800 860 861 864 879 880 887 911 939 943 959 1001 1074 1080 1082 
5 12 16 17 20 23 26 33 35 38 39 48 72 97 98 120 141 163 195 211 237 270 304 326 334 380 391 449 466 514 530 540 546 565 570 577 610 611 631 642 659 680 755 789 820 832 865 867 881 882 896 906 909 910 931 936 953 955 964 985 998 999 1006 1024 1049 1065 
24 59 75 80 102 118 159 171 172 180 224 226 271 286 309 310 320 321 339 363 375 385 387 396 400 416 437 440 452 459 461 504 509 523 549 593 595 619 620 623 629 666 734 737 760 773 802 829 844 845 908 914 915 916 941 942 965 975 978 992 1002 1008 1043 1061 1071 
37 64 94 95 99 100 142 178 186 187 231 232 264 266 269 276 278 285 397 406 412 427 433 469 476 493 510 511 515 531 533 551 559 562 617 621 624 633 634 640 665 668 669 692 698 733 739 740 747 748 756 784 809 814 851 859 919 924 937 970 986 1037 1075 
56 84 131 153 154 207 218 221 244 253 259 282 288 329 359 364 450 454 462 492 494 496 527 555 558 561 582 591 613 615 637 701 709 727 728 761 765 767 769 776 780 815 824 839 873 888 899 928 930 960 1005 1055 
21 96 126 147 148 160 161 166 167 181 184 190 212 225 250 311 502 503 545 556 563 564 625 630 643 644 675 712 774 787 801 817 821 825 852 855 870 876 877 885 897 917 947 974 977 988 1033 1064 1067 1077 1079 
27 42 44 49 51 65 74 85 91 107 108 200 204 219 238 252 338 356 357 382 431 447 448 451 489 520 526 537 583 632 677 687 691 722 746 768 785 808 838 858 874 926 1010 1012 1027 1039 1083 
31 40 46 53 54 92 103 104 129 130 144 151 179 209 229 236 297 301 308 328 343 344 369 374 390 472 507 508 516 522 524 568 569 602 614 664 697 725 729 743 751 796 816 950 963 1059 1078 
36 45 55 57 63 164 177 240 261 272 340 347 348 407 408 419 428 434 446 460 474 486 519 521 541 599 652 661 663 716 754 782 786 793 862 923 946 1051 1058 1060 
61 115 121 273 287 299 317 318 327 337 346 409 424 425 438 444 481 485 498 499 534 547 548 571 647 651 684 758 790 828 836 850 901 907 940 969 
52 58 194 206 210 294 295 298 351 366 377 403 435 560 576 584 592 616 641 681 702 757 890 957 981 996 1016 1017 1028 1029 1046 1069 
0 1 2 3 4 9 10 11 13 14 15 18 19 22 25 29 32 34 47 119 352 373 500 605 688 689 690 806 905 979 994 
7 93 245 254 384 398 399 418 484 580 636 696 738 745 788 797 818 853 884 972 995 1009 1036 1050 1076 1084 
70 71 90 105 106 110 113 117 123 255 417 483 529 544 655 830 866 945 968 997 1015 1026 1032 1042 1047 1048 
66 67 79 81 111 132 169 241 465 467 495 505 612 707 708 752 799 807 918 935 938 982 1040 
139 176 234 268 372 389 395 538 554 589 723 724 730 863 875 944 948 956 958 976 1021 1057 
220 256 381 536 552 553 574 578 588 598 603 705 713 715 721 741 742 898 967 1019 1034 1062 
50 78 101 143 246 300 370 423 455 456 618 622 657 706 770 791 823 925 971 993 1038 
8 30 60 146 333 525 573 581 639 731 732 759 766 783 810 811 831 904 1053 
122 157 158 168 183 193 292 305 332 443 590 608 626 656 927 1030 1052 1070 
145 149 170 302 441 479 480 679 699 700 771 805 883 932 980 
322 323 473 601 645 826 847 848 854 857 902 903 954 1073 
136 137 201 325 383 477 478 513 542 543 550 635 1056 
82 83 134 152 155 263 361 464 539 804 846 1025 
192 205 260 267 392 405 458 501 528 648 837 1063 
358 410 432 439 572 594 686 720 894 933 934 983 
76 258 315 753 762 841 842 893 913 1000 1072 
62 138 217 475 653 672 704 922 973 1035 
233 683 803 833 868 869 871 921 1007 1031 
649 650 673 674 714 792 798 872 1011 
41 112 124 222 628 685 781 
213 457 735 736 795 819 900 
353 445 772 889 984 1013 
235 600 886 987 1014 
242 243 316 394 
413 414 949 1054 
