11 62 63 87 116 124 132 159 160 164 165 173 174 178 179 180 191 209 223 234 236 246 251 252 253 259 264 271 272 286 298 305 308 315 327 337 338 339 347 348 359 361 365 373 395 397 405 416 423 427 433 434 466 467 470 476 485 486 493 506 511 512 515 521 530 534 551 556 569 601 618 621 622 629 640 646 647 659 664 669 682 692 716 727 728 729 746 753 785 788 803 804 807 808 854 858 897 937 966 969 985 998 1007 1021 1022 1059 1060 1071 1074 
0 2 4 5 7 10 12 20 21 22 25 29 34 44 46 50 53 54 148 211 334 424 425 472 474 514 540 541 549 553 615 616 681 755 781 782 797 837 840 866 891 892 896 936 943 1038 1054 1055 1076 
276 340 406 438 439 446 460 463 494 554 558 559 610 617 633 636 651 665 668 693 707 709 720 725 747 754 776 815 820 839 849 940 968 970 1037 
58 59 86 128 145 186 233 268 291 294 351 393 396 436 471 480 632 634 679 700 768 845 883 932 967 1083 
68 69 108 109 115 131 157 188 216 235 290 404 482 585 596 609 703 778 832 869 899 1005 1006 1049 1080 
101 112 117 162 206 207 210 215 275 289 369 464 517 527 546 568 573 599 612 631 660 828 911 944 
92 97 121 143 149 155 185 190 198 254 263 419 432 495 539 605 886 979 982 983 1025 1040 
79 241 324 368 407 431 457 458 591 652 663 683 691 741 742 826 833 921 997 1004 1031 
84 85 96 133 309 310 342 479 619 620 706 737 750 770 780 879 887 993 1026 1042 
23 91 120 134 194 195 199 214 257 265 277 430 637 800 882 952 954 980 
13 35 36 38 72 82 565 576 680 735 736 906 1000 1015 1024 1051 
66 166 182 205 231 250 317 346 356 386 402 572 777 812 918 1063 
75 94 353 445 649 673 674 714 792 798 872 889 924 925 1013 1075 
18 48 140 197 325 477 478 529 588 757 824 922 959 1046 
93 125 200 562 600 645 744 787 817 870 935 988 1003 1039 
158 168 193 292 332 443 502 503 592 868 946 947 977 1079 
70 105 110 113 153 244 245 282 413 414 873 949 1048 
98 295 372 403 426 518 676 813 838 875 931 934 1023 
141 146 525 577 666 667 671 760 951 953 1008 1020 1053 
40 218 237 270 300 318 388 412 538 589 789 863 
52 375 454 473 508 509 708 779 890 908 919 975 
73 189 258 296 313 319 330 491 544 795 827 835 
15 42 43 49 76 77 156 227 537 913 1072 
67 130 242 243 255 408 465 595 862 938 964 
238 303 442 520 524 581 597 751 752 799 912 
297 299 322 323 374 400 469 582 902 903 1073 
88 103 177 219 677 773 802 916 965 1058 
19 55 56 57 64 226 240 266 364 
247 496 532 717 718 801 841 930 958 
302 333 418 593 602 635 701 734 1050 
24 32 47 119 690 806 888 905 
30 31 142 273 590 611 783 1065 
135 421 519 566 567 860 861 1082 
150 196 500 504 672 731 984 1002 
221 391 450 575 738 774 836 1011 
490 560 702 748 771 874 957 1036 
106 107 122 123 382 389 1052 
129 260 390 641 642 662 765 
147 167 571 772 850 1067 1077 
170 228 280 657 658 710 730 
192 606 607 648 670 885 1033 
217 232 385 451 492 643 1035 
281 284 314 344 420 884 1018 
377 483 484 623 871 880 996 
381 552 574 603 705 713 721 
9 139 171 625 910 1017 
14 71 118 630 853 1032 
16 384 437 675 818 900 
17 33 274 555 764 909 
27 28 37 80 262 624 
51 278 394 447 526 1027 
104 151 152 336 371 516 
136 542 550 694 695 1068 
249 293 311 831 895 939 
256 461 497 536 578 898 
349 350 401 417 422 749 
366 370 528 719 814 1001 
398 586 594 686 775 933 
441 570 580 583 722 1084 
452 459 462 767 769 809 
468 638 685 711 723 822 
6 39 60 455 732 
8 65 360 513 976 
61 269 608 823 1043 
83 352 362 656 987 
111 169 628 929 1081 
287 650 948 956 1057 
481 547 548 756 907 
487 626 726 1030 1070 
488 587 688 689 830 
1 41 429 994 
26 852 855 923 
100 399 699 881 
176 843 851 859 
184 563 821 1064 
187 363 644 992 
201 304 383 759 
204 499 661 963 
220 715 1034 1062 
229 230 856 971 
261 428 505 761 
326 343 816 867 
345 411 598 1019 
357 784 793 986 
380 449 489 805 
415 819 927 928 
453 535 579 834 
498 655 762 846 
584 865 999 1069 
3 239 763 
74 163 1010 
89 758 950 
102 283 392 
154 288 409 
161 316 378 
175 208 279 
181 285 876 
203 653 654 
312 376 712 
320 321 829 
328 523 1078 
331 456 557 
354 1041 1056 
367 877 1014 
379 639 878 
387 972 978 
444 786 825 
531 533 745 
543 545 857 
561 796 960 
604 1028 1029 
614 847 848 
698 739 740 
766 810 811 
941 942 1061 
990 991 1066 
