0 11 62 63 87 105 113 116 124 165 173 174 178 179 236 251 252 253 264 272 297 305 315 327 337 338 339 347 359 361 373 397 423 427 433 434 438 466 469 476 486 511 512 521 534 551 569 618 621 640 646 659 692 746 754 793 804 808 858 966 969 1021 1022 1048 1074 
101 111 112 117 162 169 181 203 206 207 210 275 276 285 289 340 366 369 370 406 414 439 446 460 463 464 494 517 528 546 554 568 573 599 612 617 628 631 633 636 651 660 665 668 693 707 709 719 720 776 814 815 828 839 849 876 911 940 944 968 1001 1037 
132 159 160 164 180 209 223 234 259 271 286 298 308 334 348 365 395 467 470 485 493 506 515 530 556 601 622 629 664 682 716 727 728 729 753 767 769 785 788 807 854 896 897 899 937 985 998 1007 1059 1060 1071 
5 20 44 45 46 53 54 78 104 148 377 424 425 474 483 484 514 516 549 553 616 623 681 782 797 837 840 866 871 880 891 892 916 936 943 996 1054 1076 
3 6 13 35 36 38 39 60 61 72 82 184 239 269 455 565 576 608 680 732 735 736 763 823 906 1000 1015 1024 1043 1051 1064 
52 106 107 122 123 186 375 382 389 454 473 508 509 558 559 632 634 669 708 747 768 779 850 890 908 919 970 975 1052 1083 
68 69 108 109 115 131 157 188 216 235 290 404 482 585 596 609 703 778 832 869 1005 1006 1049 1080 
84 85 96 133 220 309 310 342 479 619 620 654 706 715 737 770 780 879 887 993 1026 1034 1042 1062 
1 2 4 7 10 12 21 22 41 50 144 211 358 429 472 540 541 615 755 994 1038 1055 
58 59 79 86 128 145 222 233 241 267 268 291 294 351 393 436 471 480 683 932 967 
92 97 121 149 155 185 190 198 254 263 419 432 495 539 605 886 979 982 983 1025 1040 
23 91 120 134 194 195 199 202 214 257 265 277 430 637 800 882 952 954 973 980 
89 141 146 335 525 527 577 666 667 671 743 758 760 949 950 951 953 1008 1020 1053 
98 287 295 372 403 426 518 650 676 813 838 875 931 934 948 956 1023 1057 
248 324 407 431 457 458 591 613 652 663 691 741 742 826 833 921 997 1031 
75 94 353 445 649 673 674 714 792 798 872 889 924 925 1013 1075 
238 296 303 442 491 520 524 581 597 751 752 795 799 835 912 
93 125 200 562 600 645 744 787 817 870 935 988 1003 1039 
158 168 193 292 332 443 502 503 592 868 946 947 977 1079 
18 48 140 197 325 477 478 529 588 757 824 922 959 
66 166 182 205 250 317 346 386 402 777 812 918 1063 
15 42 43 49 76 77 278 394 447 526 913 1072 
221 391 450 575 644 700 738 774 836 845 883 1011 
88 103 177 219 266 677 773 802 965 1046 1058 
19 55 56 57 64 225 226 240 364 974 
24 29 32 34 47 119 690 806 888 905 
40 237 270 300 318 388 412 538 789 863 
67 130 242 243 408 465 595 862 938 964 
302 333 418 593 602 635 679 701 734 1050 
70 110 153 154 244 245 282 413 873 
102 283 392 398 586 594 686 775 933 
255 256 461 497 536 578 898 926 1012 
30 31 142 273 590 611 783 1065 
73 189 258 313 319 330 544 827 
151 152 227 331 336 371 456 557 
176 215 312 376 712 843 851 859 
217 232 385 396 451 492 643 1035 
490 560 702 748 771 874 957 1036 
16 143 384 437 675 818 900 
51 156 299 374 537 582 1027 
74 163 175 208 279 694 1010 
127 487 507 626 726 1030 1070 
170 228 280 657 658 710 730 
192 606 607 648 670 885 1033 
229 230 231 356 572 856 971 
281 284 314 344 420 884 1018 
322 323 400 533 902 903 1073 
349 350 401 417 422 749 750 
381 552 574 603 705 713 721 
9 139 171 625 910 1017 
14 71 118 630 853 1032 
135 147 519 566 567 1082 
136 218 550 589 695 1068 
247 496 532 841 930 958 
249 293 311 831 895 939 
288 409 415 819 927 928 
441 570 580 583 722 1084 
468 638 685 711 723 822 
8 65 360 513 976 
17 33 555 764 909 
83 352 362 656 987 
167 571 772 1067 1077 
367 368 877 1004 1014 
481 547 548 756 907 
488 587 688 689 830 
610 725 820 929 1081 
26 852 855 923 
28 37 80 624 
100 399 699 881 
150 500 672 731 
196 504 984 1002 
201 304 383 759 
204 499 661 963 
260 390 641 662 
261 428 505 761 
274 421 860 861 
326 343 816 867 
345 411 598 1019 
380 449 489 805 
452 459 462 809 
453 535 579 834 
498 655 762 846 
542 543 545 857 
584 865 999 1069 
647 717 718 801 
129 642 765 
161 316 378 
187 363 992 
246 416 803 
320 321 829 
328 523 1078 
354 1041 1056 
357 784 986 
379 639 878 
387 972 978 
444 786 825 
561 796 960 
604 1028 1029 
614 847 848 
653 704 790 
698 739 740 
766 810 811 
941 942 1061 
990 991 1066 
