0 11 62 63 87 116 132 159 160 164 165 173 174 180 209 236 246 251 252 259 271 272 286 298 305 308 315 327 338 339 347 348 359 363 365 373 395 397 405 416 423 427 433 434 439 466 467 470 485 486 493 506 512 515 521 530 534 551 556 558 569 601 622 629 644 646 664 669 682 692 716 727 728 729 746 753 785 788 803 804 807 825 846 854 858 897 937 966 985 992 998 1007 1021 1022 1059 1060 1071 1074 
101 102 111 112 117 169 207 210 275 276 283 289 340 366 369 370 414 446 460 463 464 494 517 527 528 546 554 568 573 599 612 617 628 631 633 636 651 660 665 668 693 707 712 719 720 754 776 814 828 839 849 911 940 944 1001 1037 
1 2 7 10 12 21 50 144 192 211 247 297 334 358 472 496 532 540 541 591 615 648 755 837 841 892 896 930 958 1038 1054 1055 
5 20 45 46 53 54 78 104 377 424 483 484 516 549 553 606 607 616 670 681 782 797 840 866 891 916 943 996 1076 
3 6 13 35 36 38 39 60 72 82 95 152 331 455 456 475 557 565 576 680 732 767 769 906 1015 1024 1051 
84 85 96 133 203 223 309 310 342 619 620 653 654 706 737 750 770 780 879 887 939 993 1026 1042 
108 109 115 131 157 188 216 239 290 404 482 585 596 609 703 763 778 832 869 899 1005 1006 1049 1080 
92 97 121 143 149 155 185 190 198 254 263 419 432 495 539 605 886 979 982 983 1025 1040 
93 125 200 562 600 645 744 787 813 817 870 885 904 935 974 988 1003 1033 1039 
75 94 353 445 649 673 674 714 792 798 852 855 872 923 925 946 1013 1075 
4 23 141 146 525 577 666 667 671 758 760 951 952 953 1008 1020 1053 
52 186 375 393 454 473 508 509 559 634 708 747 779 890 908 970 975 
91 120 134 194 195 199 214 257 265 277 430 637 800 882 954 980 1046 
40 218 237 270 300 318 335 388 412 538 589 743 789 796 863 
66 182 205 231 250 317 346 356 386 402 572 777 812 918 1063 
88 103 151 177 219 426 561 676 677 773 802 960 965 1023 1058 
238 296 303 442 491 520 524 581 597 751 752 795 799 912 
324 407 431 457 652 663 691 741 742 826 833 921 997 1031 
15 42 43 49 76 77 156 227 336 371 537 913 1072 
67 130 242 243 255 408 465 595 862 926 938 964 1012 
79 86 233 241 291 471 566 567 683 889 919 924 1041 
26 73 189 258 313 319 330 354 544 827 835 1056 
70 105 110 113 153 244 245 282 413 873 949 1048 
19 55 56 57 64 226 240 266 364 458 621 
22 24 29 32 34 47 119 690 806 888 905 
106 107 122 123 382 389 421 791 860 861 1052 
158 168 193 292 332 443 502 503 592 868 1079 
217 222 232 267 385 406 451 492 643 815 1035 
18 48 197 325 477 478 529 824 922 959 
129 163 208 260 390 641 642 662 765 
299 322 323 374 400 582 902 903 1073 
302 333 418 593 602 635 701 734 1050 
30 31 142 273 590 611 783 1065 
44 148 166 425 474 514 880 936 
68 69 234 235 361 476 640 808 
74 136 542 550 694 695 1010 1068 
98 295 372 403 838 875 931 934 
145 479 480 679 700 845 883 932 
162 392 398 586 594 686 775 933 
179 253 469 501 618 659 709 844 
206 351 490 560 702 748 874 957 
221 391 450 575 738 774 836 1011 
487 488 587 626 689 726 1030 1070 
16 384 437 623 675 818 900 
51 187 278 394 447 526 1027 
61 124 337 438 511 647 969 
147 167 571 772 850 1067 1077 
170 228 280 657 658 710 730 
176 215 312 376 843 851 859 
281 284 314 344 420 884 1018 
381 552 574 603 705 713 721 
9 139 171 625 910 1017 
14 71 118 630 853 1032 
17 33 274 555 764 909 
249 293 311 731 831 895 
349 350 401 417 422 749 
441 570 580 583 722 1084 
468 638 685 711 723 822 
8 65 360 513 976 
25 41 429 781 994 
58 294 735 736 1000 
100 453 535 579 834 
181 285 876 947 977 
287 650 948 956 1057 
367 368 877 1004 1014 
448 489 632 768 1083 
481 547 548 756 907 
610 725 820 929 1081 
28 37 80 624 
99 178 264 510 
138 202 355 973 
150 196 500 672 
184 563 821 1064 
201 304 383 759 
204 499 661 963 
220 715 1034 1062 
229 230 856 971 
261 428 505 761 
269 608 823 1043 
326 343 816 867 
345 411 598 1019 
357 784 793 986 
415 819 927 928 
452 459 462 809 
461 497 578 898 
498 655 762 871 
584 865 999 1069 
684 901 917 1009 
688 830 945 968 
59 396 967 
83 656 987 
90 268 724 
135 519 1082 
140 588 757 
154 288 409 
161 316 378 
225 256 536 
320 321 829 
328 523 1078 
379 639 878 
380 449 805 
387 972 978 
399 699 881 
504 984 1002 
531 533 745 
543 545 857 
604 1028 1029 
614 847 848 
698 739 740 
717 718 801 
766 810 811 
941 942 1061 
990 991 1066 
