11 62 124 132 134 159 160 164 165 174 180 209 234 236 246 252 259 271 286 298 308 315 327 337 338 339 347 348 359 361 363 365 373 395 397 427 433 434 439 466 467 470 476 485 486 493 506 511 512 515 530 534 551 556 592 601 622 629 640 644 646 647 664 669 682 692 716 727 728 729 746 753 767 769 785 788 803 804 807 825 854 858 897 937 966 969 985 992 998 1007 1021 1059 1060 1071 1074 
89 101 102 111 112 117 169 207 210 215 275 276 283 289 312 340 366 369 370 376 387 414 446 460 463 464 471 517 527 528 546 554 568 573 599 612 617 628 631 633 636 651 660 665 668 693 707 712 719 720 754 776 814 828 849 911 944 950 972 978 1001 1037 
68 69 108 109 114 115 131 157 188 216 235 290 294 404 436 482 535 585 596 609 703 735 736 778 832 842 869 899 1000 1005 1006 1049 1080 
93 125 200 345 553 562 598 600 606 607 645 648 670 744 787 797 813 817 870 885 916 935 974 987 988 1003 1019 1033 1039 1076 
52 99 178 179 264 328 375 452 454 459 462 473 508 509 510 558 559 659 708 709 747 779 809 890 908 970 975 1078 
88 103 128 148 166 177 184 219 311 474 514 523 561 676 677 773 802 840 891 936 960 965 1023 1058 1064 
82 92 121 143 149 152 155 185 190 198 254 263 419 432 495 539 605 886 933 979 982 983 1025 1040 
43 49 51 156 187 222 227 261 278 394 406 428 447 494 526 537 538 815 839 863 940 1027 
84 85 96 133 309 310 342 479 480 619 620 679 706 737 750 770 780 879 887 939 993 
23 91 97 120 194 195 199 214 257 265 277 362 430 637 800 882 952 954 980 1046 
0 63 87 105 110 113 116 173 251 272 305 423 521 569 793 808 1022 1048 
2 50 211 247 334 496 532 540 541 755 837 841 892 896 930 958 1038 1054 
5 7 20 21 46 53 54 104 151 297 424 431 472 516 615 691 866 1055 
18 48 168 197 325 477 478 483 484 498 529 655 762 824 846 871 922 959 
221 226 295 364 391 403 411 458 575 584 738 745 774 836 865 999 1011 1069 
75 94 353 445 649 673 674 714 792 798 852 855 872 923 925 1013 1075 
106 107 122 123 186 266 357 382 389 393 533 621 634 784 791 986 1052 
238 296 303 354 442 491 520 524 581 597 751 752 795 799 835 1056 
1 4 10 22 25 41 352 426 429 781 902 903 994 1073 
66 182 205 231 250 317 356 386 402 572 777 812 918 1063 
141 146 525 577 666 667 671 758 760 951 953 1008 1020 1053 
3 6 39 60 239 269 331 455 456 557 608 732 763 
158 193 292 332 441 443 502 503 570 580 583 868 1084 
58 77 86 162 291 392 398 586 594 686 775 
67 130 242 243 255 408 465 595 862 938 964 
12 44 377 425 549 616 681 782 880 996 
24 29 32 34 47 119 690 806 888 905 
36 95 417 475 565 576 680 906 1024 1051 
79 233 241 566 567 683 889 919 924 1041 
26 73 189 258 313 319 330 544 827 
129 163 208 260 390 641 642 662 765 
302 333 418 593 602 635 701 734 1050 
17 33 274 505 555 761 764 909 
40 126 237 270 329 388 412 789 
74 136 542 550 694 695 1010 1068 
147 167 318 571 772 850 1067 1077 
153 154 244 245 282 413 873 949 
248 324 368 407 663 826 1004 1031 
14 71 118 630 853 1015 1032 
16 384 437 623 675 818 900 
30 31 273 611 783 904 1065 
150 196 500 504 672 984 1002 
170 228 280 657 658 710 730 
191 192 346 405 409 416 518 
224 253 469 501 618 678 844 
225 256 461 497 536 578 898 
281 284 314 344 420 884 1018 
288 341 410 415 819 927 928 
381 552 574 603 705 713 721 
688 830 945 968 997 1026 1042 
9 139 171 625 910 1017 
19 55 56 57 64 240 
35 38 72 140 588 757 
70 249 293 731 831 895 
98 372 838 875 931 934 
181 285 876 946 947 977 
206 351 560 702 874 957 
217 232 451 531 643 1035 
299 322 323 374 400 582 
448 489 632 722 768 1083 
457 652 741 742 833 921 
468 638 685 711 723 822 
8 65 360 513 976 
145 700 845 883 932 
287 650 948 956 1057 
349 350 401 422 749 
481 547 548 756 907 
487 626 726 1030 1070 
610 725 820 929 1081 
28 37 80 624 
100 453 579 834 
142 218 589 590 
144 336 358 371 
176 843 851 859 
201 304 383 759 
202 203 223 973 
204 499 661 963 
229 230 856 971 
267 385 492 613 
326 343 816 867 
15 42 76 
45 78 943 
90 268 724 
135 519 1082 
161 316 378 
220 1034 1062 
300 823 1043 
320 321 829 
335 743 796 
367 877 1014 
379 639 878 
380 449 805 
399 699 881 
421 860 861 
543 545 857 
604 1028 1029 
614 847 848 
698 739 740 
717 718 801 
766 810 811 
912 913 1072 
926 1012 1079 
941 942 1061 
990 991 1066 
