73 74 156 175 188 189 208 227 279 280 283 284 296 303 313 314 319 330 336 345 349 350 354 355 368 371 376 378 379 381 386 396 401 402 404 420 422 442 468 490 491 552 553 574 586 588 597 598 603 604 606 607 638 662 667 670 694 705 711 713 721 744 749 750 813 822 827 835 951 952 1003 1004 1010 1019 1020 1034 1062 
0 1 2 3 4 9 10 11 12 13 14 15 18 19 21 22 25 29 32 34 43 47 76 77 119 163 165 173 174 220 247 256 258 300 315 352 373 423 488 500 532 536 578 605 625 641 642 688 689 690 715 717 718 741 742 753 781 806 823 898 905 913 925 967 979 990 991 994 1022 1066 1072 
42 46 53 54 103 104 129 130 144 151 205 209 218 236 266 276 282 301 308 329 338 343 344 359 364 369 390 427 431 434 450 453 454 458 487 496 507 516 524 528 561 568 569 583 591 615 664 691 692 697 701 709 725 726 734 751 765 776 816 834 837 838 874 930 960 963 1037 1055 1059 1063 
5 16 17 20 23 26 33 35 38 39 48 72 97 98 141 195 211 237 240 270 304 326 334 380 391 449 466 514 527 530 540 546 565 570 577 610 611 631 659 680 789 820 865 867 881 882 896 906 909 910 931 936 953 955 964 985 998 999 1006 1017 1024 1065 
24 75 80 102 118 159 171 180 187 225 226 271 286 309 310 320 321 339 363 375 387 400 416 440 452 459 461 497 509 549 595 619 620 629 666 737 760 829 844 914 915 916 941 942 965 975 978 992 1008 1026 1042 1043 1061 1071 
51 55 56 57 64 99 100 164 178 179 264 272 278 297 324 327 340 347 348 374 415 428 433 460 469 486 489 508 510 521 541 558 559 617 633 661 663 668 669 693 698 733 739 740 747 748 754 756 808 814 970 1027 1060 
58 59 86 87 142 145 162 186 221 228 232 268 269 291 293 365 393 411 412 448 471 476 480 493 511 515 531 533 551 621 632 634 640 658 679 699 700 710 722 727 728 730 768 784 793 850 883 892 919 932 986 1083 
88 92 96 120 125 126 128 135 147 148 149 160 161 166 167 170 181 184 185 190 198 250 261 311 312 419 441 506 545 563 660 712 774 787 805 825 870 876 877 885 897 911 917 947 977 980 1014 1033 1064 1067 1077 1082 
28 62 68 69 109 116 127 140 182 196 197 199 214 215 216 217 239 257 262 265 277 290 342 360 362 388 421 430 482 535 579 585 596 643 644 653 654 703 704 763 777 778 800 887 922 959 1001 1035 1080 
27 44 49 65 78 85 91 107 108 200 204 219 238 251 252 253 356 357 382 426 447 451 455 520 523 526 537 624 676 677 687 706 746 770 773 791 802 845 858 926 993 1012 1023 1039 
40 89 150 202 203 223 249 281 463 470 472 517 566 567 575 614 646 671 682 719 743 758 764 779 794 796 812 840 843 878 891 895 901 912 920 950 1018 1041 
131 153 154 206 207 210 242 243 244 259 288 316 351 366 394 408 462 494 505 555 560 576 702 755 761 772 785 839 862 873 888 899 928 940 957 1005 1015 
7 93 212 235 245 254 302 384 398 399 418 437 484 580 593 630 636 675 696 738 745 771 788 797 801 818 853 884 886 972 995 1009 1036 1050 1076 1084 
82 83 134 152 155 263 341 358 361 410 413 414 432 439 464 539 572 594 686 720 804 846 849 894 933 934 949 983 1025 1054 
6 114 133 177 274 289 407 446 519 599 652 716 762 782 786 841 842 860 861 879 880 893 923 939 946 1000 1058 
52 172 224 294 295 298 353 377 403 435 445 584 592 623 678 681 757 889 890 966 981 996 1013 1028 1029 1069 
121 273 317 318 337 346 409 424 425 444 481 485 498 499 534 547 548 571 647 651 684 790 828 836 907 969 
36 45 63 70 71 90 105 110 112 113 117 124 474 477 478 513 628 685 832 929 1048 1049 1051 1056 1081 
122 157 158 168 193 292 305 332 443 502 503 556 590 608 626 656 817 852 855 974 988 1030 1052 1070 1079 
139 176 234 367 372 389 395 538 554 589 616 723 724 767 769 863 875 944 948 956 958 976 1021 1057 
66 67 79 81 111 132 169 241 465 467 495 612 707 708 752 799 807 821 918 935 938 982 1040 
37 41 94 95 183 222 231 285 397 406 522 562 602 665 809 851 859 924 927 937 1075 
8 30 60 146 333 525 573 581 639 731 732 766 783 810 811 815 831 904 1053 
213 233 457 683 735 736 795 803 819 833 868 869 871 900 921 1007 1031 
31 61 84 115 194 287 299 436 438 582 609 637 729 780 824 1046 
106 123 255 417 483 529 544 564 655 830 866 945 968 997 1032 1047 
322 323 473 600 601 645 826 847 848 854 857 902 903 954 987 1073 
138 229 230 328 335 475 504 672 856 971 973 984 1002 1078 
136 137 201 325 383 542 543 550 635 695 759 1016 1068 
50 101 143 246 370 618 622 657 1038 
649 650 673 674 714 792 798 872 1011 
248 260 267 385 392 492 501 613 
275 429 512 587 775 943 1074 
191 192 405 518 648 
331 456 557 
