31 43 46 53 54 77 89 92 99 100 103 104 129 130 144 151 153 154 165 173 174 178 205 209 218 221 230 236 244 247 251 253 264 282 300 301 308 329 335 343 344 359 364 369 390 423 450 452 453 454 458 459 469 487 488 494 496 507 510 516 524 527 528 532 558 559 561 568 569 578 591 614 615 617 664 668 669 697 701 716 725 726 727 728 729 743 747 748 751 756 765 779 796 816 823 834 837 839 856 873 898 925 930 940 960 963 970 1022 1055 1059 1063 
73 74 156 175 188 189 191 192 208 225 227 279 280 283 284 296 303 313 314 319 330 345 346 349 350 354 355 367 368 378 379 385 386 396 401 402 404 405 409 420 422 426 442 468 490 491 497 518 520 536 586 597 604 606 607 638 648 662 667 670 676 678 694 695 711 744 749 750 813 822 827 835 951 952 966 1003 1004 1010 1020 1023 1068 
5 12 16 17 20 23 26 33 35 38 39 48 72 97 98 120 141 163 195 211 237 270 304 326 334 380 391 449 466 514 530 540 546 565 570 577 610 611 631 642 647 659 680 717 718 755 789 820 832 865 867 881 882 896 906 909 910 931 936 953 955 964 985 990 991 998 999 1006 1017 1024 1049 1065 1066 
1 2 42 51 55 57 115 142 164 179 186 240 248 269 272 287 293 297 324 338 347 348 374 408 412 428 431 433 434 438 460 476 486 493 508 511 515 519 521 541 551 583 599 621 632 634 640 661 663 709 722 733 768 776 782 784 793 815 838 860 861 862 874 892 919 923 946 986 1027 1060 1083 
24 75 80 91 102 118 159 171 172 180 220 224 226 271 286 309 310 320 321 339 340 363 375 387 400 411 416 440 461 504 509 533 549 575 593 595 619 620 623 629 666 715 734 737 741 742 746 754 760 764 812 829 844 858 908 914 915 916 941 942 965 967 975 978 992 1002 1008 1012 1043 1061 1071 
0 40 59 86 87 96 126 128 147 160 161 166 181 184 228 229 250 260 261 267 274 281 291 311 328 341 365 392 393 415 463 470 471 472 501 517 522 563 564 602 646 658 671 693 710 719 794 821 825 849 876 878 897 920 947 950 977 1018 1064 1078 
28 68 69 88 109 114 116 127 133 135 140 162 182 196 197 199 214 215 216 239 257 262 265 277 289 290 312 342 360 362 376 388 421 430 436 482 506 535 579 585 596 609 627 654 660 703 763 777 778 800 843 864 879 887 911 939 959 1001 1080 1082 
7 93 148 167 185 190 198 212 245 254 384 398 399 418 484 545 580 625 630 636 643 644 675 696 712 738 745 773 774 787 788 797 801 817 818 845 852 853 855 870 877 884 885 972 974 988 995 1033 1036 1050 1067 1076 1077 1084 
37 64 94 95 145 187 231 232 276 278 285 397 406 427 479 480 531 562 624 633 635 665 692 698 739 740 809 814 851 859 883 924 932 937 1037 1075 
27 44 49 65 107 108 177 200 204 219 238 252 266 356 357 382 407 446 447 451 523 526 652 677 687 691 785 786 802 926 1039 1058 
139 176 234 268 372 389 395 502 503 538 554 556 589 639 723 724 730 766 767 769 810 811 863 875 944 948 956 958 976 1021 1057 1079 
52 58 206 294 295 298 351 366 377 403 435 560 576 584 592 616 641 681 702 757 890 957 981 996 1016 1028 1029 1069 
70 71 90 105 106 110 113 117 123 255 256 417 483 529 544 655 830 850 866 945 968 997 1015 1026 1032 1042 1047 1048 
62 76 138 217 258 315 331 336 371 475 557 653 672 704 753 762 841 842 893 913 922 973 1000 1035 1072 
3 9 10 11 13 14 15 18 19 22 29 32 34 47 119 373 500 605 688 689 690 806 905 979 
66 67 79 81 111 132 169 241 465 467 495 505 612 707 708 752 799 807 918 935 938 982 1040 
30 131 207 259 288 333 353 445 462 555 759 761 772 783 888 889 899 904 928 984 1005 1013 
61 85 121 273 299 317 318 481 498 499 534 537 547 548 571 684 758 901 907 917 1009 
122 157 158 168 183 193 292 305 332 443 590 608 626 656 927 1030 1052 1070 
21 25 36 41 45 63 112 124 222 352 419 474 628 685 781 994 1051 
50 78 101 246 370 448 455 456 489 622 706 770 791 808 971 993 1038 
82 83 125 134 152 155 263 361 413 414 464 539 804 846 949 1025 1054 
56 84 194 202 203 210 223 249 492 582 613 637 780 824 895 1046 
322 323 473 601 645 826 847 848 854 857 902 903 954 1073 
381 552 553 574 588 598 603 705 713 721 1019 1034 1062 
136 137 201 325 383 477 478 513 542 543 550 1056 
358 410 432 439 572 594 686 720 894 933 934 983 
4 8 60 146 525 573 581 731 732 831 1053 
327 337 424 425 444 485 651 790 828 836 969 
149 170 302 441 679 699 700 771 805 980 
150 566 567 682 840 891 912 929 1041 1081 
233 683 803 833 868 869 871 921 1007 1031 
6 275 429 512 587 775 880 943 1074 
649 650 673 674 714 792 798 872 1011 
213 457 735 736 795 819 900 
235 600 886 987 1014 
143 437 618 657 
242 243 316 394 
