0 11 62 63 68 69 87 116 124 132 134 159 160 164 165 173 174 179 180 209 223 224 234 246 251 252 253 259 271 272 286 308 315 327 330 335 337 338 339 347 348 359 361 365 373 395 397 416 421 423 433 434 438 466 467 470 476 485 486 493 494 501 504 506 511 512 515 521 527 530 534 551 556 558 569 582 618 621 622 629 632 640 646 659 664 682 693 716 727 728 729 743 746 753 754 768 788 793 803 804 807 808 827 835 839 844 858 897 899 929 937 940 969 985 998 1002 1007 1021 1022 1059 1060 1071 1074 1081 1083 
1 2 5 7 10 16 20 21 22 25 33 41 44 45 46 50 53 54 78 88 103 104 144 148 151 168 177 192 211 219 266 304 336 358 371 377 384 410 419 424 425 429 448 458 472 474 482 483 484 489 514 516 540 541 549 553 584 602 606 607 615 616 635 651 655 670 677 681 755 773 776 781 782 791 797 801 802 818 837 840 865 866 871 891 892 893 894 900 916 936 983 994 999 1038 1054 1055 1058 1069 1076 
86 101 102 111 112 128 145 162 169 176 181 203 206 207 210 215 233 267 275 276 283 285 291 298 312 320 321 340 351 366 369 370 376 387 392 393 398 414 435 436 446 460 463 464 471 480 517 528 546 554 568 573 585 586 594 599 612 617 628 631 636 660 665 668 686 707 712 719 720 775 814 828 829 843 849 851 859 876 883 911 932 933 941 942 944 972 978 981 1017 1037 1061 
24 30 31 40 74 84 85 96 126 133 136 142 158 172 183 193 218 220 237 268 270 273 292 300 305 309 310 318 329 332 342 388 412 441 443 502 503 522 538 550 570 578 580 583 589 590 592 611 619 620 654 694 695 706 715 722 724 733 737 770 771 780 783 789 862 863 868 874 879 887 888 898 904 927 946 947 964 971 977 993 1010 1036 1065 1068 1079 1084 
3 6 13 18 35 36 38 39 48 58 60 61 72 82 95 140 152 184 197 239 269 294 325 326 343 349 350 381 401 417 422 455 475 477 478 487 488 496 529 552 565 574 576 587 588 603 608 626 645 680 689 705 713 721 726 732 735 736 749 750 757 758 763 766 767 769 810 811 816 823 824 867 906 922 943 959 1000 1024 1030 1034 1043 1051 1062 1064 1070 
9 17 19 23 27 28 37 55 56 57 59 64 73 79 80 139 147 171 189 226 241 262 274 297 302 313 319 322 323 324 333 363 364 367 368 385 396 400 407 418 431 439 461 469 497 531 533 544 555 559 591 593 624 652 663 679 683 734 741 742 745 764 785 794 826 833 877 902 903 909 910 920 921 952 967 992 997 1001 1004 1026 1031 1042 1050 1073 
4 89 91 92 97 120 121 127 141 143 146 155 190 194 195 199 202 213 214 235 240 254 257 263 265 277 288 341 409 415 430 432 437 444 457 481 495 505 507 525 539 547 548 577 605 623 625 637 666 667 671 701 756 760 786 795 800 819 825 882 886 907 928 951 953 954 973 979 982 1008 1014 1020 1025 1040 1046 1053 
15 42 43 49 51 76 77 156 186 187 227 232 236 238 248 261 278 296 299 303 374 394 406 427 428 442 447 491 492 520 524 526 537 581 597 610 613 678 692 709 725 751 752 761 799 815 820 842 912 913 966 1027 1072 
52 99 106 107 122 123 135 178 230 264 328 375 382 389 451 452 454 459 462 473 508 509 510 519 523 561 566 567 601 614 634 669 698 708 739 740 747 779 796 809 847 848 854 860 861 890 919 950 960 970 1052 1078 1082 
26 75 94 108 109 114 115 131 157 188 216 258 289 290 353 380 404 445 449 596 609 649 673 691 703 714 772 778 792 798 805 832 852 855 869 872 889 923 924 925 1005 1006 1013 1049 1075 1080 
93 125 167 170 200 201 212 228 245 280 383 562 571 600 648 657 658 675 700 710 730 744 759 787 817 850 853 870 885 935 980 987 988 1003 1033 1039 1067 1077 
67 129 130 150 175 185 196 198 208 242 243 255 256 260 279 390 408 465 500 595 662 672 731 926 938 984 1012 1047 
14 70 71 90 105 110 113 117 118 153 154 244 282 413 630 688 830 873 945 949 968 1015 1032 1048 
66 166 182 191 205 229 231 250 317 346 356 386 402 405 572 633 777 812 856 918 1063 
217 221 345 391 411 450 575 598 643 644 653 674 704 738 774 790 836 845 1011 1019 1035 
98 287 295 372 403 426 518 650 676 696 697 813 838 875 931 934 948 956 1023 1057 
8 29 32 34 47 65 119 360 440 513 690 806 905 976 995 996 
12 247 334 532 647 717 718 841 880 896 930 958 990 991 1066 
138 249 281 284 293 311 314 344 355 420 831 884 895 939 1018 
81 161 301 316 378 379 542 543 545 639 857 878 
479 490 560 641 702 748 908 957 965 975 
100 149 399 453 535 579 699 834 881 
204 498 499 661 687 762 846 955 963 
83 163 352 362 642 656 765 
222 468 638 685 711 723 822 
684 901 917 1009 
225 536 974 
331 456 557 
354 1041 1056 
357 784 986 
563 564 821 
604 1028 1029 
