73 74 76 156 175 188 189 191 192 208 227 255 258 279 280 283 284 296 303 313 314 315 319 330 331 336 345 349 350 354 355 368 371 378 379 381 386 401 402 404 405 420 422 442 468 490 491 518 544 552 553 574 586 588 597 598 603 604 606 607 638 648 662 667 670 694 705 711 713 721 744 749 750 753 813 822 827 835 913 951 952 1003 1004 1010 1019 1020 1034 1062 1072 
16 75 80 99 102 118 159 171 180 187 225 226 271 286 309 310 320 321 339 363 375 387 400 416 440 452 459 461 497 509 510 549 558 559 595 617 619 620 629 633 666 668 669 693 698 733 737 739 740 747 748 756 760 790 814 829 844 914 915 916 941 942 970 975 978 992 1008 1026 1042 1043 1061 1071 
5 12 17 20 23 26 33 35 38 39 48 72 97 98 141 195 211 237 240 270 304 326 334 380 391 449 466 514 527 530 540 546 565 570 577 610 611 631 659 680 789 820 865 867 881 882 896 906 909 910 931 936 953 955 964 999 1006 1017 1024 1065 
53 54 56 57 64 100 103 104 151 164 178 179 209 236 248 264 272 297 301 308 324 327 340 343 344 347 348 369 374 428 433 434 460 486 489 508 516 521 524 541 568 569 613 661 663 664 709 725 726 751 754 808 816 963 1059 1060 
88 92 96 120 125 126 128 135 147 148 149 160 161 166 167 170 181 184 185 190 198 250 261 311 312 376 419 441 506 545 563 643 644 660 712 774 787 805 825 843 870 876 877 885 897 911 917 947 977 980 1014 1033 1064 1067 1077 1082 
58 59 77 86 142 145 162 186 221 231 232 269 278 291 293 298 365 393 411 412 448 469 471 476 480 493 511 515 531 533 551 592 621 632 634 640 665 699 700 722 727 728 768 779 784 793 850 883 892 919 932 1035 1083 
40 52 87 89 150 172 202 203 223 228 249 281 377 463 470 472 517 566 567 575 614 623 646 658 671 681 682 710 719 743 757 758 764 794 796 812 840 878 890 891 895 901 912 920 940 950 996 1018 1028 1029 1041 
42 46 51 55 129 130 144 205 218 253 266 276 338 359 364 390 415 427 431 453 454 458 487 496 507 528 561 583 593 615 691 692 697 701 734 765 776 834 837 838 874 930 960 1001 1027 1037 1055 1063 
24 27 44 49 62 65 85 91 107 108 200 204 217 219 238 251 252 356 357 382 426 447 451 520 523 526 537 653 676 677 687 704 746 773 802 845 858 922 926 965 1012 1023 1039 
43 153 154 163 165 173 174 210 220 244 247 256 282 288 329 366 408 450 488 494 532 536 578 591 641 642 715 717 718 741 742 839 862 873 898 928 967 986 990 991 1022 1066 
28 68 69 109 116 127 140 182 196 197 199 214 215 216 235 239 257 262 265 277 290 342 360 362 388 421 430 482 535 579 585 596 654 703 763 777 778 800 887 959 1080 
31 61 84 115 121 194 260 267 273 287 299 317 318 346 385 392 396 409 436 438 481 492 498 499 501 534 547 548 571 582 609 637 684 729 780 824 907 1046 
122 157 158 168 193 292 294 295 305 332 353 403 435 443 445 502 503 556 584 590 608 626 656 817 852 855 889 974 981 988 1013 1030 1052 1069 1070 1079 
7 93 212 245 254 302 384 398 399 418 437 484 580 630 636 675 679 696 738 745 771 788 797 801 818 853 884 886 972 995 1009 1036 1050 1076 1084 
0 1 2 3 4 9 10 11 13 14 15 18 19 22 25 29 32 34 47 119 352 373 500 587 605 625 688 689 690 775 806 905 979 994 
6 21 114 133 177 274 289 407 446 519 599 652 716 762 782 786 841 842 860 861 879 880 893 923 939 946 1000 1058 
36 45 63 70 71 90 105 110 112 113 117 124 474 477 478 513 628 685 832 929 1048 1049 1051 1056 1081 
66 67 79 81 111 132 169 241 465 467 495 612 707 708 752 799 807 821 918 935 938 982 1040 
131 206 207 259 351 462 505 555 560 576 702 755 761 767 769 772 785 888 899 957 1005 1015 
139 176 234 367 372 389 395 538 554 589 616 723 724 863 875 944 948 956 958 976 1021 1057 
8 30 60 146 333 525 573 581 639 731 732 766 783 810 811 815 831 859 904 1053 
50 78 101 242 243 246 316 370 394 455 456 479 557 622 706 770 791 908 993 1038 
37 41 94 95 183 222 285 397 406 562 624 781 809 851 924 927 937 1075 
82 83 134 152 155 263 361 413 414 464 539 804 846 894 949 983 1025 1054 
322 323 473 600 601 645 826 847 848 854 857 902 903 954 985 987 998 1073 
213 233 457 683 735 736 795 803 819 833 868 869 871 900 921 1007 1031 
136 137 201 325 383 542 543 550 635 695 759 1016 1068 
106 123 417 483 529 655 830 866 945 968 997 1032 
224 649 650 673 674 678 714 792 798 872 966 1011 
337 424 425 444 485 522 602 647 651 828 836 969 
341 358 410 432 439 572 594 686 720 849 933 934 
138 229 230 328 475 504 672 973 984 1002 1078 
143 268 300 423 618 657 730 823 925 
275 429 512 943 1074 
335 856 971 
