73 74 76 156 175 188 189 192 208 227 255 258 279 280 283 284 293 296 303 313 314 315 319 330 349 350 354 368 378 379 381 386 401 402 404 405 420 422 442 445 468 490 491 544 586 597 604 606 607 638 648 662 667 670 694 711 744 749 750 753 813 822 827 835 889 892 913 951 952 1003 1004 1010 1013 1020 1072 
0 1 2 3 4 6 9 10 11 12 13 14 15 18 19 21 22 25 29 32 34 44 47 52 114 119 133 177 289 352 373 377 407 446 500 519 587 599 605 623 625 652 681 688 689 690 716 757 762 775 781 782 786 806 841 842 879 880 890 893 905 923 939 946 979 994 1058 
5 20 23 26 33 35 38 39 48 72 97 98 112 120 124 141 195 211 237 240 270 326 343 380 449 466 489 514 527 530 540 546 565 570 577 610 611 628 631 680 685 789 808 816 820 865 867 881 882 906 909 910 929 931 936 953 955 964 985 998 999 1006 1024 1065 1081 
42 46 53 54 102 103 129 130 144 159 171 172 209 218 253 266 276 301 308 309 310 338 344 359 364 369 390 427 431 454 458 507 523 524 549 561 568 569 621 629 664 691 692 697 709 725 737 751 765 773 776 802 845 874 886 916 930 960 963 966 1026 1037 1042 1059 
16 75 99 118 225 226 286 320 321 339 375 387 400 416 440 452 459 499 509 510 551 558 559 595 617 619 620 633 666 668 669 693 698 733 739 740 747 748 756 760 790 814 815 829 844 896 908 914 915 941 942 970 975 978 1008 1043 1061 1071 
17 36 45 56 57 63 64 70 71 90 100 105 110 113 117 151 164 178 179 180 236 248 264 272 297 298 324 327 334 340 347 348 428 433 434 460 461 474 477 478 486 497 508 515 521 541 592 661 663 754 832 1017 1048 1049 1051 1056 1060 
28 61 68 69 109 115 116 127 140 182 196 197 199 214 215 216 235 239 257 262 265 277 287 290 312 342 346 360 362 376 388 409 421 430 438 482 513 535 579 585 596 627 654 703 763 777 778 800 843 887 911 959 995 996 1028 1029 1080 
24 27 37 49 65 80 85 107 108 142 145 187 200 204 217 219 232 238 252 271 356 357 363 382 411 426 447 451 480 493 520 526 531 537 583 624 676 677 687 699 700 771 838 883 926 932 965 992 1012 1023 1035 1039 
88 92 96 125 126 128 135 147 148 149 160 161 166 167 170 181 184 185 190 198 250 261 311 355 419 441 506 545 563 660 712 805 825 862 870 876 897 917 947 977 980 1064 1067 1077 1082 
40 89 150 202 203 223 249 281 413 414 463 470 472 476 517 566 567 575 614 646 651 671 682 719 743 758 764 779 794 796 812 840 878 891 895 901 912 920 949 950 1018 1041 1054 
153 154 212 213 244 245 282 288 384 398 399 418 437 484 580 630 636 675 696 717 718 735 736 738 745 788 801 818 819 853 873 884 900 972 986 990 991 1009 1032 1036 1050 1066 1084 
104 122 157 158 168 193 292 294 295 305 332 353 403 435 443 453 487 496 502 503 516 556 584 590 608 626 656 726 817 834 852 855 974 981 988 1000 1016 1030 1052 1069 1070 1079 
58 59 77 86 87 162 186 221 228 268 269 274 278 291 329 341 365 374 393 412 450 469 471 511 533 591 634 640 658 710 727 728 730 784 793 860 861 919 1011 
131 206 207 210 242 243 259 316 351 366 394 408 462 494 505 555 560 576 702 755 761 772 785 839 864 888 899 928 940 945 957 1005 1015 
51 55 136 137 201 205 304 325 383 391 415 528 542 543 550 593 615 635 659 695 701 734 759 837 1001 1027 1055 1063 1068 
82 83 134 152 155 263 331 336 358 361 371 410 432 439 464 539 572 594 686 720 804 846 849 894 933 934 983 1025 
121 273 317 318 337 424 425 444 448 481 485 498 534 547 548 571 632 647 684 722 768 828 836 850 907 969 1083 
43 62 163 165 173 174 220 251 256 488 532 536 578 641 642 653 704 715 741 742 898 922 967 1022 
139 176 234 367 372 389 395 538 554 589 616 723 724 767 769 863 875 944 948 956 958 976 1021 1057 
66 67 79 81 111 132 169 241 465 467 495 612 707 708 752 799 807 821 918 935 938 982 1040 
50 78 101 143 246 300 370 423 455 456 479 557 618 622 657 706 770 791 823 925 993 1038 
8 30 60 146 333 525 573 581 639 731 732 766 783 810 811 831 859 904 1053 
41 94 95 183 222 231 285 397 406 522 562 602 665 809 851 924 927 937 1075 
7 93 254 600 601 643 644 645 774 787 797 854 877 885 987 1014 1033 1076 
138 229 230 247 328 335 475 504 672 856 971 973 984 1002 1078 
91 224 649 650 673 674 678 714 746 792 798 858 872 
345 552 553 574 588 598 603 705 713 721 1019 1034 1062 
31 84 194 299 436 582 609 637 729 780 824 1046 
233 457 683 795 803 833 868 869 871 921 1007 1031 
322 323 473 826 847 848 857 902 903 954 1073 
260 267 385 392 396 492 501 613 
275 302 429 512 679 943 1074 
123 417 830 866 968 997 
106 483 529 655 
