0 11 62 63 87 105 113 116 132 159 160 164 165 173 174 178 179 180 209 224 236 251 252 264 271 272 286 305 308 315 327 339 347 348 359 373 395 397 423 433 434 466 467 470 475 485 486 493 506 512 521 530 534 551 556 569 601 621 622 629 646 659 664 716 729 746 753 754 788 804 807 854 858 897 937 985 998 1007 1021 1022 1048 1059 1060 1071 1074 
101 111 112 117 162 169 206 207 210 275 276 340 366 369 370 414 446 460 463 464 494 517 528 546 554 568 573 599 612 628 631 636 651 660 665 668 693 707 719 720 776 814 828 839 849 911 940 944 1001 1037 
68 124 223 234 235 259 337 338 361 365 421 438 476 511 515 640 682 767 769 808 827 835 899 929 969 1081 
43 49 51 77 156 238 278 299 303 374 394 442 447 491 520 524 526 537 581 597 751 752 799 912 1027 
1 2 12 22 41 50 144 192 247 334 358 429 496 532 540 541 837 841 896 930 958 994 1038 1054 
74 84 85 96 133 220 309 310 342 479 582 619 620 654 706 715 737 770 780 879 887 993 1010 
23 91 120 134 194 195 199 202 203 214 240 257 265 277 430 637 800 882 952 954 973 
52 375 452 454 459 462 473 508 509 558 617 633 669 708 709 747 779 809 890 919 970 
44 88 103 148 177 184 219 266 425 474 514 677 773 802 936 965 1046 1058 1064 
19 55 56 57 64 226 322 323 364 400 439 461 497 559 785 902 903 1073 
69 108 109 114 115 157 216 289 290 482 585 596 609 691 703 778 869 1080 
248 324 407 431 457 591 652 663 741 742 826 833 921 997 1026 1031 1042 
66 166 182 205 231 250 317 346 356 386 402 572 777 812 918 1063 
92 97 121 155 185 190 198 254 263 419 432 539 625 886 983 1025 
106 107 122 123 186 382 389 632 634 768 850 860 861 1052 1083 
4 141 146 525 577 666 667 671 760 951 953 1008 1020 1053 
158 168 193 292 332 443 502 503 592 868 946 947 977 1079 
18 48 325 477 478 498 529 655 757 762 846 1034 1062 
35 72 75 94 649 673 674 714 792 798 872 924 1075 
73 131 188 189 258 296 313 319 330 404 544 795 1005 
93 125 200 562 600 645 744 787 817 935 988 1003 1039 
79 86 145 233 241 291 393 471 480 683 883 932 
221 391 411 450 575 598 738 774 836 845 1011 1019 
13 36 38 82 95 417 565 576 680 906 1051 
187 217 232 261 406 428 451 643 761 815 1035 
20 45 46 53 54 78 104 424 516 943 
24 29 32 34 47 119 690 806 888 905 
30 31 142 273 590 611 759 783 1065 
102 283 392 398 586 594 686 775 933 
3 6 39 60 239 455 732 763 
14 71 118 630 853 968 1015 1032 
70 153 244 245 282 413 873 949 
129 163 208 260 390 642 662 765 
167 212 213 571 772 870 1067 1077 
176 215 312 376 712 843 851 859 
295 353 403 445 875 889 925 1013 
333 418 593 602 635 701 734 1050 
487 488 587 626 689 726 1030 1070 
553 782 797 840 866 891 916 1076 
5 7 10 21 472 615 1055 
16 143 384 437 675 818 900 
40 270 300 318 412 538 863 
59 363 385 396 644 967 992 
98 372 518 813 838 931 934 
136 218 550 589 694 695 1068 
281 284 314 344 420 884 1018 
345 606 607 648 670 885 1033 
381 552 574 603 705 713 721 
441 570 580 583 722 964 1084 
8 65 360 513 976 996 
9 139 171 623 910 1017 
15 42 76 842 913 1072 
27 28 37 80 262 624 
58 294 735 736 1000 1024 
89 335 527 727 728 743 
135 147 519 566 567 1082 
140 197 588 824 922 959 
151 152 227 331 336 371 
228 280 657 658 710 730 
249 293 311 831 895 939 
341 410 415 819 927 928 
349 350 401 422 749 750 
495 505 605 979 982 1040 
17 274 555 764 909 
83 352 362 656 987 
100 149 399 699 881 
191 246 405 416 803 
253 427 618 678 966 
255 595 926 1012 1047 
287 650 948 956 1057 
367 368 877 1004 1014 
377 483 484 871 880 
468 638 711 723 822 
481 547 548 756 907 
490 641 702 748 957 
26 852 855 923 
67 130 465 938 
90 110 268 724 
137 201 304 383 
150 500 672 731 
204 499 661 963 
229 230 856 971 
242 243 408 862 
256 536 578 898 
267 492 613 692 
269 608 823 1043 
326 343 816 867 
328 523 950 1078 
357 784 793 986 
380 449 489 805 
453 535 579 834 
542 543 545 857 
549 616 681 892 
584 865 999 1069 
647 717 718 801 
688 830 904 945 
33 211 755 
154 288 409 
161 316 378 
170 700 980 
181 285 876 
237 388 789 
320 321 829 
354 1041 1056 
379 639 878 
387 972 978 
426 676 1023 
435 981 1016 
444 786 825 
458 501 844 
531 533 745 
560 908 975 
561 796 960 
563 564 821 
604 1028 1029 
610 725 820 
614 847 848 
653 704 790 
698 739 740 
766 810 811 
771 874 1036 
832 1006 1049 
941 942 1061 
990 991 1066 
