0 11 62 63 68 69 87 105 110 113 116 124 132 134 159 160 164 165 173 174 179 180 209 223 224 234 246 251 252 253 259 271 272 286 308 315 327 335 337 338 339 347 348 359 361 365 373 395 397 405 416 421 423 433 434 438 457 458 466 467 469 470 476 485 486 493 494 501 504 506 511 512 515 521 527 530 534 551 556 558 569 582 618 621 622 629 632 640 646 659 664 669 682 693 709 716 727 728 729 743 746 747 753 754 768 788 793 795 803 804 807 808 839 844 858 897 899 929 937 940 969 970 981 985 998 1002 1007 1016 1021 1022 1048 1059 1060 1071 1074 1081 1083 
1 2 5 7 10 12 20 21 25 33 41 44 45 46 50 53 54 78 88 103 104 144 148 151 168 177 192 211 219 230 236 247 266 334 358 377 419 424 425 429 448 472 474 483 484 489 514 516 532 540 541 549 553 602 615 616 635 647 677 681 717 718 755 773 781 782 791 797 801 802 837 840 841 866 871 880 891 892 896 916 930 936 943 958 965 990 991 994 1038 1046 1054 1055 1058 1066 1076 
86 101 102 111 112 117 128 145 162 169 176 181 203 206 207 210 215 233 267 275 276 283 285 291 298 312 320 321 340 351 366 369 370 376 387 392 393 398 435 436 446 460 463 464 471 480 517 528 546 554 568 573 585 586 594 599 612 617 628 631 636 651 660 665 668 686 707 712 719 720 775 776 814 827 828 829 843 849 851 859 876 883 911 932 933 941 942 944 972 978 1001 1017 1037 1061 
15 42 43 49 51 52 76 77 99 106 107 122 123 135 156 178 186 187 227 232 238 261 264 278 296 299 303 328 374 375 382 389 394 406 427 428 442 447 451 452 454 459 462 473 491 492 508 509 510 519 520 523 524 526 537 566 567 581 597 613 634 692 698 708 739 740 751 752 761 766 767 769 779 799 809 810 811 815 835 842 860 861 890 912 913 919 950 966 1027 1052 1072 1078 1082 
24 30 31 40 74 84 85 90 96 126 133 136 142 158 172 183 193 218 220 237 268 270 273 292 300 305 309 310 318 329 332 342 388 412 441 443 479 502 503 522 538 550 570 578 580 583 589 590 592 611 619 620 654 694 695 706 715 722 724 733 737 770 771 780 783 789 862 863 868 874 879 887 888 898 904 927 946 947 964 971 977 993 1010 1036 1065 1068 1079 1084 
4 16 23 89 91 92 97 120 121 127 141 143 146 155 190 194 195 199 202 214 240 254 257 263 265 277 288 341 384 409 415 430 432 437 444 481 495 505 507 525 539 547 548 577 605 623 625 637 666 667 671 701 756 760 786 800 818 819 825 882 900 907 928 945 951 952 953 954 973 979 982 1008 1020 1025 1040 1053 
26 73 75 94 108 109 114 115 131 137 157 188 189 201 216 258 289 290 304 313 319 330 353 357 380 383 404 410 445 449 482 544 596 609 649 673 674 678 691 703 714 759 772 778 784 792 798 805 832 852 855 869 872 889 893 894 923 924 925 983 986 1005 1006 1013 1049 1075 1080 
70 93 125 153 154 167 170 185 198 200 204 212 213 228 244 245 280 282 413 414 499 562 571 600 601 606 607 645 648 657 658 661 670 675 700 710 730 744 787 817 850 853 854 870 873 885 934 935 949 963 980 988 1003 1033 1039 1067 1077 
3 6 13 35 36 38 39 58 60 61 72 82 95 152 184 239 269 294 349 350 401 417 422 455 456 475 487 488 496 565 576 587 608 626 680 689 726 732 735 736 749 750 758 763 823 906 1000 1024 1030 1043 1051 1064 1070 
9 17 19 27 28 37 55 56 57 64 80 139 171 226 262 274 322 323 333 364 400 439 461 497 531 533 555 559 624 745 764 785 794 902 903 909 910 920 1073 
59 147 248 297 324 336 363 367 368 371 385 396 407 418 431 591 593 652 663 734 741 742 826 833 877 921 967 992 997 1004 1014 1026 1031 1042 1050 
18 48 140 197 325 326 343 381 477 478 498 529 552 574 588 603 655 687 705 713 721 757 762 816 824 846 867 922 955 959 1034 1062 
14 71 98 118 191 287 295 372 403 426 518 630 650 676 688 696 697 813 830 838 875 931 948 956 968 1015 1023 1032 1057 
67 79 129 130 150 175 196 208 241 242 243 255 256 260 279 390 408 465 500 595 662 672 683 731 926 938 984 1012 1047 
217 221 345 391 411 450 561 575 598 610 614 643 644 653 704 725 738 774 790 796 820 836 845 847 848 960 1011 1019 1035 
8 22 29 32 34 47 65 119 360 440 513 584 690 806 865 905 976 995 996 999 1069 
66 166 182 205 231 250 317 346 356 386 402 572 633 777 812 918 1063 
138 249 281 284 293 311 314 344 355 420 831 884 895 939 1018 
81 161 301 302 316 378 379 542 543 545 639 679 857 878 
100 149 399 453 535 579 699 834 881 
83 163 352 362 642 656 765 987 
490 560 641 702 748 908 957 975 
222 468 638 685 711 723 822 
684 901 917 1009 
225 536 974 
354 1041 1056 
563 564 821 
604 1028 1029 
