43 56 58 77 84 86 99 128 165 173 174 202 218 230 247 251 253 274 291 301 335 341 359 364 365 423 452 454 459 471 488 492 494 496 510 527 531 532 558 559 561 568 569 582 613 614 615 617 621 637 668 669 693 698 701 709 716 725 727 728 739 740 747 748 756 765 776 780 785 796 815 824 839 856 930 960 963 970 1022 1055 
73 74 156 163 175 188 189 191 192 208 225 227 279 280 283 284 293 296 303 313 314 319 330 345 349 350 354 355 367 368 376 378 379 385 386 396 401 402 404 405 420 422 442 468 490 491 497 518 520 536 586 597 604 606 607 638 648 662 667 670 694 695 711 744 749 750 822 827 835 885 892 951 952 1003 1004 1010 1020 1033 1068 
5 12 16 17 20 23 26 33 35 38 39 48 72 97 98 100 120 141 178 195 211 237 264 270 304 326 334 380 391 449 466 489 514 530 540 546 565 570 577 610 611 631 642 647 659 680 717 718 755 789 808 820 832 865 867 881 882 896 906 909 910 931 936 953 955 964 985 990 991 998 999 1006 1017 1049 1065 1066 
2 42 51 55 57 114 142 164 179 186 221 240 248 269 272 297 324 338 347 348 374 408 412 431 433 434 460 469 476 486 493 508 511 515 519 521 541 551 583 599 632 634 640 661 663 733 768 782 784 793 838 850 860 861 862 874 919 923 986 1027 1060 1083 
7 21 93 148 167 190 212 254 327 337 384 398 399 418 419 424 425 444 485 502 503 545 556 580 625 630 643 644 651 675 696 712 738 773 774 787 790 797 801 817 818 825 828 836 845 852 853 855 870 877 884 969 974 988 995 1050 1067 1076 1077 1079 1084 
28 68 69 88 109 116 127 133 135 140 162 182 196 197 199 214 215 216 257 262 265 277 289 290 312 342 360 388 421 430 506 535 585 596 609 627 654 660 703 778 800 864 879 887 911 959 984 1001 1080 1082 
25 36 41 45 61 63 89 96 112 124 161 184 203 210 222 223 249 250 261 311 474 563 564 578 628 682 685 743 758 781 821 840 891 895 898 901 929 939 940 1051 1064 1081 
0 1 3 4 8 9 10 11 13 14 15 18 19 22 29 32 34 47 60 119 146 239 373 500 525 573 581 605 690 731 732 763 806 831 905 979 994 1053 
75 80 102 118 180 226 286 320 321 339 340 375 387 400 416 440 461 509 533 595 619 620 666 754 760 829 844 908 914 915 941 942 975 978 1008 1043 1061 1071 
52 233 294 295 298 351 377 403 435 584 592 681 683 741 742 757 761 803 833 868 869 871 890 921 924 946 947 977 981 996 1000 1007 1016 1028 1029 1031 1069 
66 67 79 81 111 132 153 154 169 177 241 244 282 329 407 446 450 465 467 495 505 591 612 652 707 708 752 786 799 807 873 918 935 938 982 1040 1058 
70 71 85 90 105 106 110 113 115 117 121 273 287 299 317 318 346 409 438 481 483 498 499 529 534 537 571 655 722 899 907 968 1015 1032 1048 
40 87 228 229 281 328 393 411 415 451 463 470 472 517 522 575 602 646 658 671 710 719 764 779 794 812 843 878 920 950 1018 1078 
30 131 206 207 259 288 333 353 366 445 462 555 560 576 639 641 702 759 766 767 769 772 783 810 811 888 889 928 957 1005 1013 
31 46 53 54 92 103 104 129 130 144 151 209 236 308 343 344 369 390 453 487 507 516 524 664 697 726 729 751 816 834 1059 
37 59 64 94 95 187 231 232 276 278 285 363 397 406 427 428 562 593 633 635 665 692 734 809 814 851 859 937 992 1037 1075 
91 159 171 172 194 220 224 252 309 436 504 523 549 623 629 678 715 737 746 802 858 916 966 967 1002 1012 1046 
125 126 147 150 160 166 181 185 198 205 260 267 392 441 458 501 528 566 567 777 805 837 876 897 1041 1063 
27 44 49 65 107 108 200 204 219 238 266 356 357 382 447 526 624 677 687 691 926 1039 
139 176 234 372 389 395 538 554 589 616 723 724 863 875 944 948 956 958 976 1021 1057 
122 157 158 168 183 193 292 305 332 352 362 443 590 608 626 656 927 1030 1052 1070 
78 245 310 448 455 479 484 636 706 745 770 788 791 971 972 993 1036 
62 138 217 331 336 371 456 475 557 653 672 704 922 973 1035 
82 83 134 152 155 263 361 413 414 464 539 804 949 1025 1054 
322 323 473 601 645 826 847 848 854 857 902 903 954 1073 
6 275 429 482 512 579 587 688 689 775 880 943 1074 
358 410 432 439 572 594 686 720 849 894 933 934 983 
381 552 553 574 588 598 603 705 713 721 1019 1034 1062 
76 258 315 753 762 841 842 846 893 912 913 1072 
136 137 201 325 383 477 478 513 542 543 550 1056 
145 149 170 302 480 679 699 700 771 883 932 980 
123 255 256 417 544 866 997 1026 1042 1047 
24 50 101 246 271 370 622 965 1038 
143 268 300 437 618 657 730 823 925 
649 650 673 674 714 792 798 872 1011 
213 457 735 736 795 819 900 1024 
426 676 813 830 904 945 1023 
235 600 886 987 1014 
547 548 684 917 1009 
242 243 316 394 
