218 219 251 327 347 348 363 364 369 374 375 382 393 395 397 400 406 415 427 428 431 433 434 438 439 447 450 451 454 459 460 461 462 464 466 467 469 470 471 472 476 485 486 492 493 494 501 505 508 509 510 511 515 517 519 521 522 527 528 530 531 532 534 537 540 551 554 555 556 558 559 561 568 573 575 582 595 612 617 618 621 622 628 633 636 640 644 646 647 651 659 660 665 668 669 682 693 697 698 701 706 707 709 712 716 719 720 725 727 728 733 746 747 748 753 755 756 765 776 779 781 785 786 787 790 803 814 815 821 823 824 825 826 839 843 849 864 878 896 911 937 968 969 970 972 982 992 993 1021 1037 1039 1060 
68 69 108 109 114 115 116 127 131 215 216 234 235 289 290 304 337 338 359 360 365 380 388 421 422 429 482 506 535 579 585 596 634 637 703 704 729 763 777 778 788 812 834 857 860 861 899 950 954 978 980 998 1005 1080 
188 189 258 259 266 283 296 303 313 319 330 345 354 361 376 386 396 402 404 442 445 468 481 490 491 520 524 544 581 597 604 638 662 678 685 711 730 783 795 822 827 835 884 907 983 
0 1 2 3 4 5 6 7 10 12 13 15 21 25 41 44 50 52 193 352 368 426 545 652 902 903 906 917 960 973 994 1004 1038 1051 1073 
35 36 38 48 60 72 75 98 140 269 270 315 329 391 412 444 463 546 547 548 577 599 631 661 684 769 804 846 863 956 976 981 1011 1016 1035 
133 134 194 195 196 197 199 214 239 246 248 257 265 272 273 276 277 300 312 328 362 381 430 440 572 627 800 918 999 1010 1078 
39 40 61 88 89 96 124 126 128 161 166 176 177 181 184 228 250 261 311 514 563 565 671 749 805 879 939 949 965 1064 
58 59 76 77 86 118 135 145 146 162 167 217 221 233 267 268 274 275 291 385 392 411 643 784 967 1067 1077 1082 
212 552 553 574 588 598 603 606 607 648 705 713 721 744 797 817 853 870 885 916 934 963 974 988 995 1019 1033 1076 
171 172 224 309 310 342 377 436 437 549 623 629 689 737 780 813 876 877 887 891 904 996 1026 1028 1029 1042 
45 46 82 83 92 97 120 121 125 143 155 190 253 254 263 341 384 417 419 432 820 832 836 926 1049 
53 54 78 80 103 104 159 160 180 209 236 271 286 297 308 387 541 600 645 664 858 866 943 1059 1071 
93 147 148 149 150 170 185 198 204 205 401 441 782 881 925 933 966 984 1013 1043 1063 
8 9 11 14 18 19 22 24 29 32 34 47 119 373 609 690 806 905 
317 318 484 498 499 529 570 571 583 632 680 757 758 762 772 840 850 1006 
229 230 301 302 333 418 512 580 593 625 630 675 818 1050 1074 1084 
334 335 424 425 448 449 489 663 734 768 808 873 986 1007 1083 
294 295 353 372 403 435 518 584 656 681 774 875 987 1069 
479 480 679 699 700 738 771 773 810 811 845 883 932 936 
62 63 87 165 173 174 252 423 475 569 922 1022 
452 453 487 488 496 507 516 626 726 944 1030 1070 
42 43 49 51 65 156 200 504 819 865 1027 
141 142 182 473 474 500 605 715 953 959 979 
206 207 351 366 560 576 702 874 908 957 1036 
280 281 284 355 420 739 740 852 855 1018 1058 
314 615 616 723 724 837 892 910 1017 1054 1055 
566 567 741 742 833 888 889 919 921 924 1041 
16 17 20 23 26 33 211 789 882 952 
70 71 90 105 110 113 117 1015 1032 1048 
84 85 91 220 619 958 1012 1034 1062 1079 
101 102 186 187 222 231 232 278 828 856 
136 137 201 325 383 495 562 602 635 1040 
73 74 163 175 208 279 694 695 1068 
157 158 168 183 292 305 332 443 608 
649 650 673 674 792 798 872 948 1057 
151 152 227 324 331 336 358 371 
247 378 379 672 708 809 880 975 
27 28 37 95 624 951 1001 
30 31 610 611 670 759 1065 
106 107 122 123 389 890 1052 
129 130 144 260 390 523 938 
138 139 262 326 847 848 867 
153 154 244 245 282 413 414 
255 256 367 497 536 578 743 
293 696 722 838 868 869 931 
407 408 446 465 591 862 1031 
912 913 923 946 947 977 1072 
55 56 57 64 240 796 
66 67 79 81 241 683 
94 285 714 851 859 1075 
99 100 164 178 179 264 
111 112 169 370 793 794 
191 192 346 405 416 909 
202 203 210 223 249 895 
213 686 687 842 935 1000 
322 323 801 802 920 1046 
666 667 760 844 1008 1020 
237 238 538 539 1025 
339 340 620 750 754 
717 718 764 929 1081 
225 226 927 928 
316 349 350 791 
356 357 410 691 
394 525 526 1053 
478 513 641 642 
586 587 594 775 
735 736 900 1024 
751 752 799 807 
242 243 964 
287 288 409 
298 299 761 
320 321 829 
343 344 816 
455 456 557 
457 458 533 
502 503 592 
542 543 550 
589 590 1009 
601 854 985 
613 614 692 
639 766 767 
657 658 710 
676 677 1023 
731 732 831 
941 942 1061 
961 962 989 
990 991 1066 
