84 99 218 251 253 359 364 423 454 494 496 510 527 531 558 559 561 568 582 615 617 621 668 669 698 701 709 716 727 728 739 740 747 748 756 765 776 785 815 839 930 960 970 1055 
5 16 17 20 26 35 38 39 48 72 97 98 120 141 211 237 270 304 326 449 466 489 546 565 577 610 611 631 789 808 820 867 906 953 955 1065 
188 189 283 296 303 313 319 330 354 376 385 386 396 402 442 468 490 491 520 597 604 638 662 711 822 827 835 
0 1 4 9 10 11 13 14 15 19 22 29 32 34 47 119 373 605 690 806 905 979 994 
7 93 254 384 398 399 418 419 580 630 696 738 773 797 801 818 845 853 884 995 1050 1076 1084 
21 148 167 190 212 502 503 545 556 625 675 712 817 852 855 870 974 988 1067 1077 1079 
46 53 54 103 104 151 209 236 308 343 344 369 516 524 664 726 751 816 1059 
73 74 163 175 208 279 345 404 586 606 607 670 694 695 744 1003 1010 1068 
80 102 118 180 226 375 387 400 440 461 533 666 760 844 908 975 978 1008 
281 393 411 415 463 470 517 575 646 671 719 779 794 843 878 920 1018 
61 89 96 161 184 250 261 311 578 743 758 898 901 939 940 1064 
68 69 109 116 133 216 289 290 388 421 535 609 703 778 879 1080 
142 186 269 476 493 511 515 551 632 634 640 768 784 850 986 1083 
157 158 168 183 193 292 305 332 443 590 608 626 927 1030 1070 
131 207 259 288 462 555 641 702 767 769 888 928 957 1005 
125 126 147 160 166 181 185 198 205 777 876 897 1063 
159 171 172 224 309 436 504 549 623 629 737 916 1002 
75 286 339 340 416 509 595 619 620 754 1043 1071 
233 683 741 742 803 833 868 869 921 924 1007 1031 
540 570 680 832 865 910 931 964 999 1006 1017 1049 
2 248 324 433 434 460 541 663 782 923 
78 310 448 455 479 706 770 791 971 993 
273 317 318 346 409 498 499 534 571 722 
381 552 553 574 598 603 705 713 721 1019 
33 380 514 530 642 755 936 985 998 
37 94 95 285 406 851 859 937 1075 
43 77 165 173 230 247 488 532 1022 
52 377 681 757 871 890 996 1028 1029 
58 86 128 274 291 341 365 471 693 
196 199 214 257 265 277 430 800 984 
465 467 707 752 799 807 918 935 938 
42 51 338 431 583 838 874 1027 
44 49 65 107 238 382 447 526 
55 57 164 240 348 408 862 1060 
327 424 425 444 485 651 825 828 
28 140 342 360 654 887 1001 
50 101 246 271 370 622 1038 
70 90 105 110 113 117 1048 
76 258 315 753 841 842 893 
91 220 715 746 858 967 1012 
111 169 495 505 612 982 1040 
114 221 374 519 599 860 861 
179 297 347 469 486 508 661 
234 538 589 863 948 956 1057 
245 484 636 745 788 972 1036 
280 284 293 314 355 420 892 
298 351 435 592 761 981 1016 
322 323 847 848 902 903 1073 
350 367 368 378 379 497 1004 
401 422 667 749 951 952 1020 
512 587 688 689 775 943 1074 
649 650 673 714 792 798 872 
27 108 200 624 677 691 
40 451 472 522 602 950 
59 187 363 593 734 992 
62 217 653 704 922 1035 
71 483 529 968 1015 1032 
136 137 201 325 383 550 
154 244 282 329 450 591 
176 372 616 723 724 875 
177 407 446 652 786 1058 
223 682 840 891 929 1081 
276 278 427 692 814 1037 
294 295 403 584 1000 1069 
389 395 554 944 976 1021 
452 459 614 725 796 963 
8 146 525 581 1053 
12 334 391 659 896 
25 41 222 685 781 
36 45 63 474 1051 
56 202 637 780 824 
82 134 152 361 804 
88 135 506 660 1082 
92 453 487 507 834 
100 178 264 881 909 
122 352 362 656 1052 
129 130 144 390 697 
194 252 523 802 1046 
204 219 266 687 1039 
331 336 371 456 557 
432 439 720 849 933 
643 644 774 787 877 
735 736 819 900 1024 
30 333 759 783 
64 231 633 665 
67 79 81 241 
83 263 539 1025 
87 228 658 710 
115 287 438 899 
138 475 672 973 
145 480 883 932 
150 566 567 1041 
156 227 349 750 
192 648 885 1033 
203 210 249 895 
206 366 560 576 
242 243 316 394 
255 256 544 1047 
260 267 392 501 
275 429 482 579 
337 790 836 969 
358 410 894 983 
397 562 635 809 
413 414 949 1054 
426 676 813 1023 
473 826 857 954 
477 478 513 1056 
572 594 686 934 
639 766 810 811 
3 239 763 
23 195 882 
66 132 708 
85 299 537 
112 124 628 
121 481 907 
123 417 866 
149 699 771 
170 700 980 
174 335 856 
182 215 596 
191 405 518 
213 457 795 
229 328 1078 
272 521 793 
300 823 925 
320 321 829 
356 357 926 
412 733 919 
445 889 1013 
458 528 837 
547 548 684 
563 564 821 
588 1034 1062 
600 987 1014 
601 645 854 
647 717 718 
731 732 831 
830 904 945 
912 913 1072 
941 942 1061 
946 947 977 
990 991 1066 
997 1026 1042 
