11 124 132 134 159 160 164 165 173 180 209 224 234 236 246 259 271 286 298 305 308 315 337 338 339 347 348 359 361 363 365 373 395 397 427 433 434 439 466 467 470 476 485 486 493 506 511 512 515 530 534 551 556 558 592 601 622 629 640 644 646 647 664 669 678 682 692 716 727 728 729 746 753 785 788 803 804 807 825 854 858 897 937 966 969 985 992 998 1007 1021 1022 1059 1060 1071 1074 
89 101 111 112 117 169 176 207 210 215 275 276 289 291 312 340 366 369 370 376 414 446 460 463 464 471 517 527 528 546 554 568 573 599 612 617 628 631 633 636 651 660 665 668 693 707 712 719 720 754 776 814 828 843 849 851 859 911 944 950 1001 1037 
1 4 5 10 12 20 21 22 25 34 41 44 46 148 352 377 424 425 429 472 549 616 681 781 782 840 866 880 891 902 903 994 996 1073 
24 29 32 47 84 85 96 119 133 220 309 310 342 479 480 619 620 679 690 706 737 750 770 780 806 879 887 888 905 939 993 1034 1062 
93 125 200 553 562 600 606 607 645 648 670 744 787 797 813 817 870 885 904 916 935 974 987 988 1003 1033 1039 1076 
68 69 108 109 114 115 157 216 235 290 294 482 535 596 609 703 735 736 778 832 842 869 1000 1006 1049 1080 
0 62 63 87 105 110 113 116 174 251 252 253 272 327 423 469 521 569 618 793 808 1048 
92 97 121 143 149 155 185 190 198 254 263 419 432 495 539 605 886 979 982 983 1025 1040 
75 94 295 353 403 445 649 673 674 714 792 798 852 855 872 875 923 925 946 1013 1075 
88 103 166 177 184 219 311 426 474 514 561 676 677 773 802 936 960 965 1023 1058 1064 
49 51 187 217 222 232 261 278 394 406 428 447 451 526 538 643 709 815 1027 1035 
35 36 38 72 82 95 152 417 475 565 576 680 767 769 906 1015 1024 1051 
52 375 452 454 459 462 473 508 509 559 708 747 779 809 890 908 970 975 
91 120 194 195 199 214 257 265 277 362 430 637 800 882 954 980 1046 
23 141 146 525 577 666 667 671 758 760 951 952 953 1008 1020 1053 
26 73 131 188 189 258 313 319 330 354 404 544 827 835 1005 1056 
2 7 50 211 334 540 541 615 755 837 892 896 1038 1054 1055 
18 48 168 325 477 478 483 484 498 529 655 762 846 871 
158 193 292 332 441 443 502 503 570 580 583 868 1079 1084 
238 296 303 442 491 520 524 581 597 751 752 795 799 912 
248 324 368 407 457 652 663 741 742 826 833 921 1004 1031 
58 86 102 162 283 392 398 586 594 686 775 933 
3 6 39 60 239 331 455 456 557 732 763 
66 182 205 250 317 386 402 777 812 918 1063 
67 130 242 243 255 408 465 595 862 938 964 
106 107 122 123 382 389 421 791 860 861 1052 
79 233 241 566 567 683 889 919 924 1041 
206 351 490 560 702 748 771 874 957 1036 
221 391 450 575 591 738 774 836 845 1011 
129 163 208 260 390 641 642 662 765 
186 266 267 357 393 621 634 784 986 
302 333 418 593 602 635 701 734 1050 
17 33 274 505 555 761 764 909 
19 55 56 57 64 226 240 364 
40 126 237 270 329 388 412 789 
43 77 156 227 494 537 839 940 
53 54 104 151 297 431 516 691 
74 136 542 550 694 695 1010 1068 
150 196 500 504 672 731 984 1002 
153 154 244 245 282 413 873 949 
16 384 437 623 675 818 900 
147 167 571 772 850 1067 1077 
170 228 280 657 658 710 730 
191 192 346 405 409 416 518 
225 256 461 497 536 578 898 
229 230 231 356 572 856 971 
281 284 314 344 420 884 1018 
288 341 410 415 819 927 928 
381 552 574 603 705 713 721 
688 830 945 968 997 1026 1042 
9 139 171 625 910 1017 
14 71 118 630 853 1032 
27 28 37 80 262 624 
30 31 273 611 783 1065 
61 269 438 608 823 1043 
247 496 532 841 930 958 
299 322 323 374 400 582 
448 489 632 722 768 1083 
468 638 685 711 723 822 
8 65 360 513 976 
15 42 76 913 1072 
70 249 293 831 895 
98 372 838 931 934 
181 285 876 947 977 
287 650 948 956 1057 
349 350 401 422 749 
458 584 865 999 1069 
487 626 726 1030 1070 
610 725 820 929 1081 
99 178 264 510 
100 453 579 834 
144 336 358 371 
145 700 883 932 
197 824 922 959 
201 304 383 759 
202 203 223 973 
204 499 661 963 
326 343 816 867 
345 411 598 1019 
481 548 756 907 
45 78 943 
90 268 724 
135 519 1082 
140 588 757 
161 316 378 
218 300 589 
320 321 829 
328 523 1078 
335 743 796 
367 877 1014 
379 639 878 
380 449 805 
385 492 613 
387 972 978 
399 699 881 
531 533 745 
543 545 857 
547 684 901 
604 1028 1029 
614 847 848 
698 739 740 
717 718 801 
766 810 811 
941 942 1061 
990 991 1066 
