16 17 20 23 26 27 28 33 37 53 54 78 80 94 95 103 104 153 154 157 158 159 160 168 180 183 191 192 209 211 212 213 236 242 243 244 245 271 280 281 282 284 285 286 287 288 292 293 297 308 314 317 318 320 321 322 323 332 346 355 356 357 367 387 398 399 405 407 408 409 410 416 420 443 446 465 483 484 497 498 499 529 541 552 553 566 567 570 571 574 583 588 591 598 600 601 603 606 607 615 616 624 632 648 655 657 658 664 680 686 687 691 696 705 710 713 716 721 722 723 724 739 740 744 745 757 758 762 771 782 788 789 797 801 802 817 829 833 837 838 840 841 842 850 851 852 853 854 855 858 866 868 869 870 871 874 882 885 886 888 889 892 893 894 901 909 910 912 913 914 915 916 919 920 921 923 924 930 931 934 935 940 943 946 947 951 952 963 964 977 985 988 995 997 1001 1006 1018 1019 1031 1032 1033 1036 1046 1055 1058 1059 1071 1072 1075 1076 
55 56 64 218 219 251 252 327 347 348 363 364 369 374 375 382 393 395 397 400 406 415 423 427 428 431 433 434 438 439 447 450 451 454 459 460 461 462 464 466 467 469 470 471 472 476 485 486 492 493 494 501 502 505 508 509 510 511 515 517 519 521 522 527 528 530 531 532 534 537 540 551 554 555 556 558 559 561 568 569 573 575 582 595 612 617 618 621 622 628 633 636 640 646 647 651 659 660 665 668 669 682 693 697 698 701 706 707 709 712 719 720 725 727 728 733 746 747 748 753 755 756 765 776 779 781 785 786 787 790 803 814 815 821 823 824 825 826 839 843 849 864 878 896 911 937 968 969 970 972 982 992 993 1021 1037 1039 1060 
68 69 108 109 114 115 116 127 131 136 137 201 215 216 234 235 289 290 298 299 304 325 334 335 337 338 359 360 365 380 388 421 422 424 425 429 448 449 482 489 503 506 513 535 579 585 592 596 634 637 663 703 704 729 734 761 763 768 777 778 808 812 834 856 857 873 941 942 950 954 978 980 986 996 998 1005 1007 1017 1028 1029 1061 1080 1083 
39 40 58 59 61 76 77 86 88 89 96 118 124 126 128 135 145 146 161 162 166 167 176 177 181 184 217 221 228 233 250 261 267 268 274 275 291 311 385 392 411 514 565 608 613 614 643 644 645 671 692 749 784 805 860 861 862 879 939 949 967 1024 1064 1067 1077 1082 
0 1 2 3 4 5 6 7 8 9 10 11 12 13 14 15 18 19 21 22 24 25 29 32 34 41 44 47 50 52 119 193 350 352 368 373 426 545 609 652 690 806 859 902 903 905 906 917 960 973 994 1004 1034 1038 1051 1062 1073 
35 36 38 48 60 72 75 98 101 102 140 186 187 222 231 232 269 270 278 315 329 391 412 413 414 444 463 546 547 548 577 589 590 599 631 661 684 769 804 828 846 863 881 925 956 976 981 1009 1011 1016 1035 1054 
188 189 258 259 266 283 296 303 313 319 330 345 354 361 376 386 396 402 404 442 445 468 477 481 490 491 520 524 544 581 597 604 638 662 678 685 711 714 730 783 795 822 827 835 884 899 907 983 1041 1056 
45 46 82 83 92 93 97 120 121 125 143 147 148 149 150 155 170 185 190 198 204 205 253 254 263 341 384 401 417 419 432 441 695 820 832 836 926 933 966 984 1013 1043 1049 1063 1068 
229 230 247 301 302 333 378 379 418 512 580 586 587 593 594 625 630 639 666 667 672 675 708 731 732 760 766 767 775 809 818 831 844 880 900 965 975 1008 1020 1050 1074 1084 
73 117 175 206 207 208 279 351 366 479 480 560 576 679 694 699 700 702 735 736 738 772 773 810 811 845 883 908 932 936 957 1000 1015 
133 134 194 195 196 197 199 214 239 240 246 248 257 265 272 273 276 277 300 312 328 362 381 430 440 572 627 800 918 999 1010 1078 
66 67 79 81 132 138 139 241 262 326 452 453 487 488 496 507 516 626 683 726 847 848 867 897 898 944 955 1002 1003 1030 1070 
62 63 70 71 87 90 105 110 113 163 165 173 174 255 256 305 475 478 536 563 564 578 641 642 743 922 1022 1047 1048 
30 31 141 142 182 473 474 500 605 610 611 670 676 677 715 741 742 751 752 759 799 807 904 953 959 979 1023 1065 
42 43 49 51 65 129 130 144 156 200 237 238 260 390 504 523 538 539 770 819 865 938 971 1025 1027 
74 84 85 91 202 203 210 220 223 249 339 340 455 456 557 619 620 653 654 750 754 895 958 1012 1079 
171 172 224 309 310 342 377 436 437 549 623 629 688 689 737 780 813 830 876 877 887 891 1014 1026 1042 
111 112 169 343 344 370 457 458 533 542 543 550 649 650 673 674 792 793 794 798 816 872 948 1057 
57 106 107 122 123 294 295 353 372 389 403 435 518 584 656 681 774 796 875 890 987 1052 1069 
316 349 383 495 562 602 635 717 718 764 791 929 990 991 1040 1066 1081 
151 152 225 226 227 324 331 336 358 371 927 928 945 974 
99 100 164 178 179 264 
394 525 526 1053 
961 962 989 
