73 74 163 175 188 208 245 279 280 284 293 313 314 319 345 355 404 420 586 606 607 648 662 670 694 695 744 831 892 1003 1010 1068 
218 253 359 364 366 454 494 496 527 558 559 615 617 621 668 669 701 727 728 747 748 756 765 776 785 839 930 940 970 1055 
5 35 38 39 48 72 97 98 120 141 270 326 449 466 489 546 565 577 610 611 631 659 808 820 867 906 953 955 1065 
68 69 109 116 133 196 199 214 216 239 257 265 277 289 290 388 421 430 482 535 609 703 763 778 800 879 984 1080 
42 115 281 287 338 393 431 438 463 470 517 575 583 646 671 719 779 838 874 878 899 949 1018 
148 167 190 212 312 545 556 625 675 712 797 817 852 855 870 911 917 974 988 995 1067 1076 1077 
0 3 9 10 11 13 14 15 19 22 29 32 34 47 119 373 605 690 806 905 979 994 
80 102 118 159 171 172 180 224 309 310 375 461 504 549 623 629 737 908 975 1002 
36 45 61 63 89 96 124 161 184 250 474 578 628 743 758 898 901 1051 1064 
254 384 398 399 418 419 580 630 696 738 773 801 818 845 853 884 1009 1050 1084 
189 283 296 303 330 354 386 402 442 468 490 491 597 604 638 827 835 
46 53 54 78 103 104 151 209 236 308 369 455 516 664 726 1059 
1 2 21 25 272 324 433 434 460 521 541 663 781 782 873 
157 158 168 183 193 292 305 332 443 590 608 626 927 1030 1070 
131 207 259 462 555 560 641 702 767 769 888 928 957 1005 
540 570 584 680 832 865 910 931 964 999 1006 1017 1049 1069 
86 128 221 233 274 291 341 436 471 868 869 924 1031 
125 126 147 160 166 181 185 198 205 777 876 897 1063 
282 446 465 467 591 707 752 799 807 918 935 938 
43 77 165 173 230 247 251 487 488 532 1022 
75 286 339 340 509 595 619 620 754 1043 1071 
121 273 317 346 481 498 499 534 571 722 907 
186 269 476 511 515 551 632 634 640 823 850 
226 387 400 440 531 533 666 760 844 978 1008 
381 411 552 553 574 598 603 705 713 721 1019 
33 380 514 530 642 709 755 936 985 998 
40 234 318 538 589 724 863 948 956 1057 
52 377 483 681 757 871 890 996 1028 1029 
452 459 561 568 614 716 725 796 960 963 
12 334 389 395 554 896 944 976 1021 
37 94 95 285 406 851 859 937 1075 
44 49 65 107 238 382 447 520 526 
76 258 315 753 762 841 842 846 893 
129 130 194 252 390 523 802 916 1046 
16 17 20 26 211 237 304 789 
55 57 164 240 348 408 862 1060 
56 84 202 492 582 637 780 824 
111 112 169 495 505 612 982 1040 
327 424 425 444 485 651 825 828 
28 140 342 360 654 887 1001 
59 187 363 734 768 992 1083 
66 67 79 81 132 241 708 
255 256 544 997 1026 1042 1047 
322 323 847 848 902 903 1073 
512 587 688 689 775 943 1074 
643 644 774 787 877 885 1033 
649 650 673 714 792 798 872 
27 108 200 624 677 691 
50 101 144 246 697 1038 
62 217 653 704 922 1035 
90 105 110 113 117 1048 
114 374 519 599 860 861 
223 682 840 891 929 1081 
276 278 427 692 814 1037 
297 347 469 486 508 661 
367 368 378 379 497 1004 
448 706 770 791 971 993 
484 636 745 788 972 1036 
683 741 742 833 921 1007 
60 573 731 732 815 
71 529 968 1015 1032 
82 134 152 361 804 
88 135 506 660 1082 
91 220 746 858 1012 
100 178 264 881 909 
122 352 362 656 1052 
136 137 201 325 383 
149 479 699 700 771 
176 295 372 403 875 
177 407 652 786 1058 
182 215 376 596 843 
192 458 528 837 1054 
204 219 266 687 1039 
298 351 435 981 1016 
331 336 371 456 557 
343 344 524 751 816 
422 667 951 952 1020 
432 439 720 849 933 
451 472 522 602 950 
735 736 819 900 1024 
4 146 525 1053 
30 333 759 783 
51 391 415 1027 
64 231 633 665 
83 263 539 1025 
87 228 658 710 
138 475 672 973 
145 480 883 932 
150 566 567 1041 
156 227 349 750 
242 243 316 394 
249 311 895 939 
337 790 836 969 
358 410 894 983 
365 392 501 693 
397 562 635 809 
426 676 813 1023 
473 826 857 954 
477 478 513 1056 
502 503 592 1079 
572 594 686 934 
616 711 723 822 
639 766 810 811 
23 195 882 
41 222 685 
58 294 1000 
85 299 537 
123 417 866 
142 232 493 
153 413 414 
154 288 409 
174 335 856 
191 405 518 
213 457 795 
229 328 1078 
261 428 761 
271 370 622 
300 423 925 
301 569 593 
320 321 829 
350 401 749 
356 357 926 
412 733 919 
445 889 1013 
453 579 834 
542 543 550 
547 548 684 
563 564 821 
588 1034 1062 
600 987 1014 
601 645 854 
647 717 718 
698 739 740 
784 793 986 
830 904 945 
912 913 1072 
941 942 1061 
946 947 977 
990 991 1066 
