73 74 163 175 188 189 208 245 279 283 296 303 313 319 330 345 350 354 368 376 378 379 385 386 396 402 404 442 468 490 491 520 586 597 604 606 607 638 648 662 670 678 694 695 711 744 827 835 1003 1004 1010 1068 
5 35 38 39 48 72 82 97 98 120 134 141 152 270 326 361 449 466 489 546 565 577 610 611 631 659 804 808 820 867 906 953 955 1065 
68 69 109 116 133 196 199 214 216 239 257 265 277 289 290 388 421 430 482 535 609 703 763 778 800 879 1080 
218 359 364 452 454 459 496 527 558 561 568 614 615 621 701 709 716 725 727 728 765 776 796 930 960 963 1055 
0 3 9 10 11 13 14 15 19 22 29 32 34 47 119 373 605 690 806 905 979 994 
131 206 207 253 259 366 462 494 555 560 576 641 702 767 769 785 839 888 928 940 957 1005 
99 297 347 374 469 486 508 510 559 617 661 668 669 698 739 740 747 748 756 970 
118 159 171 172 224 309 310 375 387 504 549 623 629 737 908 975 978 1002 1026 1042 
36 45 61 63 89 96 124 161 184 250 474 628 743 758 823 901 1051 1064 
12 300 334 389 395 423 538 554 589 896 925 944 948 956 976 1021 1057 
51 281 391 393 415 463 470 517 575 646 671 719 779 878 949 1018 1027 
254 384 398 399 418 419 580 630 696 738 801 818 853 884 1009 1050 1084 
157 158 168 183 193 292 305 332 443 590 608 626 927 1030 1070 
1 2 21 25 272 433 434 460 521 541 663 781 782 873 
46 53 54 103 104 151 209 236 308 369 516 664 697 1059 
167 190 212 556 625 675 817 852 855 870 974 988 1067 1077 
540 570 584 680 832 865 910 931 964 999 1006 1017 1049 1069 
66 111 112 132 169 467 612 707 708 752 799 807 935 
125 126 147 160 166 181 185 198 205 777 876 897 1063 
148 194 545 712 773 797 802 845 916 917 995 1046 1076 
186 269 412 476 511 515 551 632 634 640 733 850 919 
16 17 20 23 26 195 211 237 304 789 882 
27 108 200 204 219 266 624 677 687 691 1039 
42 115 287 338 367 431 438 583 838 874 899 
50 101 129 130 144 246 271 370 390 622 1038 
75 286 339 340 509 595 619 620 754 1043 1071 
233 683 741 742 833 868 869 921 924 1007 1031 
52 377 483 681 757 871 890 996 1028 1029 
33 380 514 530 642 755 936 985 998 
37 94 95 285 406 851 859 937 1075 
43 77 165 230 247 487 488 532 726 
70 90 105 110 113 117 153 244 1048 
76 258 315 753 762 841 842 846 893 
78 448 455 479 706 770 791 971 993 
226 400 440 531 533 666 760 844 1008 
273 317 318 346 498 499 534 571 722 
432 439 572 594 686 720 849 933 934 
28 140 342 360 654 684 887 1001 
44 49 65 107 238 382 447 526 
55 57 164 240 348 408 862 1060 
56 84 202 492 582 637 780 824 
86 221 291 341 365 471 693 815 
177 282 407 446 591 652 786 1058 
225 255 256 497 536 578 898 1047 
280 284 293 314 355 420 831 892 
327 424 425 444 485 651 825 828 
381 552 553 574 603 705 713 721 
59 187 363 734 768 992 1083 
150 566 567 912 913 1041 1072 
276 278 427 692 814 966 1037 
322 323 847 848 902 903 1073 
426 676 813 830 904 945 1023 
512 587 688 689 775 943 1074 
643 644 774 787 877 885 1033 
649 650 673 714 792 798 872 
58 294 295 403 875 1000 
62 217 251 653 704 1035 
136 137 201 325 383 635 
156 227 349 401 749 750 
182 215 312 596 843 911 
223 682 840 891 929 1081 
234 616 723 724 822 863 
324 331 336 371 456 557 
484 636 745 788 972 1036 
71 529 968 1015 1032 
88 135 506 660 1082 
91 220 746 858 1012 
100 178 264 881 909 
114 519 599 860 861 
121 481 547 548 907 
122 352 362 656 1052 
179 923 946 947 977 
192 458 528 837 1054 
229 252 328 523 1078 
298 351 435 981 1016 
343 344 524 751 816 
422 667 951 952 1020 
451 472 522 602 950 
735 736 819 900 1024 
4 146 525 1053 
30 333 759 783 
60 573 731 732 
64 231 633 665 
67 79 81 241 
80 102 180 461 
83 263 539 1025 
87 228 658 710 
138 475 672 973 
145 480 883 932 
242 243 316 394 
249 311 895 939 
337 790 836 969 
358 410 894 983 
445 889 984 1013 
473 826 857 954 
477 478 513 1056 
495 505 982 1040 
502 503 592 1079 
639 766 810 811 
40 441 805 
41 222 685 
85 299 537 
123 417 866 
142 232 493 
149 699 771 
154 288 409 
170 700 980 
173 922 1022 
174 335 856 
191 405 518 
213 457 795 
261 428 761 
274 764 812 
301 569 593 
320 321 829 
356 357 926 
397 562 809 
411 598 1019 
453 579 834 
465 918 938 
542 543 550 
563 564 821 
588 1034 1062 
600 987 1014 
601 645 854 
647 717 718 
784 793 986 
941 942 1061 
990 991 1066 
