7 8 31 32 35 36 38 39 40 42 43 44 84 85 87 88 89 90 91 92 93 94 95 110 111 114 299 321 327 328 365 378 481 493 494 495 525 526 532 535 537 545 570 572 586 587 600 601 602 607 608 609 624 625 
28 29 30 34 41 86 248 345 346 347 348 349 351 352 358 359 360 361 366 367 400 406 421 425 426 427 431 432 459 462 472 473 480 503 504 536 541 542 543 559 567 616 630 640 651 652 653 654 660 666 677 
33 131 132 133 134 135 136 137 138 140 141 142 143 144 145 146 147 148 149 150 274 304 305 313 314 442 443 448 449 450 451 452 453 454 482 519 549 612 613 618 619 671 
37 69 100 115 116 117 118 119 120 121 122 172 173 174 175 176 177 178 203 204 249 300 330 338 362 363 415 464 465 539 560 571 574 581 582 610 621 644 
66 67 68 250 251 252 253 254 291 292 397 398 399 408 409 410 444 445 483 496 497 540 566 588 589 620 636 637 645 659 670 678 
179 180 181 182 183 184 185 186 187 188 189 190 191 192 193 194 387 388 389 390 391 392 499 500 514 538 550 590 611 650 
234 235 236 237 238 239 240 241 242 243 244 245 246 247 262 263 264 265 266 267 268 287 375 376 416 655 656 657 
51 52 221 222 223 224 225 226 227 340 341 342 343 344 461 576 577 578 591 592 593 594 646 647 668 
72 73 74 75 76 77 78 79 80 81 82 83 157 158 159 195 228 229 230 379 383 384 385 622 667 
53 54 55 56 57 58 59 60 61 62 63 152 153 154 155 156 380 463 515 516 517 518 672 
106 107 108 109 163 164 165 166 167 168 169 170 171 205 206 207 311 315 353 404 405 466 467 
5 6 9 10 11 12 13 14 15 208 209 210 211 212 506 527 528 529 530 533 534 675 
49 50 96 97 98 99 101 102 103 104 105 322 323 324 325 326 627 628 629 662 663 
125 126 128 129 130 139 369 370 371 372 373 374 455 456 457 458 512 513 554 
16 17 18 280 281 282 283 284 285 286 329 487 488 498 573 633 634 
213 214 215 216 217 218 219 220 412 470 471 523 524 631 632 
47 48 127 301 302 303 316 317 484 485 486 505 648 649 
113 123 124 257 258 259 260 261 546 551 552 564 565 575 
417 418 419 420 490 491 492 522 531 544 579 580 603 
23 24 25 26 27 334 386 401 402 403 
70 71 308 309 310 438 439 440 626 658 
19 20 21 22 151 368 441 479 661 
112 275 276 277 278 279 598 599 606 
199 200 201 202 350 411 617 641 642 
269 270 271 335 336 337 364 635 643 
295 296 297 298 318 319 320 339 555 
231 232 233 377 407 489 597 676 
272 273 293 294 428 429 430 
288 331 332 333 356 357 553 
0 1 2 3 4 
289 290 561 638 639 
468 469 547 548 558 
474 475 476 520 521 
381 382 501 502 
393 394 395 460 
45 46 437 
160 161 162 
196 197 198 
255 256 396 
306 307 312 
422 423 424 
507 508 509 
510 511 669 
568 569 623 
583 584 585 
