3 6 7 10 11 12 15 21 44 102 129 130 131 132 133 258 266 272 352 354 356 357 358 361 423 472 478 491 493 494 495 496 498 561 563 564 567 695 753 779 793 804 805 815 819 822 835 849 
8 16 17 18 19 94 95 112 149 160 233 235 296 318 319 456 537 538 540 541 542 543 560 591 621 622 624 655 706 708 825 856 
63 236 237 238 239 240 241 242 367 446 502 503 516 545 717 718 790 791 829 838 889 
246 247 248 249 250 251 252 253 255 256 257 259 260 261 562 565 566 640 714 772 833 
103 104 105 106 108 109 110 113 114 115 212 213 214 311 312 313 554 555 847 892 
304 305 306 307 308 309 310 489 490 667 713 731 799 800 801 867 893 
187 196 205 206 348 351 405 406 407 408 409 410 648 776 903 909 
121 314 315 389 390 473 474 475 588 601 609 610 612 697 698 
96 97 99 127 128 175 415 557 558 570 572 573 586 
326 328 330 333 335 337 338 339 340 374 375 376 377 
51 141 192 444 506 529 579 580 707 780 813 814 
80 81 82 84 85 86 88 89 548 549 550 904 
134 135 136 138 139 142 145 254 401 759 788 862 
0 137 332 353 372 373 499 520 597 625 809 
100 101 436 437 438 631 632 633 634 880 
355 428 507 508 509 510 511 512 513 865 
13 14 611 746 747 748 749 751 752 
146 148 150 227 278 279 280 449 843 
147 221 222 223 224 225 226 672 673 
172 173 174 177 360 464 465 694 710 
188 194 202 203 412 447 644 696 736 
20 204 320 321 589 674 806 807 
33 34 61 125 126 291 539 897 
45 46 47 48 49 477 657 848 
167 168 169 170 171 481 482 842 
189 190 191 193 198 199 201 393 
211 329 341 583 619 877 878 898 
289 294 297 298 299 303 593 863 
587 613 616 642 712 729 882 883 
641 643 645 646 649 658 659 660 
35 36 38 207 528 687 881 
37 635 686 899 900 901 902 
62 90 232 400 577 794 820 
71 72 73 571 574 575 578 
158 159 161 162 166 359 773 
228 229 230 485 486 487 795 
288 290 302 404 467 468 505 
23 197 343 576 786 837 
59 462 750 762 763 764 
60 65 93 463 719 836 
76 457 458 459 460 461 
181 184 424 425 427 886 
243 245 440 442 617 885 
344 345 346 347 480 908 
366 368 369 370 851 852 
384 385 386 483 484 525 
418 419 450 451 452 711 
420 421 422 453 454 488 
675 678 740 741 853 854 
1 2 4 5 178 
9 292 808 844 864 
50 52 53 54 208 
66 426 584 585 821 
122 154 157 845 846 
163 164 165 544 765 
179 182 392 471 896 
293 590 618 620 709 
397 398 399 403 466 
514 515 517 526 527 
532 533 534 535 536 
598 599 600 802 803 
623 626 627 628 629 
647 812 816 817 818 
24 26 27 28 
29 32 840 841 
67 68 231 761 
98 614 615 699 
117 118 119 501 
120 262 546 547 
124 689 690 720 
151 155 156 268 
210 371 455 781 
276 277 668 669 
380 381 382 383 
439 441 443 834 
676 677 770 771 
703 704 705 796 
732 733 734 735 
22 349 869 
55 57 58 
56 220 234 
77 887 888 
83 116 656 
123 209 504 
143 144 500 
152 281 282 
153 342 559 
180 183 185 
267 269 839 
270 283 284 
271 274 275 
273 364 448 
295 754 755 
323 324 325 
327 760 871 
331 592 730 
394 395 396 
429 430 431 
434 435 445 
479 870 884 
492 850 866 
522 523 524 
556 638 639 
636 637 688 
650 651 652 
653 727 728 
700 701 702 
722 723 724 
774 775 798 
777 778 792 
826 827 828 
868 872 873 
874 875 876 
879 894 907 
