3 9 21 44 50 52 53 54 97 123 128 129 130 131 132 133 146 147 148 150 164 176 208 209 211 220 221 222 223 224 225 226 227 258 279 280 309 352 354 355 356 357 358 420 421 422 423 426 439 440 441 442 443 453 454 471 472 476 477 478 488 489 491 493 504 520 540 619 657 672 673 695 710 750 753 754 755 760 772 779 786 804 805 808 819 820 834 835 843 844 849 864 
8 12 29 31 32 62 63 80 81 82 83 84 85 89 90 116 121 122 149 154 157 158 159 160 161 162 163 165 166 278 341 359 424 425 427 449 456 462 516 549 560 577 583 585 618 621 624 654 655 661 662 706 708 717 718 773 794 840 841 845 846 856 898 
30 290 326 328 329 330 331 333 334 335 336 337 338 339 340 372 373 374 375 376 377 545 592 730 868 877 878 
102 103 104 105 106 107 108 109 110 111 112 113 114 115 212 213 214 218 262 311 312 313 553 554 555 847 892 
33 34 288 289 291 292 294 295 296 297 298 299 300 301 302 303 480 593 674 675 678 740 741 853 854 863 
16 17 18 19 20 23 204 232 318 319 320 321 322 579 580 589 806 807 825 
57 86 87 88 189 190 191 192 193 198 199 200 201 392 393 548 550 707 
135 139 144 249 250 253 257 260 304 305 306 307 308 714 731 867 893 
179 180 181 182 183 184 185 418 419 450 451 452 700 701 711 886 896 
136 246 247 248 251 252 254 256 259 261 562 566 640 759 833 862 
188 194 196 197 202 203 206 343 350 407 409 410 696 736 837 
51 141 444 505 506 588 590 762 763 764 765 780 813 814 
76 137 457 458 459 460 461 494 497 498 499 576 625 793 
55 56 58 59 60 64 65 93 234 244 463 719 836 
72 96 98 99 415 557 570 572 573 575 578 586 699 
24 27 28 66 134 143 346 561 563 564 567 815 
155 266 267 268 269 270 283 284 617 839 885 
14 345 611 622 746 747 748 749 752 908 
71 73 127 495 496 500 559 571 574 796 
100 101 436 437 438 631 632 633 634 880 
175 428 507 508 509 510 511 512 513 865 
310 647 667 799 800 801 812 816 817 818 
587 613 614 615 616 642 712 729 882 883 
138 369 397 398 399 401 402 403 466 
187 205 351 405 408 648 776 903 909 
35 37 635 686 899 900 901 902 
42 43 45 46 47 48 49 848 
61 94 95 125 126 558 688 897 
74 75 124 243 245 689 690 720 
172 173 174 177 360 464 465 694 
641 643 645 646 649 658 659 660 
167 168 170 171 481 482 842 
228 229 230 485 486 487 795 
366 367 368 370 791 851 852 
474 475 609 610 612 697 698 
0 1 2 4 5 178 
15 342 344 347 400 751 
120 156 455 546 547 781 
195 532 533 534 535 536 
235 537 541 542 543 544 
236 237 238 240 241 242 
314 315 389 390 473 601 
384 385 386 483 484 525 
598 599 600 802 803 822 
25 26 332 353 391 
169 446 584 790 821 
210 371 529 597 809 
327 404 467 468 871 
361 362 363 364 365 
514 515 517 526 527 
623 626 627 628 629 
6 7 10 11 
13 479 870 884 
22 348 349 869 
67 68 231 761 
233 538 539 591 
271 272 274 275 
276 277 668 669 
380 381 382 383 
412 447 620 644 
490 492 850 866 
502 503 829 838 
676 677 770 771 
38 528 687 
77 887 888 
140 142 145 
152 281 282 
239 788 889 
255 565 713 
273 448 702 
293 709 739 
323 324 325 
394 395 396 
434 435 445 
522 523 524 
556 638 639 
650 651 652 
653 727 728 
703 704 705 
722 723 724 
774 775 798 
777 778 792 
826 827 828 
874 875 876 
879 894 907 
