0 3 44 50 52 53 54 123 130 132 133 146 150 158 159 160 161 162 166 208 209 211 220 221 222 223 224 225 226 227 258 279 309 352 354 355 358 359 361 365 420 421 422 423 426 439 440 441 442 443 453 454 456 471 472 478 479 488 491 493 504 540 619 657 669 672 673 708 753 755 760 773 779 786 792 804 805 834 835 849 
25 30 236 237 238 239 240 241 242 290 324 326 327 328 329 330 331 332 333 334 335 336 337 338 339 340 353 356 372 373 374 375 376 377 391 404 418 419 450 451 467 468 545 592 711 788 871 877 878 889 
57 81 83 84 86 87 88 116 186 187 188 189 190 191 192 193 194 195 196 198 199 200 201 202 203 205 206 219 351 393 405 406 407 408 409 410 411 412 447 548 550 636 648 696 707 776 903 909 
8 12 24 62 63 66 80 82 85 89 90 121 134 143 148 149 157 234 271 278 283 346 380 537 543 547 549 560 561 564 567 577 621 624 717 718 794 856 
11 51 56 59 60 64 65 93 141 244 341 444 462 463 505 506 516 546 583 585 588 618 661 662 719 762 763 764 765 780 812 813 814 836 874 875 876 898 
102 103 104 105 106 107 108 109 110 111 112 113 114 115 212 213 214 218 311 312 313 363 553 554 555 847 892 
72 96 97 98 99 127 128 175 176 415 428 507 513 557 570 572 573 574 575 578 586 587 699 865 
61 74 75 94 95 124 125 126 243 245 357 558 637 688 689 690 720 819 897 
136 246 247 248 251 252 254 256 259 261 562 563 566 640 759 772 815 833 862 
289 291 292 294 295 296 297 298 299 300 301 303 347 480 539 593 
17 20 233 318 319 320 321 322 541 542 589 590 591 825 
6 7 9 10 13 14 122 129 808 820 844 846 864 
314 315 389 390 455 473 474 475 601 697 698 781 
179 181 182 184 392 424 425 427 452 886 896 
266 267 268 269 270 502 503 617 829 839 885 
16 18 19 21 22 232 235 348 349 869 
42 43 45 46 47 48 49 476 477 848 
138 369 397 398 399 400 401 402 403 466 
249 250 253 257 260 304 307 714 731 867 
641 642 643 645 646 647 649 658 659 660 
147 273 280 362 364 448 449 702 843 
2 169 178 284 446 584 790 821 
29 31 32 654 655 706 840 841 
71 73 495 496 500 559 571 796 
135 139 140 142 144 145 851 852 
172 173 174 177 360 464 465 694 
210 371 529 597 609 610 612 809 
345 622 746 747 749 750 752 908 
35 36 38 207 528 687 881 
37 635 686 899 900 901 902 
76 137 457 458 459 460 461 
228 229 230 485 486 487 795 
306 310 667 799 800 801 816 
674 675 678 740 741 853 854 
15 342 344 748 751 838 
23 204 579 580 806 807 
197 343 620 644 736 837 
305 489 490 492 850 866 
366 367 368 370 520 791 
384 385 386 483 484 525 
712 729 870 882 883 884 
120 131 156 262 695 
167 168 170 171 842 
288 293 302 709 739 
514 515 517 526 527 
598 599 600 802 822 
623 626 627 628 629 
33 34 55 58 
67 68 231 761 
163 165 538 544 
532 533 534 535 
676 677 770 771 
1 4 5 
77 887 888 
152 281 282 
255 565 713 
272 274 275 
276 277 668 
381 382 383 
394 395 396 
434 435 445 
494 499 625 
498 576 793 
522 523 524 
556 638 639 
613 614 615 
650 651 652 
653 727 728 
703 704 705 
722 723 724 
774 775 798 
826 827 828 
868 872 873 
879 894 907 
