3 6 7 9 10 11 12 15 21 44 45 46 47 48 49 50 52 53 54 56 67 68 102 103 105 106 108 110 111 114 123 129 130 131 132 133 208 209 220 228 229 230 231 248 258 266 267 269 270 272 276 277 294 295 298 299 300 311 312 313 331 352 353 354 356 357 358 361 366 369 370 423 472 476 477 478 479 485 486 487 491 492 493 494 495 496 497 498 499 500 504 561 563 564 565 567 593 618 657 668 669 695 720 722 723 724 748 753 754 755 761 772 777 778 779 792 793 795 808 815 819 822 835 839 844 848 849 850 864 
51 76 77 134 135 136 137 138 139 141 142 145 146 147 148 150 192 210 218 219 221 222 223 224 225 226 227 254 271 273 274 275 278 279 280 364 384 385 386 444 448 449 457 458 459 460 461 483 484 506 525 529 579 580 672 673 702 707 759 780 788 812 813 814 826 827 828 843 862 887 888 890 891 899 900 901 
0 1 2 4 5 167 168 169 170 171 178 288 290 301 302 326 327 328 330 332 333 334 335 336 337 338 339 340 349 372 373 374 375 376 377 404 418 419 450 451 452 467 468 481 482 505 520 521 522 523 524 596 597 700 711 760 809 842 855 869 871 
42 43 71 72 73 96 97 98 99 127 128 172 173 174 175 176 177 355 360 413 414 415 428 429 430 431 464 465 507 508 509 510 511 512 513 556 557 558 570 571 572 573 574 575 578 586 587 614 615 636 637 638 639 688 694 699 710 739 791 865 
8 16 60 65 93 94 95 112 149 160 212 214 296 318 319 323 324 325 380 381 382 383 456 463 537 539 541 543 554 555 560 591 621 623 624 625 626 627 628 629 655 706 708 719 757 758 825 836 856 892 
23 197 211 329 341 342 343 514 515 516 517 526 527 559 576 583 613 619 676 677 689 690 770 771 786 787 789 837 838 874 875 876 877 878 879 884 894 898 907 
87 186 187 188 189 190 191 193 194 195 196 198 199 200 201 202 203 205 206 348 350 351 393 406 407 408 409 410 411 412 447 696 736 776 903 909 
104 109 120 213 262 322 405 434 435 445 546 547 553 616 620 641 642 643 644 645 646 647 648 649 658 659 660 712 729 730 816 817 818 882 883 
62 66 74 75 90 113 115 121 181 184 232 283 284 314 315 389 390 424 425 426 427 577 584 585 612 794 820 821 847 886 
80 81 82 83 84 85 86 88 89 116 117 118 119 501 548 549 550 656 732 733 734 735 904 
63 236 237 238 239 240 241 242 367 446 503 545 717 718 774 775 790 798 804 805 829 889 
246 247 249 250 251 252 253 255 256 257 259 260 261 562 566 640 714 768 769 833 870 
13 14 143 144 153 289 297 344 345 346 347 480 622 746 747 749 751 752 908 
179 180 182 183 185 392 471 532 533 534 535 536 650 651 652 653 727 728 896 
59 371 420 421 422 453 454 455 462 488 750 762 763 764 781 
107 122 151 152 154 155 156 157 281 282 362 363 365 845 846 
158 159 161 162 163 164 165 166 359 394 395 396 544 765 773 
304 305 306 307 308 309 310 489 490 667 713 731 866 867 893 
17 18 19 20 22 233 234 235 320 321 538 540 542 589 
204 292 303 674 675 678 740 741 806 807 853 854 863 
24 25 26 27 28 140 368 391 402 851 852 
268 397 398 399 400 401 403 466 502 581 582 
35 36 37 38 207 528 635 686 687 881 
243 245 439 440 441 442 443 617 834 885 
588 598 599 600 601 609 610 611 802 803 
61 64 124 125 126 244 291 897 
29 30 31 32 654 840 841 
33 34 55 57 58 
78 79 799 800 801 
473 474 475 697 698 
703 704 705 796 797 
592 868 872 873 
293 590 709 
661 662 902 
