3 31 32 67 68 75 153 231 266 267 269 276 277 323 325 327 341 342 343 344 345 346 347 434 435 439 440 441 442 443 445 456 480 514 515 516 517 520 521 522 523 524 526 527 576 598 599 600 611 613 615 616 617 654 655 661 662 668 669 676 677 706 708 712 720 722 723 724 729 730 760 761 762 763 764 765 770 771 777 778 786 787 789 792 793 802 803 822 834 835 839 841 849 871 874 875 876 882 883 884 885 898 902 908 
6 7 8 9 10 11 12 13 14 15 33 34 55 56 58 59 60 61 64 65 93 120 121 122 123 124 126 129 130 131 132 133 151 154 157 243 244 245 270 289 291 292 294 296 297 298 299 318 366 369 370 371 380 381 382 383 401 462 463 593 609 610 612 695 719 746 747 748 749 750 751 752 757 758 808 820 821 825 836 844 845 846 
71 72 73 96 97 98 99 125 127 128 175 176 352 353 354 355 356 357 358 413 414 415 507 508 509 510 511 512 513 556 557 558 559 570 571 572 573 574 575 578 586 587 614 638 639 688 699 709 739 791 819 865 897 
35 36 37 38 102 103 104 105 106 107 108 109 110 111 112 113 114 115 207 212 213 214 262 311 312 313 314 315 320 322 389 390 473 474 475 528 553 554 555 635 686 687 697 698 847 881 892 899 900 901 
0 1 4 5 29 30 301 326 328 329 330 331 332 333 334 335 336 337 338 339 340 349 367 372 373 374 375 376 377 391 545 592 596 597 689 690 809 838 840 855 868 869 872 873 877 878 879 894 907 
24 25 26 27 28 63 76 77 134 135 136 137 138 139 140 141 142 143 144 145 368 457 458 459 460 461 503 529 546 560 601 717 718 788 812 813 814 829 851 852 887 888 890 891 
187 188 194 196 197 200 201 202 203 205 348 350 351 405 406 407 408 409 410 411 412 447 494 495 496 497 498 499 500 703 704 705 736 776 796 797 837 903 909 
246 247 248 249 250 251 252 253 254 255 256 257 258 259 260 261 561 562 563 564 565 566 567 640 713 714 731 759 768 769 772 815 833 870 
62 66 155 268 271 272 273 274 275 283 284 397 398 399 400 402 403 466 502 547 581 582 583 584 585 702 794 826 827 828 
57 186 189 190 191 192 193 198 199 204 206 392 393 471 472 636 637 674 675 678 696 707 740 741 806 807 853 854 
146 147 148 149 150 218 219 220 221 222 223 224 225 226 227 278 279 280 444 448 449 504 579 580 672 673 843 
42 44 45 46 47 48 49 50 51 52 53 54 208 209 210 211 300 476 477 478 479 577 657 848 
78 79 304 305 306 307 308 309 310 489 490 491 492 493 667 799 800 801 816 817 818 866 867 893 
80 81 82 83 84 85 86 87 88 89 90 548 549 550 656 732 733 734 735 904 
293 319 588 590 618 619 620 641 642 643 644 645 646 647 648 649 658 659 660 
16 17 18 19 21 22 23 74 232 233 234 235 321 424 425 426 427 
179 182 183 184 185 589 621 622 623 624 625 626 627 628 629 886 896 
2 156 167 169 178 361 362 363 364 365 446 774 775 790 798 
43 172 173 174 177 295 360 464 465 694 710 753 754 755 
158 159 160 161 162 163 164 165 166 359 394 395 396 773 
180 195 532 533 534 535 536 650 651 652 653 727 728 
20 94 95 537 538 539 540 541 542 543 544 591 
100 101 436 437 438 631 632 633 634 850 880 
236 237 238 239 240 241 242 324 804 805 889 
181 288 290 303 418 419 451 452 711 863 
420 421 422 423 453 454 455 488 779 781 
228 229 230 485 486 487 795 864 
384 385 386 483 484 525 856 862 
302 404 467 468 505 506 780 
387 388 416 417 606 607 608 
116 117 118 119 501 
681 682 683 737 738 
39 40 41 721 
428 429 430 431 
551 552 715 716 
664 665 666 784 
670 671 742 743 
69 70 630 
152 281 282 
215 216 217 
263 264 265 
285 286 287 
378 379 602 
450 700 701 
469 470 785 
568 569 663 
603 604 605 
679 680 861 
691 692 693 
725 726 895 
744 745 756 
830 831 832 
