3 6 7 8 9 10 11 12 14 21 24 27 28 29 31 32 42 43 44 45 46 47 48 49 50 51 52 53 54 55 56 58 59 60 61 62 63 64 65 66 67 68 80 82 83 84 85 89 90 93 94 95 97 116 120 121 122 123 125 126 128 129 130 131 132 133 134 136 141 143 146 147 148 149 150 154 157 158 159 160 161 162 163 164 165 166 172 173 174 175 176 177 208 209 211 219 220 221 222 223 224 225 226 227 228 229 230 231 234 244 246 247 248 251 252 254 256 258 259 261 271 272 274 275 278 279 280 309 341 346 352 354 355 356 357 358 359 360 380 381 382 383 384 385 386 394 395 396 413 414 415 420 423 424 425 426 427 439 440 441 442 443 444 449 456 462 463 464 465 471 472 476 477 478 483 484 485 486 487 488 489 491 493 504 505 506 507 508 509 510 511 512 513 520 525 540 546 549 558 560 561 562 563 564 566 567 577 583 584 585 611 618 619 620 621 622 623 624 626 627 628 629 640 654 655 657 661 662 672 673 676 677 688 694 695 706 708 710 717 718 719 722 723 724 746 747 748 749 750 752 753 754 755 757 758 759 760 761 762 763 764 765 770 771 772 773 779 780 786 787 789 794 795 804 805 808 813 814 815 819 820 821 833 834 835 836 840 841 843 844 845 846 848 849 856 862 864 865 890 891 897 898 
0 1 2 4 5 15 71 72 73 76 99 127 137 151 152 153 178 281 282 342 344 345 347 400 457 458 459 460 461 494 495 496 497 498 499 500 557 559 570 571 572 573 574 575 576 578 586 625 751 793 796 908 
35 36 37 38 156 167 168 169 170 171 207 273 314 315 361 362 363 364 365 389 390 421 422 446 448 453 454 455 473 481 482 528 588 590 601 635 686 687 774 775 781 790 798 826 827 828 842 881 899 900 901 902 
25 26 30 96 98 290 326 327 328 329 330 331 332 333 334 335 336 337 338 339 340 353 372 373 374 375 376 377 391 404 467 468 514 515 516 517 526 527 545 592 596 699 730 855 868 871 877 878 879 894 907 
186 187 188 194 195 196 197 202 203 205 206 343 350 351 405 406 407 408 409 410 411 412 447 532 533 534 535 536 641 643 644 645 646 648 649 650 651 652 653 658 659 660 696 727 728 736 776 837 903 909 
135 139 140 142 144 145 155 249 250 253 255 257 260 266 267 268 269 270 283 284 304 306 308 565 581 582 617 713 714 731 768 769 839 867 885 893 
102 103 104 105 106 107 108 109 110 111 112 113 114 115 212 213 214 218 262 311 312 313 547 553 554 555 847 892 
33 34 288 289 291 292 294 295 296 297 298 299 300 301 302 303 480 593 674 675 678 740 741 853 854 863 
57 81 86 87 88 189 190 191 192 193 198 199 200 201 392 393 548 550 636 637 707 
16 17 18 19 20 23 204 232 318 319 320 321 322 579 580 589 806 807 825 
100 101 305 307 436 437 438 490 492 631 632 633 634 850 866 880 
434 435 445 587 613 614 615 616 642 712 729 874 875 876 882 883 
179 180 181 182 183 184 185 418 419 450 451 452 711 886 896 
78 79 310 647 667 799 800 801 812 816 817 818 
210 371 474 475 529 597 609 610 612 697 698 809 
236 237 238 239 240 241 242 323 324 325 788 889 
366 367 368 370 502 503 791 829 838 851 852 
233 235 537 538 539 541 542 543 544 591 
138 369 397 398 399 401 402 403 466 
74 75 124 243 245 689 690 720 
521 522 523 524 703 704 705 797 
598 599 600 802 803 822 
13 479 870 884 
22 348 349 869 
276 277 668 669 
428 429 430 431 
77 887 888 
293 709 739 
556 638 639 
700 701 702 
777 778 792 
