0 3 29 30 31 32 67 68 75 102 153 231 266 267 269 276 277 289 294 297 298 301 303 323 325 326 327 328 329 330 331 332 333 334 335 336 337 338 339 340 341 342 343 344 346 347 367 372 373 374 375 376 377 391 434 435 439 440 441 442 443 445 456 480 494 495 496 498 499 500 514 515 516 517 520 521 522 523 524 526 527 545 576 592 596 597 598 599 600 613 616 617 654 655 661 662 668 669 676 677 689 690 703 704 705 706 708 712 720 722 723 724 729 730 760 761 762 763 764 765 770 771 777 778 786 787 789 792 793 796 797 802 809 822 834 835 838 839 840 841 849 855 863 871 874 875 876 877 878 879 882 883 884 885 894 898 902 907 
6 7 8 9 10 11 12 13 14 15 33 34 55 56 58 59 60 61 64 65 93 112 120 121 122 123 124 126 129 130 131 132 133 151 154 157 243 244 245 262 270 292 296 318 345 366 368 369 370 371 380 381 382 383 401 462 463 609 610 611 612 695 719 746 747 748 749 750 751 752 757 758 803 808 820 821 825 836 844 845 846 908 
43 71 72 73 96 97 98 99 125 127 128 172 173 174 175 176 177 295 352 353 354 355 356 357 358 360 413 414 415 464 465 507 508 509 510 511 512 513 556 557 558 559 570 571 572 573 574 575 578 586 587 614 615 636 637 638 639 688 694 699 709 710 739 753 754 755 791 819 865 897 
24 25 26 27 28 63 76 77 134 135 136 137 138 139 140 141 142 143 144 145 457 458 459 460 461 503 529 546 560 601 717 718 788 812 813 814 829 851 852 887 888 890 891 
1 2 4 5 103 104 105 106 107 108 109 110 111 114 156 167 169 178 212 213 214 311 312 313 361 362 363 364 365 446 554 555 774 775 790 798 892 
246 247 248 249 250 251 252 253 254 255 256 257 258 259 260 261 561 562 563 564 565 566 567 640 713 714 731 759 768 769 772 815 833 870 
62 66 155 268 271 272 273 274 275 283 284 397 398 399 400 402 403 450 466 502 547 581 582 583 584 585 700 701 702 794 826 827 828 
187 188 194 196 197 200 201 202 203 205 348 349 350 351 405 406 407 408 409 410 411 412 447 497 736 776 837 869 903 909 
35 36 37 38 113 115 207 314 315 322 389 390 473 474 475 528 553 635 686 687 697 698 847 881 899 900 901 
146 147 148 149 150 218 219 220 221 222 223 224 225 226 227 278 279 280 444 448 449 504 579 580 672 673 843 
42 44 45 46 47 48 49 50 51 52 53 54 208 209 210 211 300 476 477 478 479 577 657 848 
78 79 304 305 306 307 308 309 310 489 490 491 492 493 667 799 800 801 816 817 818 866 867 893 
57 186 189 190 191 192 193 198 199 204 206 393 674 675 678 696 707 740 741 806 807 853 854 
288 290 293 418 419 451 452 618 619 620 641 642 643 644 645 646 647 648 649 658 659 660 711 
80 81 82 83 84 85 86 87 88 89 90 548 549 550 656 732 733 734 735 904 
16 17 18 19 21 22 23 74 181 232 233 234 235 424 425 426 427 
179 182 183 184 185 589 621 622 623 624 625 626 627 628 629 886 896 
20 94 95 291 299 537 538 539 540 541 542 543 544 591 593 
158 159 160 161 162 163 164 165 166 359 394 395 396 773 
180 195 532 533 534 535 536 650 651 652 653 727 728 
100 101 436 437 438 631 632 633 634 850 880 
236 237 238 239 240 241 242 324 804 805 889 
420 421 422 423 453 454 455 488 779 781 
228 229 230 485 486 487 795 864 
384 385 386 483 484 525 856 862 
302 404 467 468 505 506 780 
387 388 416 417 606 607 608 
116 117 118 119 501 
319 320 321 588 590 
681 682 683 737 738 
39 40 41 721 
428 429 430 431 
551 552 715 716 
664 665 666 784 
670 671 742 743 
69 70 630 
152 281 282 
215 216 217 
263 264 265 
285 286 287 
378 379 602 
392 471 472 
469 470 785 
568 569 663 
603 604 605 
679 680 861 
691 692 693 
725 726 895 
744 745 756 
830 831 832 
868 872 873 
