0 3 75 102 266 268 327 331 332 338 341 344 346 347 372 373 376 391 439 440 441 442 443 456 480 494 495 496 498 499 502 576 592 597 613 614 615 616 661 662 703 704 705 712 720 729 730 760 777 778 786 792 793 796 797 804 805 809 822 834 835 849 871 874 875 876 882 883 884 898 
8 9 12 55 56 60 64 65 93 112 122 129 157 292 296 318 345 366 368 369 370 371 380 401 462 463 719 746 747 749 751 752 808 820 821 825 836 844 846 864 908 
43 71 72 73 96 98 99 127 128 172 173 174 176 177 360 415 464 465 556 557 559 570 571 572 573 578 586 694 699 709 739 
146 147 148 149 150 218 220 221 222 223 224 225 226 227 278 279 280 444 448 449 504 579 580 672 673 843 
153 187 405 406 407 408 409 412 619 620 641 642 643 644 645 646 647 648 649 658 659 660 776 
246 247 248 250 255 256 257 258 260 561 562 563 564 565 566 567 640 713 772 815 
188 194 196 197 200 201 202 203 205 348 349 351 410 447 736 837 869 903 909 
37 63 141 503 529 546 635 686 717 718 812 813 814 829 899 900 901 902 
57 186 189 190 191 192 193 198 199 204 206 393 636 674 696 707 806 807 
110 113 115 314 315 320 321 322 389 390 455 473 474 475 553 555 781 847 
42 44 45 46 47 48 49 211 300 476 477 478 479 577 657 848 
80 81 82 83 84 85 86 87 88 89 90 548 549 550 656 904 
103 104 105 106 108 109 111 114 212 213 214 311 312 313 554 892 
20 94 95 165 291 537 538 539 540 541 542 543 544 591 
326 329 330 333 335 337 340 374 375 377 689 690 877 878 
24 25 26 27 28 134 135 139 140 142 143 851 852 
76 136 137 144 145 457 458 459 460 461 500 560 
236 237 238 239 240 241 242 324 328 339 545 889 
304 305 306 307 308 309 310 667 799 800 801 867 
100 101 436 437 438 631 632 633 634 850 880 
120 121 123 130 131 133 262 612 695 750 
179 182 184 589 621 622 624 625 886 896 
249 251 252 253 259 261 714 731 759 833 
97 125 354 357 358 513 558 819 897 
158 159 160 161 162 163 166 359 773 
598 599 600 601 609 610 611 802 803 
50 51 52 53 54 208 209 210 
289 294 297 298 299 303 593 863 
420 421 422 423 453 454 488 779 
428 507 508 509 510 511 512 865 
35 36 38 207 528 687 881 
61 124 126 151 154 244 845 
107 156 361 362 363 364 365 
180 195 532 533 534 535 536 
228 229 230 485 486 487 795 
243 245 267 269 617 839 885 
397 398 399 400 402 403 466 
2 167 169 178 446 790 
31 32 654 655 706 841 
168 170 171 481 482 842 
175 352 353 355 356 791 
271 272 273 274 275 702 
290 418 419 451 452 711 
342 343 516 787 789 838 
367 520 521 522 523 524 
384 385 386 483 484 525 
489 490 491 492 866 893 
675 678 740 741 853 854 
6 7 10 13 14 
16 18 21 22 426 
17 19 232 234 235 
62 283 284 547 794 
74 181 424 425 427 
116 117 118 119 501 
387 388 606 607 608 
514 515 517 526 527 
623 626 627 628 629 
681 682 683 737 738 
11 15 59 748 
39 40 41 721 
66 583 584 585 
67 68 231 761 
276 277 668 669 
302 404 467 468 
336 574 575 587 
493 816 817 818 
551 552 715 716 
664 665 666 784 
670 671 742 743 
676 677 770 771 
732 733 734 735 
762 763 764 765 
1 4 5 
29 30 840 
33 34 58 
69 70 630 
77 887 888 
152 281 282 
215 216 217 
263 264 265 
285 286 287 
288 293 618 
295 710 754 
319 588 590 
323 325 708 
378 379 602 
381 382 383 
392 471 472 
394 395 396 
429 430 431 
434 435 445 
450 700 701 
469 470 785 
505 506 780 
568 569 663 
603 604 605 
650 651 652 
653 727 728 
679 680 861 
691 692 693 
722 723 724 
725 726 895 
744 745 756 
774 775 798 
826 827 828 
830 831 832 
868 872 873 
879 894 907 
