0 3 102 266 268 327 331 332 338 344 372 373 376 391 439 440 441 442 443 456 494 495 496 498 499 502 592 597 613 614 615 616 703 704 705 712 720 729 730 760 786 793 796 797 804 805 809 822 834 835 849 871 882 883 884 
103 104 105 106 108 109 110 111 113 114 115 212 213 214 311 312 313 314 315 322 389 390 455 473 474 475 553 554 555 781 847 892 
35 36 37 38 63 141 207 503 528 529 546 598 599 600 601 635 686 687 717 718 812 813 814 829 881 899 900 901 
187 188 194 196 197 200 201 202 203 205 348 349 351 405 406 407 408 409 410 411 412 447 736 776 837 869 903 909 
146 147 148 149 150 218 219 220 221 222 223 224 225 226 227 278 279 280 444 448 449 504 579 580 672 673 843 
24 25 26 27 28 76 134 135 136 137 139 140 142 143 144 145 457 458 459 460 461 500 560 851 852 
42 44 45 46 47 48 49 50 51 52 53 54 208 209 210 211 477 478 479 577 657 848 
246 247 248 250 255 256 257 258 260 561 562 563 564 565 566 567 640 713 714 731 772 815 
304 305 306 307 308 309 310 489 490 491 492 493 667 799 800 801 816 817 818 866 867 893 
8 12 55 56 60 64 65 93 112 129 157 292 296 318 401 462 463 719 825 836 
153 341 342 343 346 347 480 516 576 661 662 787 789 838 874 875 876 898 902 
57 186 189 190 191 192 193 198 199 204 206 393 636 674 696 707 806 807 
72 97 125 175 352 353 354 355 356 357 358 558 791 819 897 
9 11 15 59 122 366 368 369 370 371 748 808 844 846 
20 94 95 165 291 537 538 539 540 541 542 543 544 591 
71 73 127 128 176 556 557 559 570 571 573 586 709 739 
120 121 123 130 131 132 133 262 270 612 695 750 820 821 
326 329 330 333 335 337 340 374 375 377 689 690 877 878 
619 620 641 642 643 644 645 646 647 648 649 658 659 660 
2 167 168 169 170 171 178 446 481 482 790 842 
14 345 609 610 611 746 747 749 751 752 803 908 
62 66 271 273 283 284 547 583 584 585 702 794 
236 237 238 239 240 241 242 324 328 339 545 889 
96 98 507 508 509 510 511 512 572 578 699 
100 101 436 437 438 631 632 633 634 850 880 
43 99 172 173 174 177 360 464 465 694 
180 182 183 185 195 532 533 534 535 536 
289 294 297 298 299 301 303 334 593 863 
158 159 160 161 162 163 166 359 773 
179 184 589 621 622 624 625 886 896 
17 19 23 232 233 234 235 320 
80 81 82 83 84 87 89 656 
85 86 88 90 548 549 550 904 
228 229 230 485 486 487 795 864 
420 421 422 423 453 454 488 779 
61 124 126 151 154 244 845 
107 156 361 362 363 364 365 
243 245 267 269 617 839 885 
397 398 399 400 402 403 466 
31 32 654 655 706 841 
74 75 181 424 425 427 
290 418 419 451 452 711 
367 520 521 522 523 524 
384 385 386 483 484 525 
675 678 740 741 853 854 
16 18 21 22 426 
116 117 118 119 501 
249 251 254 759 870 
252 253 259 261 833 
295 710 753 754 755 
387 388 606 607 608 
514 515 517 526 527 
623 626 627 628 629 
681 682 683 737 738 
6 7 10 13 
39 40 41 721 
67 68 231 761 
276 277 668 669 
302 404 467 468 
319 321 588 590 
336 574 575 587 
380 381 382 383 
428 429 430 431 
551 552 715 716 
664 665 666 784 
670 671 742 743 
676 677 770 771 
732 733 734 735 
762 763 764 765 
1 4 5 
29 30 840 
33 34 58 
69 70 630 
77 887 888 
152 281 282 
215 216 217 
263 264 265 
272 274 275 
285 286 287 
288 293 618 
323 325 708 
378 379 602 
392 471 472 
394 395 396 
415 513 865 
434 435 445 
450 700 701 
469 470 785 
505 506 780 
568 569 663 
603 604 605 
650 651 652 
653 727 728 
679 680 861 
691 692 693 
722 723 724 
725 726 895 
744 745 756 
774 775 798 
777 778 792 
826 827 828 
830 831 832 
868 872 873 
879 894 907 
