3 6 7 10 11 12 15 21 44 67 68 102 129 130 131 132 133 231 246 247 248 249 250 251 252 253 255 256 257 258 259 260 261 266 268 272 302 331 352 354 356 357 358 361 404 423 467 468 472 478 491 493 494 495 496 497 498 505 513 520 561 562 563 564 565 566 567 581 582 618 620 640 695 714 722 723 724 753 761 768 769 772 779 793 804 805 815 819 822 833 835 849 
0 1 2 4 5 137 178 181 184 288 289 290 294 295 297 298 299 300 301 303 326 327 328 330 332 333 334 335 337 338 339 340 353 372 373 374 375 376 377 418 419 450 451 452 476 499 593 596 597 625 675 678 711 740 741 754 755 760 809 853 854 855 863 871 886 
87 186 187 188 189 190 191 193 194 195 196 198 199 200 201 202 203 204 205 206 292 348 350 351 393 405 406 407 408 409 410 411 412 447 532 533 534 535 536 641 643 644 645 646 648 649 650 651 652 653 658 659 660 674 696 727 728 736 776 806 807 903 909 
8 16 60 61 65 93 94 95 112 125 126 149 160 233 235 291 296 319 323 324 325 456 462 463 537 538 539 540 541 542 543 560 591 621 623 624 626 627 628 629 655 706 708 719 757 758 825 836 856 897 
42 43 71 72 73 96 97 99 127 128 172 173 174 175 176 177 360 413 414 415 464 465 556 557 558 570 571 572 573 574 575 578 586 636 637 638 639 688 694 710 739 791 848 
50 51 52 53 54 123 141 192 208 209 271 273 274 275 364 444 448 504 506 529 579 580 661 662 707 780 813 814 826 827 828 890 891 899 900 901 902 
63 74 75 98 138 236 237 238 239 240 241 242 367 424 425 427 446 502 503 514 515 516 517 526 527 545 699 717 718 774 775 788 790 798 829 838 889 
78 79 143 144 267 269 270 283 284 304 305 306 307 308 309 310 344 345 346 347 480 489 490 500 667 713 731 799 800 801 839 866 867 893 908 
9 17 18 19 20 22 56 220 228 229 230 234 318 320 321 322 366 369 370 397 398 399 400 401 403 466 485 486 487 589 795 808 844 864 
103 104 105 106 108 109 110 113 114 120 212 213 214 262 311 312 313 434 435 445 546 547 553 554 555 616 642 712 729 730 847 882 883 892 
76 77 134 135 136 139 140 142 145 254 368 384 385 386 402 457 458 459 460 461 483 484 525 759 851 852 862 887 888 
14 23 153 197 211 341 342 343 559 576 583 619 622 676 677 746 747 748 749 751 752 770 771 786 787 789 837 898 
45 46 47 48 49 62 66 90 115 121 232 314 315 389 390 426 477 577 584 585 612 657 794 820 821 
80 81 82 83 84 85 86 88 89 116 117 118 119 501 548 549 550 656 732 733 734 735 904 
107 122 151 152 154 155 156 157 281 282 362 363 365 420 421 422 453 454 455 488 781 845 846 
111 146 147 148 150 218 219 221 222 223 224 225 226 227 278 279 280 449 672 673 843 
293 473 474 475 588 590 598 599 600 601 609 610 611 697 698 709 802 803 
158 159 161 162 163 164 165 166 359 394 395 396 544 765 773 
33 34 55 57 58 179 180 182 183 185 392 471 896 
64 124 244 329 689 690 720 877 878 879 894 907 
100 101 436 437 438 492 631 632 633 634 850 880 
355 428 429 430 431 507 508 509 510 511 512 865 
35 36 37 38 207 528 635 686 687 881 
243 245 439 440 441 442 443 617 834 885 
336 349 587 613 614 615 869 874 875 876 
521 522 523 524 703 704 705 796 797 
167 168 169 170 171 481 482 842 
29 30 31 32 654 840 841 
59 210 371 750 762 763 764 
24 25 26 27 28 391 
647 812 816 817 818 
276 277 668 669 
380 381 382 383 
592 868 872 873 
700 701 702 
777 778 792 
