3 6 7 10 11 12 15 21 44 45 46 47 48 49 56 102 103 105 106 108 110 111 114 129 130 131 132 133 220 248 258 266 267 269 270 272 300 331 352 354 357 358 361 366 369 370 423 472 476 477 478 479 491 492 493 496 561 563 564 565 567 618 657 695 720 748 753 772 779 793 815 819 822 835 839 848 849 850 
87 186 187 188 189 190 191 193 194 195 196 198 199 200 201 202 203 205 206 348 350 351 393 406 407 408 409 410 411 412 447 696 736 776 903 909 
42 43 71 72 73 96 97 99 127 128 172 173 174 175 176 177 360 415 464 465 556 557 558 570 571 572 573 574 575 586 587 694 710 739 791 
8 16 94 95 112 149 160 212 214 296 318 319 380 456 537 539 541 543 554 555 560 591 621 624 625 655 706 825 856 892 
104 109 213 262 405 620 641 642 643 644 645 646 647 648 649 658 659 660 816 817 818 
146 147 148 150 218 219 221 222 223 224 225 226 227 278 279 280 449 672 673 843 
63 236 237 238 239 240 241 242 367 446 503 545 717 718 790 804 805 829 889 
197 211 341 342 516 559 576 583 613 619 787 789 837 838 874 875 876 884 898 
0 1 2 4 5 178 288 290 332 372 373 418 419 451 452 597 711 809 
51 141 192 210 444 506 529 579 580 707 780 812 813 814 899 900 901 
76 134 135 136 137 139 142 145 254 457 458 459 460 461 759 862 
301 326 328 330 333 334 335 337 338 339 340 374 375 376 377 
66 113 115 121 314 315 389 390 584 585 612 821 847 
204 292 303 674 675 678 740 741 806 807 853 854 863 
13 14 143 144 153 346 622 746 747 749 751 752 
80 81 82 84 85 86 88 89 548 549 550 904 
304 305 306 307 308 309 310 667 713 731 867 
17 18 19 20 22 233 234 320 321 589 
35 36 37 38 207 528 635 686 687 881 
246 247 249 250 255 256 257 260 566 714 
355 428 507 508 509 510 511 512 513 865 
74 75 181 184 424 425 426 427 886 
120 322 546 547 553 712 729 882 883 
251 252 253 259 261 562 640 833 870 
268 397 398 399 400 401 403 466 502 
371 420 421 422 453 454 455 488 781 
62 90 232 283 284 577 794 820 
122 151 154 155 156 157 845 846 
158 159 161 162 165 166 359 773 
228 229 230 485 486 487 795 
294 295 298 299 593 754 755 
24 25 26 27 28 391 
59 462 750 762 763 764 
60 65 93 463 719 836 
179 183 185 392 471 896 
243 245 440 442 617 885 
384 385 386 483 484 525 
494 495 497 498 499 500 
588 598 599 600 601 802 
29 31 32 654 841 
50 52 53 54 208 
61 125 126 291 897 
98 578 614 615 699 
140 368 402 851 852 
302 404 467 468 505 
329 689 690 877 878 
473 474 475 697 698 
514 515 517 526 527 
520 521 522 523 524 
623 626 627 628 629 
703 704 705 796 797 
9 808 844 864 
67 68 231 761 
117 118 119 501 
163 164 544 765 
168 170 171 842 
235 538 540 542 
273 364 448 702 
276 277 668 669 
289 297 347 480 
323 324 325 708 
439 441 443 834 
489 490 866 893 
532 533 534 535 
592 868 872 873 
609 610 611 803 
676 677 770 771 
732 733 734 735 
23 343 786 
33 34 58 
64 124 244 
77 887 888 
83 116 656 
123 209 504 
152 281 282 
180 182 536 
271 274 275 
293 590 709 
311 312 313 
327 760 871 
336 349 869 
344 345 908 
381 382 383 
394 395 396 
429 430 431 
434 435 445 
636 637 688 
650 651 652 
653 727 728 
661 662 902 
722 723 724 
774 775 798 
777 778 792 
799 800 801 
826 827 828 
879 894 907 
