6 7 8 9 10 11 12 13 14 15 55 56 59 60 61 64 65 93 120 121 122 123 126 129 130 131 132 133 151 154 157 270 289 291 292 294 296 297 298 299 318 366 369 370 371 380 401 462 463 593 609 610 612 695 719 746 747 748 749 750 751 752 808 820 821 825 836 844 845 846 
3 67 68 75 231 266 267 269 276 277 327 344 345 439 440 441 442 443 456 520 598 599 600 616 617 668 669 712 720 722 723 724 729 730 760 761 777 778 786 792 793 802 822 834 835 839 849 871 882 883 885 908 
246 247 248 249 250 252 253 254 255 256 257 258 259 260 261 561 562 563 564 565 566 567 640 713 714 731 772 815 833 
187 188 194 196 197 200 201 202 203 205 348 350 351 405 406 407 408 409 410 411 412 447 736 776 837 903 909 
42 44 45 46 47 48 49 50 51 52 53 54 208 209 210 211 300 476 477 478 479 577 657 848 
186 189 190 191 192 193 198 199 204 206 393 636 637 674 675 678 696 707 740 741 806 807 853 854 
301 326 328 330 331 333 334 335 336 337 338 339 340 349 367 372 374 375 376 377 545 838 869 
102 103 104 105 106 107 108 109 110 111 112 114 212 213 214 262 311 312 313 554 555 892 
146 147 148 149 150 218 219 220 221 222 225 227 278 279 280 444 448 449 504 672 673 843 
71 72 73 96 98 99 127 415 557 559 570 571 572 573 574 575 578 586 587 614 699 
24 27 28 76 134 135 136 137 139 140 142 143 144 145 457 458 459 460 461 560 
153 341 346 347 480 576 613 615 661 662 789 874 875 876 884 898 902 
125 175 352 353 355 356 357 507 508 509 510 511 512 791 865 897 
618 619 620 641 642 643 644 645 646 647 648 649 658 659 660 
158 159 160 161 162 163 164 165 166 359 394 395 396 773 
113 115 314 315 320 322 389 390 553 847 899 900 901 
20 94 95 537 538 539 540 541 542 543 544 591 
63 141 503 529 546 601 717 718 812 813 814 829 
81 83 84 85 86 88 90 548 549 550 656 904 
16 17 18 19 21 23 232 233 234 235 321 
62 155 268 273 274 283 284 502 547 702 794 
97 128 176 354 358 513 558 688 709 739 819 
100 101 436 437 438 631 632 633 634 850 880 
35 36 37 38 207 528 635 686 687 881 
43 172 173 174 177 360 464 465 694 710 
179 182 184 589 621 622 624 625 886 896 
420 421 422 423 453 454 455 488 779 781 
0 1 4 5 332 373 391 597 809 
304 306 309 489 491 667 866 867 893 
342 343 514 515 516 517 526 527 787 
156 361 362 363 364 365 446 790 
228 229 230 485 486 487 795 864 
305 307 308 310 799 800 801 
397 398 399 400 402 403 466 
494 495 496 497 498 499 500 
22 74 424 425 426 427 
31 32 654 655 706 841 
236 237 238 240 241 242 
384 385 386 483 484 525 
490 492 493 816 817 818 
116 117 118 119 501 
181 418 419 451 711 
195 532 533 534 535 
223 224 226 579 580 
239 324 804 805 889 
329 689 690 877 878 
387 388 606 607 608 
473 474 475 697 698 
623 626 627 628 629 
681 682 683 737 738 
703 704 705 796 797 
2 167 169 178 
39 40 41 721 
57 392 471 472 
66 583 584 585 
80 82 87 89 
124 243 244 245 
293 319 588 590 
295 753 754 755 
302 404 467 468 
428 429 430 431 
521 522 523 524 
551 552 715 716 
592 868 872 873 
664 665 666 784 
670 671 742 743 
676 677 770 771 
732 733 734 735 
762 763 764 765 
29 30 840 
33 34 58 
69 70 630 
77 887 888 
152 281 282 
215 216 217 
251 759 870 
263 264 265 
271 272 275 
285 286 287 
288 290 452 
323 325 708 
368 851 852 
378 379 602 
381 382 383 
434 435 445 
450 700 701 
469 470 785 
505 506 780 
556 638 639 
568 569 663 
603 604 605 
650 651 652 
653 727 728 
679 680 861 
691 692 693 
725 726 895 
744 745 756 
774 775 798 
826 827 828 
830 831 832 
879 894 907 
