3 6 7 10 11 12 14 15 21 44 45 46 47 48 49 56 67 68 75 102 103 105 106 108 110 111 114 129 130 131 132 133 137 220 231 246 247 248 249 250 251 252 253 255 256 257 258 259 260 261 266 272 276 277 302 311 312 313 331 352 353 354 356 358 361 366 369 370 404 423 467 468 472 476 477 478 479 491 493 494 495 496 497 498 499 500 505 513 561 562 563 564 565 566 567 618 620 625 640 657 668 669 695 714 720 722 723 724 748 753 761 768 769 772 777 778 779 792 793 815 822 833 835 848 849 870 
0 1 2 4 5 167 168 169 170 171 178 181 184 288 290 301 326 327 328 330 332 333 334 335 337 338 339 340 372 373 374 375 376 377 418 419 450 451 452 481 482 520 521 522 523 524 596 597 711 760 809 842 855 871 886 
50 51 52 53 54 123 141 146 147 148 150 192 208 209 218 219 221 222 223 224 225 226 227 271 273 274 275 278 279 280 364 444 448 449 504 506 529 579 580 672 673 707 780 812 813 814 826 827 828 843 890 891 
8 16 60 65 93 94 95 112 149 160 212 214 296 318 319 323 325 380 381 382 383 456 463 537 539 541 543 554 555 560 591 621 623 624 626 627 628 629 655 706 708 719 757 758 825 836 856 892 
42 43 71 72 73 96 97 99 127 128 172 173 174 175 176 177 336 349 357 360 413 414 415 464 465 556 557 558 570 571 572 573 574 575 578 586 587 636 637 638 639 688 694 710 739 791 819 869 
13 23 153 197 211 329 341 342 343 559 576 583 613 614 615 619 622 676 677 689 690 746 747 749 751 752 770 771 786 787 789 837 838 874 875 876 877 878 879 884 894 898 907 
9 204 228 229 230 289 292 294 295 297 298 299 300 303 485 486 487 593 674 675 678 740 741 754 755 795 806 807 808 844 853 854 863 864 
62 66 74 90 113 115 121 232 283 284 314 315 389 390 424 425 426 427 577 584 585 612 661 662 794 820 821 847 899 900 901 902 
63 98 236 237 238 239 240 241 242 324 367 446 503 514 515 516 517 526 527 545 699 717 718 774 775 790 798 804 805 829 889 
87 186 187 188 189 190 191 193 194 195 196 198 199 200 201 202 203 205 206 348 350 351 393 410 411 412 447 696 736 903 909 
76 77 134 135 136 138 139 142 145 254 384 385 386 457 458 459 460 461 483 484 525 759 788 862 887 888 
104 109 213 262 405 406 407 408 409 641 642 643 644 645 646 647 648 649 658 659 660 776 816 817 818 
80 81 82 83 84 85 86 88 89 116 117 118 119 501 548 549 550 656 732 733 734 735 904 
143 144 267 269 270 304 305 306 307 308 309 310 344 345 346 347 480 667 713 731 839 867 908 
100 101 436 437 438 489 490 492 631 632 633 634 799 800 801 850 866 880 893 
59 210 371 420 421 422 453 454 455 462 488 750 762 763 764 781 
17 18 19 20 22 233 234 235 320 321 322 538 540 542 589 
107 122 151 152 154 155 156 157 281 282 362 363 365 845 846 
158 159 161 162 163 164 165 166 359 394 395 396 544 765 773 
473 474 475 588 598 599 600 601 609 610 611 697 698 802 803 
120 434 435 445 546 547 553 616 712 729 730 882 883 
180 532 533 534 535 536 650 651 652 653 727 728 
355 428 429 430 431 507 508 509 510 511 512 865 
268 397 398 399 400 401 403 466 502 581 582 
35 36 37 38 207 528 635 686 687 881 
243 245 439 440 441 442 443 617 834 885 
61 64 124 125 126 244 291 897 
29 30 31 32 654 840 841 
179 182 183 185 392 471 896 
24 25 26 27 28 391 
33 34 55 57 58 
140 368 402 851 852 
703 704 705 796 797 
592 868 872 873 
293 590 709 
700 701 702 
