3 21 42 43 44 45 46 47 48 49 50 52 53 54 97 123 128 129 130 131 132 133 146 147 148 150 158 159 160 161 162 166 176 208 209 211 220 221 222 223 224 225 226 227 258 272 274 275 276 277 279 280 309 352 354 355 358 359 420 421 422 423 426 439 440 441 442 443 453 454 456 471 472 476 477 478 488 489 491 493 504 540 577 616 619 657 668 669 672 673 695 710 750 753 754 755 760 772 773 779 786 792 804 805 834 835 843 848 849 
8 12 24 27 28 61 62 63 66 80 82 83 84 85 89 90 94 95 116 121 126 134 143 149 157 234 271 278 283 346 380 449 549 560 561 563 564 567 621 624 708 717 718 794 815 856 
25 26 30 236 237 238 239 240 241 242 290 326 328 329 330 331 332 333 334 335 336 337 338 339 340 353 356 372 373 374 375 376 377 391 545 592 730 788 877 878 889 
51 55 56 58 59 60 64 65 93 141 163 165 210 244 444 462 463 505 506 546 588 719 762 763 764 765 780 812 813 814 836 
102 103 104 105 106 107 108 109 110 111 112 113 114 115 212 213 214 218 262 311 312 313 547 553 554 555 847 892 
186 187 188 194 195 196 197 202 203 205 206 343 350 351 410 412 447 620 644 696 736 837 903 909 
33 34 288 291 292 295 296 300 301 302 303 593 674 675 678 740 741 853 854 863 
57 81 86 87 88 189 190 191 192 193 198 199 200 201 393 548 550 636 707 
135 139 140 142 144 145 249 250 253 257 260 304 306 714 731 867 
587 613 641 642 643 645 646 647 649 658 659 660 712 729 882 883 
16 18 19 20 232 233 235 537 538 539 541 542 543 544 591 
246 247 248 251 252 254 256 259 261 562 566 640 759 833 862 
11 341 516 583 585 618 661 662 787 789 874 875 876 898 
71 73 127 494 495 496 497 499 500 559 571 574 625 796 
17 23 204 318 319 320 321 322 579 580 589 590 825 
72 96 98 99 415 557 570 572 573 575 578 586 699 
15 342 344 347 400 502 503 748 751 829 838 
6 7 9 10 14 122 808 844 846 864 
175 428 507 508 509 510 511 512 513 865 
179 181 182 184 392 424 425 427 886 896 
138 369 397 398 399 401 402 403 466 
266 267 268 269 270 284 617 839 885 
29 31 32 654 655 706 840 841 
76 136 137 457 458 459 460 461 
172 173 174 177 360 464 465 694 
305 307 308 490 492 850 866 893 
345 611 622 746 747 749 752 908 
228 229 230 485 486 487 795 
405 406 407 408 409 648 776 
418 419 450 451 452 700 711 
474 475 609 610 612 697 698 
0 1 2 4 5 178 
37 635 899 900 901 902 
289 294 297 298 299 480 
310 667 799 800 801 816 
314 315 389 390 473 601 
371 455 529 597 781 809 
384 385 386 483 484 525 
520 521 522 523 524 797 
598 599 600 802 803 822 
124 243 245 689 690 
125 357 558 819 897 
151 152 153 281 282 
167 168 170 171 842 
169 446 584 790 821 
327 404 467 468 871 
361 362 363 364 365 
366 367 368 370 791 
514 515 517 526 527 
532 533 534 535 536 
623 626 627 628 629 
22 348 349 869 
35 38 687 881 
67 68 231 761 
676 677 770 771 
36 207 528 
74 75 720 
77 887 888 
120 156 820 
180 183 185 
255 565 713 
273 448 702 
293 709 739 
323 324 325 
381 382 383 
394 395 396 
434 435 445 
498 576 793 
556 638 639 
650 651 652 
653 727 728 
703 704 705 
722 723 724 
774 775 798 
826 827 828 
868 872 873 
879 894 907 
