3 6 7 10 14 21 42 44 45 46 47 48 49 50 52 53 54 97 123 128 129 130 131 132 133 164 175 176 208 209 211 258 271 272 273 274 275 309 352 354 355 356 358 361 362 363 364 365 420 423 424 425 426 427 439 440 441 442 443 448 471 472 476 477 478 488 489 491 493 504 512 513 520 619 657 695 750 753 760 772 779 786 804 805 834 835 848 849 865 
8 11 12 29 31 32 62 63 80 81 82 83 84 85 89 90 116 121 149 157 158 159 160 161 162 163 165 166 234 278 341 359 456 462 540 549 560 577 583 585 618 620 621 624 654 655 661 662 706 708 717 718 773 794 840 841 856 898 
186 187 188 194 195 196 197 202 203 205 206 343 350 351 405 406 407 408 409 410 411 412 447 532 533 534 535 536 644 696 736 776 837 903 909 
55 56 58 59 60 64 65 93 146 147 148 150 219 220 221 222 223 224 225 226 227 244 279 280 449 463 672 673 719 836 843 
102 103 104 105 106 107 108 109 110 111 112 113 114 115 212 213 214 218 262 311 312 313 547 553 554 555 847 892 
30 290 326 328 329 330 331 333 334 335 336 337 338 339 340 372 373 374 375 376 377 545 592 730 868 877 878 
33 34 288 289 291 292 294 295 296 297 298 299 300 301 302 303 480 593 674 675 678 740 741 853 854 863 
57 86 87 88 189 190 191 192 193 198 199 200 201 392 393 548 550 636 637 707 
71 72 73 99 127 151 153 342 496 557 559 570 571 572 573 574 575 578 586 796 
16 17 18 19 20 23 204 232 318 319 320 321 322 579 580 589 825 
136 246 247 248 249 251 252 254 256 259 261 562 566 640 759 833 862 
51 141 444 505 506 588 590 762 763 764 765 780 813 814 
37 314 315 389 390 473 601 635 686 899 900 901 902 
43 172 173 174 177 360 415 464 465 694 710 754 755 
24 27 28 66 134 143 346 561 563 564 567 815 
179 181 182 184 418 419 450 451 452 711 886 896 
250 253 257 260 304 306 308 714 731 867 893 
9 120 122 156 546 808 820 844 846 864 
61 94 95 125 126 357 558 688 819 897 
100 101 436 437 438 631 632 633 634 880 
233 235 537 538 539 541 542 543 544 591 
310 647 667 799 800 801 812 816 817 818 
587 613 614 615 616 642 712 729 882 883 
138 369 397 398 399 401 402 403 466 
139 144 266 267 269 270 617 839 885 
345 611 622 746 747 748 749 752 908 
641 643 645 646 648 649 658 659 660 
74 75 124 243 245 689 690 720 
366 367 368 370 791 838 851 852 
35 36 38 207 528 687 881 
167 168 170 171 481 482 842 
228 229 230 485 486 487 795 
494 495 497 498 500 576 793 
0 1 2 4 5 178 
76 457 458 459 460 461 
236 237 238 240 241 242 
305 307 490 492 850 866 
384 385 386 483 484 525 
421 422 453 454 455 781 
598 599 600 802 803 822 
25 26 332 353 391 
169 446 584 790 821 
210 371 529 597 809 
327 404 467 468 871 
507 508 509 510 511 
514 515 517 526 527 
623 626 627 628 629 
13 479 870 884 
22 348 349 869 
67 68 231 761 
96 98 516 699 
135 140 142 145 
155 268 283 284 
239 324 788 889 
276 277 668 669 
380 381 382 383 
428 429 430 431 
474 609 610 612 
676 677 770 771 
15 400 751 
77 887 888 
137 499 625 
152 281 282 
180 183 185 
255 565 713 
293 709 739 
394 395 396 
434 435 445 
475 697 698 
502 503 829 
522 523 524 
556 638 639 
650 651 652 
653 727 728 
700 701 702 
703 704 705 
722 723 724 
774 775 798 
777 778 792 
826 827 828 
874 875 876 
879 894 907 
