0 3 75 102 266 268 326 327 328 330 331 332 333 335 337 338 339 340 372 373 376 377 391 439 440 441 442 443 456 494 495 496 498 499 502 592 597 613 614 615 616 703 704 705 712 720 729 730 760 786 793 796 797 804 805 809 822 834 835 849 871 882 883 884 
103 104 105 106 108 109 110 111 113 114 115 212 213 214 311 312 313 314 315 320 321 322 389 390 455 473 474 475 553 554 555 781 847 892 
43 71 72 73 96 98 99 127 128 172 173 174 176 177 360 415 464 465 556 557 559 570 571 572 573 578 586 694 699 709 739 
246 247 248 250 251 252 253 255 256 257 258 259 260 261 561 562 563 564 565 566 567 640 713 759 772 815 833 
146 147 148 149 150 218 220 221 222 223 224 225 226 227 278 279 280 444 448 449 504 579 580 672 673 843 
187 188 194 196 197 200 201 202 203 205 348 349 351 405 406 407 408 409 410 447 736 776 837 869 903 909 
42 44 45 46 47 48 49 211 300 476 477 478 479 577 657 675 678 740 741 848 853 854 
37 63 141 503 529 546 598 599 600 601 635 717 718 812 813 814 829 899 900 901 902 
8 12 55 56 60 64 65 93 112 129 157 296 318 380 401 462 463 719 825 836 
20 94 95 165 291 537 538 539 540 541 542 543 544 591 
341 342 343 516 576 661 662 787 789 838 874 875 876 898 
24 25 26 27 28 134 135 139 140 142 143 851 852 
62 283 284 397 398 399 400 402 403 466 547 794 
76 136 137 144 145 457 458 459 460 461 500 560 
120 121 123 130 131 133 262 612 695 750 820 821 
304 305 306 307 308 309 310 667 799 800 801 867 
100 101 436 437 438 631 632 633 634 850 880 
345 609 610 611 746 747 749 751 752 803 908 
641 642 643 645 646 647 648 649 658 659 660 
179 182 184 589 621 622 624 625 886 896 
189 190 191 193 199 204 636 674 806 807 
236 237 238 239 240 241 242 324 545 889 
80 81 82 83 84 87 89 548 656 
97 125 354 357 358 513 558 819 897 
158 159 160 161 162 163 166 359 773 
50 51 52 53 54 208 209 210 
57 186 192 198 206 393 696 707 
228 229 230 485 486 487 795 864 
289 294 297 298 299 303 593 863 
420 421 422 423 453 454 488 779 
428 507 508 509 510 511 512 865 
61 124 126 151 154 244 845 
85 86 88 90 549 550 904 
107 156 361 362 363 364 365 
180 195 532 533 534 535 536 
243 245 267 269 617 839 885 
329 374 375 689 690 877 878 
2 167 169 178 446 790 
9 122 292 808 844 846 
31 32 654 655 706 841 
175 352 353 355 356 791 
271 272 273 274 275 702 
290 418 419 451 452 711 
367 520 521 522 523 524 
384 385 386 483 484 525 
489 490 491 492 866 893 
6 7 10 13 14 
16 18 21 22 426 
17 19 232 234 235 
74 181 424 425 427 
116 117 118 119 501 
153 412 619 620 644 
366 368 369 370 371 
387 388 606 607 608 
514 515 517 526 527 
623 626 627 628 629 
681 682 683 737 738 
11 15 59 748 
35 38 687 881 
39 40 41 721 
66 583 584 585 
67 68 231 761 
168 170 171 842 
276 277 668 669 
302 404 467 468 
336 574 575 587 
344 346 347 480 
493 816 817 818 
551 552 715 716 
664 665 666 784 
670 671 742 743 
676 677 770 771 
732 733 734 735 
762 763 764 765 
1 4 5 
29 30 840 
33 34 58 
36 207 528 
69 70 630 
77 887 888 
152 281 282 
215 216 217 
249 714 731 
263 264 265 
285 286 287 
288 293 618 
295 710 754 
319 588 590 
323 325 708 
378 379 602 
381 382 383 
392 471 472 
394 395 396 
429 430 431 
434 435 445 
450 700 701 
469 470 785 
505 506 780 
568 569 663 
603 604 605 
650 651 652 
653 727 728 
679 680 861 
691 692 693 
722 723 724 
725 726 895 
744 745 756 
774 775 798 
777 778 792 
826 827 828 
830 831 832 
868 872 873 
879 894 907 
