3 6 7 10 11 12 15 21 44 67 68 102 129 130 131 132 133 231 246 247 248 249 250 251 252 253 255 256 257 258 259 260 261 266 268 272 331 352 354 356 357 358 361 404 423 472 478 491 493 494 495 496 497 498 513 520 561 562 563 564 565 566 567 618 620 640 695 714 722 723 724 753 761 772 779 793 804 805 815 819 822 833 835 849 
8 16 60 61 65 93 94 95 112 125 126 149 160 291 296 319 323 324 325 456 462 463 560 591 621 624 655 706 708 719 825 836 856 897 
0 1 2 4 5 137 178 288 290 326 328 330 332 333 335 337 338 339 340 353 372 373 374 375 376 377 499 597 625 809 
103 104 105 106 108 109 110 113 114 212 213 214 262 311 312 313 554 555 616 642 712 729 730 847 882 883 892 
186 187 188 194 196 202 203 205 206 348 350 351 405 406 407 408 409 410 411 447 648 696 736 776 903 909 
50 51 52 53 54 123 141 192 208 209 273 364 444 448 504 506 529 579 580 707 780 813 814 
42 43 96 97 99 128 172 173 174 175 176 177 360 415 464 465 558 694 710 739 791 848 
63 236 237 238 239 240 241 242 367 424 425 427 446 502 503 545 717 718 790 829 838 889 
146 147 148 150 219 221 222 223 224 225 226 227 278 279 280 449 672 673 843 
289 294 295 297 298 299 300 303 476 593 675 678 740 741 754 755 853 854 863 
107 151 152 154 155 156 281 282 363 420 421 422 453 454 455 488 781 
87 189 190 191 193 198 199 200 201 204 292 393 674 806 807 
158 159 161 162 163 164 165 166 359 394 395 396 544 765 773 
9 366 369 370 397 398 399 400 401 403 466 808 844 864 
66 115 121 314 315 389 390 426 584 585 612 821 
80 81 82 84 85 86 88 89 548 549 550 904 
14 153 342 559 622 746 747 748 749 751 752 
35 36 37 38 207 528 635 686 687 881 
100 101 436 437 438 631 632 633 634 880 
134 135 136 139 142 145 254 759 862 
181 184 418 419 450 451 452 711 886 
233 235 537 538 539 540 541 542 543 
355 428 507 508 509 510 511 512 865 
45 46 62 90 232 577 794 820 
98 514 515 516 517 526 527 699 
336 349 587 613 869 874 875 876 
588 598 599 600 601 611 802 803 
641 643 645 646 649 658 659 660 
18 19 20 22 56 220 234 
59 210 371 750 762 763 764 
71 72 73 571 574 575 578 
228 229 230 485 486 487 795 
304 306 309 667 713 731 867 
305 307 308 310 799 800 801 
473 474 475 609 610 697 698 
17 318 320 321 322 589 
24 25 26 27 28 391 
76 457 458 459 460 461 
127 557 570 572 573 586 
195 532 533 534 535 536 
211 341 583 619 789 898 
243 245 440 442 617 885 
267 269 270 283 284 839 
384 385 386 483 484 525 
521 703 704 705 796 797 
29 30 32 840 841 
47 48 49 477 657 
179 182 392 471 896 
329 689 690 877 878 
344 345 347 480 908 
623 626 627 628 629 
647 812 816 817 818 
23 343 786 787 
64 124 244 720 
117 118 119 501 
120 546 547 553 
122 157 845 846 
143 144 346 500 
168 170 171 842 
276 277 668 669 
302 467 468 505 
380 381 382 383 
439 441 443 834 
489 490 866 893 
592 868 872 873 
676 677 770 771 
732 733 734 735 
899 900 901 902 
33 34 58 
77 887 888 
83 116 656 
180 183 185 
197 576 837 
271 274 275 
293 590 709 
327 760 871 
368 851 852 
429 430 431 
434 435 445 
522 523 524 
556 638 639 
636 637 688 
650 651 652 
653 727 728 
700 701 702 
774 775 798 
777 778 792 
826 827 828 
879 894 907 
