3 6 7 9 10 14 21 29 31 32 42 43 44 45 46 47 48 49 50 52 53 54 67 68 74 75 78 79 97 120 122 123 125 128 129 130 131 132 133 146 147 148 150 155 156 158 159 160 161 162 164 166 172 173 174 176 177 208 209 211 220 221 222 223 224 225 226 227 228 229 230 231 258 272 273 274 275 276 277 279 280 305 307 308 309 310 352 354 355 357 358 359 360 361 362 363 364 365 394 395 396 420 421 422 423 426 439 440 441 442 443 448 453 454 456 464 465 471 472 476 477 478 485 486 487 488 489 490 491 492 493 504 540 556 558 577 616 619 638 639 654 655 657 667 668 669 672 673 676 677 694 695 702 706 710 720 722 723 724 750 753 754 755 760 761 770 771 772 773 777 778 779 786 792 795 799 800 801 804 805 808 816 819 820 826 827 828 834 835 840 841 843 844 846 848 849 850 864 866 893 897 
71 72 73 76 77 96 98 99 127 135 136 137 139 140 142 144 145 151 152 153 154 175 246 247 248 249 250 251 252 253 254 255 256 257 259 260 261 281 282 304 306 384 385 386 413 414 415 428 457 458 459 460 461 483 484 494 495 496 497 498 499 500 507 508 509 510 511 512 513 525 557 559 562 565 566 570 571 572 573 574 575 576 578 586 625 640 699 713 714 731 759 768 769 793 796 833 845 862 865 867 887 888 
8 11 12 24 27 28 61 62 63 66 80 82 83 84 85 89 90 94 95 116 121 124 126 134 143 149 157 169 234 243 245 271 278 283 341 346 380 381 382 383 446 449 514 515 516 517 526 527 549 560 561 563 564 567 583 584 585 618 621 623 624 626 627 628 629 661 662 689 690 708 717 718 757 758 774 775 787 789 790 794 798 815 821 856 874 875 876 898 
25 26 30 236 237 238 239 240 241 242 290 326 327 328 329 330 331 332 333 334 335 336 337 338 339 340 353 356 372 373 374 375 376 377 391 404 467 468 545 592 596 730 788 855 868 871 872 873 877 878 879 889 894 907 
186 187 188 194 195 196 197 202 203 205 206 219 343 350 351 405 406 407 408 409 410 411 412 447 532 533 534 535 536 620 644 648 650 651 652 653 696 727 728 736 776 837 903 909 
37 51 55 56 58 59 60 64 65 93 141 163 165 210 244 444 462 463 505 506 546 588 635 719 762 763 764 765 780 812 813 814 836 890 891 899 900 901 902 
16 17 18 19 20 23 204 232 233 235 318 319 320 321 322 537 538 539 541 542 543 544 579 580 589 590 591 806 807 825 
102 103 104 105 106 107 108 109 110 111 112 113 114 115 212 213 214 218 262 311 312 313 547 553 554 555 847 892 
33 34 288 289 291 292 294 295 296 297 298 299 300 301 302 303 480 593 674 675 678 740 741 853 854 863 
314 315 371 389 390 455 473 474 475 529 597 598 599 600 601 609 610 612 697 698 781 802 803 809 822 
0 1 2 4 5 178 366 367 368 370 520 521 522 523 524 703 704 705 791 797 851 852 
434 435 445 587 613 614 615 641 642 643 645 646 647 649 658 659 660 712 729 882 883 
15 138 342 344 347 369 397 398 399 400 401 402 403 466 502 503 748 751 829 838 
179 180 181 182 183 184 185 392 418 419 424 425 427 450 451 452 700 711 886 896 
57 81 86 87 88 189 190 191 192 193 198 199 200 201 393 548 550 636 707 
13 345 479 611 622 746 747 749 752 870 884 908 
266 267 268 269 270 284 581 582 617 839 885 
35 36 38 207 528 687 881 
167 168 170 171 481 482 842 
22 348 349 869 
293 709 739 
323 324 325 
