3 6 7 9 10 11 12 15 21 44 45 46 47 48 49 56 102 103 104 105 106 108 109 110 111 114 129 130 131 132 133 212 214 220 258 266 267 269 270 272 276 277 311 312 313 331 352 354 357 358 361 366 369 370 420 423 462 472 476 477 478 479 488 491 492 493 496 554 555 561 563 564 565 567 616 618 657 668 669 695 720 730 748 753 772 777 778 779 792 793 808 815 819 822 835 839 844 848 849 850 892 
42 43 71 72 73 96 97 98 99 127 128 172 173 174 175 176 177 360 415 464 465 556 557 558 570 571 572 573 574 575 578 586 587 614 615 694 699 710 739 791 
87 186 187 188 189 190 191 193 194 195 196 198 199 200 201 202 203 205 206 348 350 351 393 405 406 407 408 409 410 411 412 447 696 736 776 903 909 
0 288 290 326 328 330 332 333 335 337 338 339 340 372 373 374 375 376 377 418 419 451 452 597 711 809 
8 16 94 95 112 149 160 296 318 319 456 537 539 541 543 560 591 621 624 625 655 706 825 856 
51 141 192 210 271 273 274 275 444 506 529 579 580 588 702 707 780 812 813 814 899 900 901 
246 247 248 249 250 251 252 253 255 256 257 259 260 261 562 566 640 714 833 
63 236 237 238 239 240 241 242 367 503 545 717 718 804 805 829 889 
197 211 341 516 559 576 583 613 619 789 837 870 874 875 876 884 898 
76 134 135 136 137 139 142 145 254 457 458 459 460 461 759 862 
289 294 297 298 299 300 303 593 675 678 740 741 853 854 863 
146 147 148 218 219 221 222 223 224 225 226 672 673 
262 620 641 642 643 644 645 646 648 649 658 659 660 
13 14 143 144 153 346 622 746 747 749 751 752 
80 81 82 84 85 86 88 89 548 549 550 904 
122 151 154 155 156 157 362 364 365 845 846 
304 305 306 307 308 309 310 667 713 731 867 
17 18 19 20 22 233 234 320 321 589 
35 36 37 38 207 528 635 686 687 881 
355 428 507 508 509 510 511 512 513 865 
74 75 181 184 424 425 426 427 886 
113 115 121 314 315 389 390 612 847 
268 397 398 399 400 401 403 466 502 
62 90 232 283 284 577 794 820 
150 227 278 279 280 448 449 843 
158 159 161 162 165 166 359 773 
228 229 230 485 486 487 795 864 
167 168 170 171 481 482 842 
213 322 553 712 729 882 883 
371 421 422 453 454 455 781 
24 25 26 27 28 391 
60 65 93 463 719 836 
66 446 584 585 790 821 
179 183 185 392 471 896 
243 245 440 442 617 885 
384 385 386 483 484 525 
494 495 497 498 499 500 
29 31 32 654 841 
50 52 53 54 208 
59 750 762 763 764 
61 125 126 291 897 
140 368 402 851 852 
204 292 674 806 807 
302 404 467 468 505 
329 689 690 877 878 
342 344 345 838 908 
473 474 475 697 698 
514 515 517 526 527 
520 521 522 523 524 
598 599 600 601 802 
623 626 627 628 629 
703 704 705 796 797 
23 343 786 787 
67 68 231 761 
117 118 119 501 
163 164 544 765 
235 538 540 542 
323 324 325 708 
380 381 382 383 
439 441 443 834 
489 490 866 893 
532 533 534 535 
592 868 872 873 
609 610 611 803 
647 816 817 818 
676 677 770 771 
732 733 734 735 
1 4 5 
2 169 178 
33 34 58 
64 124 244 
77 887 888 
83 116 656 
120 546 547 
123 209 504 
152 281 282 
180 182 536 
293 590 709 
295 754 755 
327 760 871 
336 349 869 
394 395 396 
429 430 431 
434 435 445 
636 637 688 
650 651 652 
653 727 728 
661 662 902 
722 723 724 
774 775 798 
799 800 801 
826 827 828 
879 894 907 
