0 3 75 102 266 268 276 277 326 327 328 330 331 332 333 335 337 338 339 340 361 362 363 364 365 372 373 376 377 391 439 440 441 442 443 456 494 495 496 498 499 502 592 597 613 615 616 668 669 703 704 705 712 720 729 730 760 777 778 786 792 793 796 797 804 805 809 822 834 835 849 871 882 883 884 
103 104 105 106 107 108 109 110 111 113 114 115 212 213 214 311 312 313 314 315 320 321 322 389 390 473 474 475 553 554 555 847 892 
246 247 248 250 252 253 255 256 257 258 259 260 261 561 562 563 564 565 566 567 640 713 714 731 772 815 833 
146 147 148 149 150 218 220 221 222 223 224 225 226 227 278 279 280 444 448 449 504 579 580 672 673 843 
71 72 73 98 127 128 176 415 556 557 559 570 571 572 573 578 586 614 699 709 739 
187 188 194 196 197 200 201 202 203 205 348 349 351 410 412 447 736 837 869 903 909 
8 12 55 56 60 64 65 93 112 129 157 296 318 401 462 463 719 825 836 
37 63 141 503 529 546 635 686 717 718 812 813 814 829 899 900 901 902 
120 121 123 130 131 132 133 156 262 270 612 695 750 820 821 
42 44 45 46 47 48 49 211 477 478 479 577 657 848 
24 25 26 27 28 134 135 139 140 142 143 851 852 
153 619 641 642 643 644 645 646 647 649 658 659 660 
20 165 291 537 538 539 540 541 542 543 544 591 
76 136 137 144 145 457 458 459 460 461 500 560 
236 237 238 239 240 241 242 324 446 545 790 889 
304 305 306 307 308 309 310 667 799 800 801 867 
43 96 99 172 173 174 177 360 464 465 694 
62 66 271 272 273 274 275 283 547 702 794 
97 125 352 354 355 357 358 513 558 819 897 
100 101 436 437 438 631 632 633 634 850 880 
179 182 184 589 621 622 624 625 886 896 
189 190 191 193 199 204 636 674 806 807 
289 294 297 298 299 301 303 334 593 863 
61 94 95 124 126 151 154 244 845 
81 85 86 88 90 548 549 550 904 
158 159 160 161 162 163 166 359 773 
341 576 661 662 789 874 875 876 898 
50 51 52 53 54 208 209 210 
57 186 192 198 206 393 696 707 
420 421 422 423 453 454 488 779 
428 507 508 509 510 511 512 865 
9 122 292 808 844 846 864 
17 19 23 232 233 234 235 
35 36 38 207 528 687 881 
80 82 83 84 87 89 656 
167 168 170 171 481 482 842 
180 195 532 533 534 535 536 
228 229 230 485 486 487 795 
243 245 267 269 617 839 885 
302 404 467 468 505 506 780 
329 374 375 689 690 877 878 
345 746 747 749 751 752 908 
366 368 369 370 371 455 781 
397 398 399 400 402 403 466 
405 406 407 408 409 648 776 
31 32 654 655 706 841 
290 418 419 451 452 711 
367 520 521 522 523 524 
384 385 386 483 484 525 
489 490 491 492 866 893 
675 678 740 741 853 854 
6 7 10 13 14 
16 18 21 22 426 
74 181 424 425 427 
116 117 118 119 501 
249 251 254 759 870 
295 710 753 754 755 
342 343 516 787 838 
387 388 606 607 608 
514 515 517 526 527 
609 610 611 802 803 
623 626 627 628 629 
681 682 683 737 738 
11 15 59 748 
39 40 41 721 
67 68 231 761 
175 353 356 791 
284 583 584 585 
288 293 618 620 
336 574 575 587 
344 346 347 480 
380 381 382 383 
493 816 817 818 
551 552 715 716 
598 599 600 601 
664 665 666 784 
670 671 742 743 
676 677 770 771 
732 733 734 735 
762 763 764 765 
1 4 5 
2 169 178 
29 30 840 
33 34 58 
69 70 630 
77 887 888 
152 281 282 
215 216 217 
263 264 265 
285 286 287 
319 588 590 
323 325 708 
378 379 602 
392 471 472 
394 395 396 
429 430 431 
434 435 445 
450 700 701 
469 470 785 
568 569 663 
603 604 605 
650 651 652 
653 727 728 
679 680 861 
691 692 693 
722 723 724 
725 726 895 
744 745 756 
774 775 798 
826 827 828 
830 831 832 
868 872 873 
879 894 907 
