3 6 7 10 14 21 42 44 45 46 47 48 49 52 53 54 97 128 147 148 150 164 175 176 211 219 220 221 222 223 224 225 226 227 258 272 274 275 279 280 309 352 354 355 356 358 420 423 424 425 426 427 439 440 441 442 443 449 471 472 476 477 478 488 489 491 493 512 513 520 540 619 657 672 673 753 760 772 779 786 804 805 834 835 843 848 849 865 
8 11 12 29 31 32 62 66 80 82 83 84 85 89 90 116 129 149 157 158 159 160 161 162 163 165 166 271 278 341 346 359 456 549 560 561 563 564 567 577 583 585 618 620 621 624 654 655 661 662 706 708 773 794 815 840 841 856 898 
30 290 326 328 329 330 331 333 334 335 336 337 338 339 340 372 373 374 375 376 377 404 545 592 730 868 877 878 
102 103 104 105 106 107 108 109 110 111 112 113 114 115 212 213 214 218 262 311 312 313 547 553 554 555 847 892 
9 120 121 122 123 130 131 132 133 146 156 209 421 422 453 454 455 504 695 750 781 808 820 844 846 864 
71 72 73 99 127 151 153 342 344 345 347 496 557 559 570 571 572 573 574 575 578 586 796 908 
24 27 28 50 51 63 134 141 143 208 444 505 506 546 717 718 762 763 764 765 780 813 814 
186 188 194 195 196 197 202 203 206 343 350 407 410 447 532 533 534 535 536 644 696 736 837 
35 36 37 38 207 314 315 389 390 473 528 588 590 601 635 686 687 881 899 900 901 902 
33 34 288 289 291 292 294 295 296 297 298 299 300 301 302 303 480 593 675 863 
16 17 18 19 20 23 204 232 318 319 320 321 322 579 580 589 806 807 825 
57 81 86 87 88 189 190 191 192 193 198 200 201 393 548 550 636 637 707 
187 205 351 406 408 409 412 641 643 645 646 648 649 658 659 660 776 903 909 
136 246 247 248 249 251 252 254 256 259 261 562 566 640 759 833 862 
179 180 181 182 183 184 185 418 419 450 451 452 711 886 896 
55 56 58 59 60 64 65 93 234 244 462 463 719 836 
43 172 173 174 177 360 415 464 465 694 710 754 755 
139 144 155 266 267 268 269 270 283 284 617 839 885 
250 253 257 260 304 306 308 714 731 867 893 
100 101 436 437 438 631 632 633 634 880 
310 647 667 799 800 801 812 816 817 818 
587 613 614 615 616 642 712 729 882 883 
0 1 2 4 5 137 178 499 625 
138 369 397 398 399 401 402 403 466 
366 367 368 370 791 838 851 852 
25 26 327 332 353 391 871 
167 168 170 171 481 482 842 
228 229 230 485 486 487 795 
273 361 362 363 364 365 448 
494 495 497 498 500 576 793 
611 622 746 747 748 749 752 
76 457 458 459 460 461 
124 243 245 689 690 720 
125 357 558 688 819 897 
235 537 541 542 543 544 
236 237 238 240 241 242 
305 307 490 492 850 866 
384 385 386 483 484 525 
598 599 600 802 803 822 
674 678 740 741 853 854 
169 446 584 790 821 
210 371 529 597 809 
507 508 509 510 511 
514 515 517 526 527 
623 626 627 628 629 
13 479 870 884 
22 348 349 869 
61 94 95 126 
67 68 231 761 
96 98 516 699 
135 140 142 145 
233 538 539 591 
239 324 788 889 
276 277 668 669 
380 381 382 383 
428 429 430 431 
474 609 610 612 
676 677 770 771 
15 400 751 
77 887 888 
152 281 282 
255 565 713 
293 709 739 
394 395 396 
434 435 445 
475 697 698 
502 503 829 
522 523 524 
556 638 639 
650 651 652 
653 727 728 
700 701 702 
703 704 705 
722 723 724 
774 775 798 
777 778 792 
826 827 828 
874 875 876 
879 894 907 
