3 21 44 45 46 47 48 49 56 75 102 103 105 106 108 110 111 114 129 130 131 132 133 220 246 247 248 249 250 251 252 253 255 256 257 258 259 260 261 266 272 331 352 354 358 361 366 369 370 404 423 472 476 477 478 479 491 493 513 561 562 564 565 567 618 620 640 657 695 714 720 753 779 792 793 815 822 833 835 848 849 870 
0 1 2 4 5 178 181 184 288 290 326 328 330 332 333 335 337 338 339 340 372 373 374 375 376 377 418 419 450 451 452 597 711 809 886 
8 16 94 95 112 149 160 212 214 296 318 319 323 325 380 456 537 539 541 543 554 555 560 591 621 624 655 706 708 825 856 892 
87 186 187 188 189 190 191 193 194 195 196 198 199 200 201 202 203 205 206 348 350 351 393 410 411 412 447 696 736 903 909 
42 43 96 97 99 128 172 173 174 175 176 177 357 360 415 464 465 556 558 694 710 739 791 819 
204 289 292 294 295 297 298 299 300 303 593 674 675 678 740 741 754 755 806 807 853 854 863 
146 147 148 150 218 219 221 222 223 224 225 226 227 278 279 280 449 672 673 843 
405 406 407 408 409 641 643 644 645 646 647 648 649 658 659 660 776 816 817 818 
71 72 73 127 336 349 557 570 571 572 573 574 575 578 586 587 869 
66 113 115 121 314 315 389 390 584 585 612 821 847 899 900 901 
211 341 342 559 583 613 614 615 789 838 874 875 876 884 898 
51 141 192 444 506 529 579 580 707 780 812 813 814 
80 81 82 84 85 86 88 89 548 549 550 904 
158 159 161 162 163 164 165 166 359 544 765 773 
17 18 19 20 22 233 234 320 321 322 589 
236 237 238 239 240 241 242 324 804 805 889 
304 305 306 307 308 309 310 667 713 731 867 
474 588 598 599 600 601 609 610 611 802 803 
35 36 37 38 207 528 635 686 687 881 
100 101 436 437 438 631 632 633 634 880 
243 245 439 440 441 442 443 617 834 885 
13 153 619 622 746 747 749 751 752 
63 367 446 503 545 717 718 790 829 
134 135 136 139 142 145 254 759 862 
137 494 495 496 497 498 499 500 625 
355 428 507 508 509 510 511 512 865 
6 7 10 11 12 14 15 748 
62 90 232 283 284 577 794 820 
98 514 515 516 517 526 527 699 
120 546 547 553 712 729 882 883 
122 151 154 155 156 157 845 846 
420 421 422 453 454 455 488 781 
143 144 267 269 270 346 839 
228 229 230 485 486 487 795 
397 398 399 400 401 403 466 
24 25 26 27 28 391 
59 462 750 762 763 764 
60 65 93 463 719 836 
76 457 458 459 460 461 
384 385 386 483 484 525 
29 31 32 654 841 
50 52 53 54 208 
61 125 126 291 897 
74 424 425 426 427 
104 109 213 262 642 
140 368 402 851 852 
179 182 392 471 896 
329 689 690 877 878 
520 521 522 523 524 
623 626 627 628 629 
703 704 705 796 797 
9 808 844 864 
23 343 786 787 
67 68 231 761 
117 118 119 501 
168 170 171 842 
235 538 540 542 
276 277 668 669 
302 467 468 505 
473 475 697 698 
489 490 866 893 
532 533 534 535 
592 868 872 873 
676 677 770 771 
732 733 734 735 
33 34 58 
64 124 244 
77 887 888 
83 116 656 
123 209 504 
152 281 282 
197 576 837 
271 274 275 
273 364 448 
293 590 709 
311 312 313 
327 760 871 
344 345 908 
381 382 383 
394 395 396 
429 430 431 
434 435 445 
563 566 772 
636 637 688 
650 651 652 
653 727 728 
661 662 902 
700 701 702 
722 723 724 
774 775 798 
799 800 801 
826 827 828 
879 894 907 
