0 3 29 31 32 42 43 44 45 46 47 48 49 50 52 53 54 123 130 132 133 146 150 155 158 159 160 161 162 164 166 208 209 211 220 221 222 223 224 225 226 227 258 276 277 279 305 309 352 354 355 358 359 361 365 420 421 422 423 426 439 440 441 442 443 453 454 456 471 472 476 477 478 479 488 489 490 491 492 493 504 540 619 654 655 657 668 669 672 673 676 677 706 708 710 753 754 755 760 770 771 773 777 778 779 786 792 804 805 834 835 840 841 848 849 850 866 
25 30 236 237 238 239 240 241 242 290 323 324 325 326 327 328 329 330 331 332 333 334 335 336 337 338 339 340 353 356 372 373 374 375 376 377 391 404 418 419 434 435 445 450 451 467 468 545 592 596 616 711 712 729 730 788 855 868 870 871 872 873 877 878 879 882 883 884 889 894 907 
76 77 78 79 135 136 137 139 140 142 144 145 246 247 248 249 250 251 252 253 254 255 256 257 259 260 261 304 306 307 308 310 384 385 386 457 458 459 460 461 483 484 525 562 563 565 566 640 667 713 714 731 759 768 769 772 799 800 801 815 816 833 851 852 862 867 887 888 893 
57 81 83 84 86 87 88 116 186 187 188 189 190 191 192 193 194 195 196 197 198 199 200 201 202 203 205 206 219 343 351 393 405 406 407 408 409 410 411 412 447 548 550 613 614 615 620 636 641 642 643 644 645 646 647 648 649 658 659 660 696 707 736 776 837 903 909 
1 2 4 5 6 7 9 10 13 14 61 74 75 94 95 120 122 124 125 126 129 131 154 156 169 178 228 229 230 243 245 262 284 357 446 485 486 487 558 584 637 688 689 690 695 720 774 775 790 795 798 808 819 820 821 844 845 846 864 897 
11 35 36 37 38 51 56 59 60 64 65 93 141 207 244 341 444 462 463 505 506 516 528 546 583 585 588 618 635 661 662 686 687 719 762 763 764 765 780 787 789 812 813 814 836 874 875 876 881 890 891 898 899 900 901 902 
8 12 24 62 63 66 80 82 85 89 90 121 134 143 148 149 157 234 271 278 283 346 380 381 382 383 537 543 547 549 560 561 564 567 577 621 623 624 626 627 628 629 717 718 757 758 794 856 
71 72 73 96 97 98 99 127 128 172 173 174 175 176 177 360 413 414 415 428 464 465 494 495 496 499 500 507 513 556 557 559 570 571 572 573 574 575 578 586 587 625 638 639 694 699 796 865 
102 103 104 105 106 107 108 109 110 111 112 113 114 115 147 212 213 214 218 272 273 274 275 280 311 312 313 362 363 364 448 449 553 554 555 700 701 702 826 827 828 843 847 892 
210 314 315 345 371 389 390 455 473 474 475 529 597 598 599 600 601 609 610 611 612 622 697 698 746 747 749 750 752 781 802 803 809 822 908 
16 17 18 19 20 21 22 23 163 165 204 232 233 235 318 319 320 321 322 348 349 538 541 542 544 579 580 589 590 591 806 807 825 869 
33 34 55 58 288 289 291 292 293 294 295 296 297 298 299 300 301 302 303 347 480 539 593 674 675 678 709 739 740 741 853 854 
15 138 266 267 268 269 270 342 344 369 397 398 399 400 401 402 403 466 502 503 581 582 617 748 751 829 838 839 885 
179 180 181 182 183 184 185 392 424 425 427 452 532 533 534 535 536 650 651 652 653 727 728 886 896 
366 367 368 370 520 521 522 523 524 703 704 705 791 797 
167 168 170 171 481 482 842 
151 152 153 281 282 
514 515 517 526 527 
67 68 231 761 
394 395 396 
498 576 793 
722 723 724 
