3 6 7 10 11 12 15 21 44 64 67 68 102 124 129 130 131 132 133 231 244 246 247 248 249 250 251 252 253 255 256 257 258 259 260 261 266 272 293 331 352 354 356 357 358 361 423 472 478 491 493 494 495 496 498 561 562 563 564 565 566 567 590 592 618 620 640 689 690 695 709 714 720 722 723 724 730 753 761 768 769 772 779 793 804 805 815 819 822 833 835 849 868 872 873 
8 16 17 18 19 33 34 60 61 65 93 94 95 112 125 126 149 160 233 235 291 296 318 319 323 324 325 456 463 537 538 539 540 541 542 543 560 591 621 622 623 624 626 627 628 629 655 706 708 719 757 758 825 836 856 897 
35 36 37 38 50 51 52 53 54 123 141 192 207 208 209 271 273 274 275 364 444 448 504 506 528 529 579 580 635 661 662 686 687 707 780 813 814 826 827 828 881 890 891 899 900 901 902 
13 14 23 45 46 47 48 49 153 197 211 329 341 342 343 477 479 559 576 583 611 619 657 676 677 746 747 748 749 751 752 770 771 786 787 789 837 848 870 877 878 879 884 894 898 907 
0 1 2 4 5 137 178 288 290 302 326 327 328 330 332 333 335 337 338 339 340 353 372 373 374 375 376 377 404 467 468 499 505 520 596 597 625 760 809 855 871 
63 74 75 98 181 184 236 237 238 239 240 241 242 367 424 425 427 446 502 503 514 515 516 517 526 527 545 614 615 699 717 718 774 775 790 791 798 829 838 886 889 
59 107 122 151 152 154 155 156 157 210 268 281 282 362 363 365 366 368 369 370 371 420 421 422 453 454 455 462 488 581 582 750 762 763 764 781 845 846 851 852 
103 104 105 106 108 109 110 113 114 115 120 212 213 214 262 311 312 313 322 434 435 445 546 547 553 554 555 587 613 616 642 712 729 847 874 875 876 882 883 892 
42 43 71 72 73 96 97 99 127 128 172 173 174 175 176 177 360 413 414 415 464 465 556 557 558 570 571 572 573 574 575 578 586 638 639 694 710 739 
76 77 134 135 136 138 139 140 142 145 254 384 385 386 397 398 399 401 402 403 457 458 459 460 461 466 483 484 525 759 788 862 887 888 
78 79 143 144 267 269 270 283 284 304 305 306 307 308 309 310 344 345 346 347 480 489 490 500 667 713 731 799 800 801 839 867 893 908 
187 188 194 196 202 203 205 206 348 351 405 406 407 408 409 410 412 447 641 643 644 645 646 648 649 658 659 660 696 736 776 903 909 
62 66 90 121 232 314 315 389 390 400 426 473 474 475 577 584 585 588 598 599 600 601 609 610 612 697 698 794 802 803 820 821 
9 20 56 179 180 182 183 185 204 220 228 229 230 234 292 320 321 392 471 485 486 487 589 674 795 806 807 808 844 864 896 
55 57 58 87 186 189 190 191 193 195 198 199 200 201 393 532 533 534 535 536 650 651 652 653 727 728 
80 81 82 83 84 85 86 88 89 116 117 118 119 501 548 549 550 656 732 733 734 735 904 
111 146 147 148 150 218 219 221 222 223 224 225 226 227 278 279 280 411 449 672 673 843 
289 294 295 297 298 299 300 301 303 334 476 593 675 678 740 741 754 755 853 854 863 
158 159 161 162 163 164 165 166 359 394 395 396 544 765 773 
100 101 436 437 438 492 631 632 633 634 850 866 880 
355 428 429 430 431 507 508 509 510 511 512 513 865 
22 29 30 31 32 336 349 654 840 841 869 
243 245 439 440 441 442 443 617 834 885 
418 419 450 451 452 700 701 702 711 
521 522 523 524 703 704 705 796 797 
167 168 169 170 171 481 482 842 
24 25 26 27 28 391 
647 812 816 817 818 
276 277 668 669 
380 381 382 383 
636 637 688 
777 778 792 
