6 7 16 25 34 35 40 41 58 67 73 74 76 80 81 83 113 123 132 138 142 143 147 148 150 151 157 164 165 168 169 177 178 190 285 291 292 307 314 315 328 329 346 351 366 375 377 382 384 398 401 402 406 408 414 422 424 457 464 466 484 488 489 509 510 515 516 519 524 531 545 546 547 555 567 568 574 575 576 580 584 585 586 593 607 612 613 629 630 631 645 649 657 663 667 668 675 686 688 700 713 719 720 738 739 740 741 745 758 767 772 774 775 779 780 784 788 791 792 799 807 814 816 832 833 834 836 837 838 843 844 854 865 867 874 875 878 881 883 884 885 886 887 900 902 911 923 934 948 954 955 956 961 967 977 986 988 993 994 1012 1013 1024 1032 1041 1058 1059 1076 1077 1078 1080 1085 1088 1089 1091 1094 1098 1102 1109 1111 1113 1115 1118 1124 1125 1131 1133 1149 1150 1151 1152 1157 1162 1166 1171 1193 1197 1202 1220 1221 1229 1232 1237 1240 1244 1245 1252 1254 1257 1260 1261 1271 1273 1277 1283 1287 1294 1295 1299 1315 1327 1332 1333 1337 1338 1343 1344 1345 1350 1351 
4 5 10 17 26 30 31 33 44 45 47 56 57 69 70 71 72 91 92 97 98 99 100 120 125 126 129 130 131 133 135 152 158 159 160 161 162 163 172 173 180 213 214 236 237 238 239 243 244 248 254 268 271 275 279 288 294 295 301 302 336 352 358 359 378 389 390 394 397 409 410 417 418 425 428 429 430 434 446 453 454 455 456 461 462 471 474 496 497 498 501 523 527 528 534 538 539 552 556 577 581 595 598 605 606 610 618 648 653 665 670 672 687 693 707 708 718 742 746 747 748 752 757 763 773 785 790 794 801 802 815 818 820 840 841 850 851 861 863 891 892 897 910 927 932 933 941 943 944 945 951 969 976 979 985 991 992 996 1000 1008 1020 1021 1040 1064 1073 1093 1095 1096 1103 1136 1141 1173 1175 1177 1180 1181 1186 1194 1195 1205 1206 1207 1210 1214 1218 1219 1223 1233 1238 1239 1243 1289 1291 1300 1312 1328 1329 
0 1 12 13 22 23 32 36 37 42 43 48 53 54 55 59 63 64 65 66 75 79 86 87 88 93 94 95 96 108 111 112 149 155 174 189 195 200 204 205 208 212 218 219 220 234 235 242 245 250 255 256 257 259 269 272 277 278 296 303 304 305 306 308 309 321 322 327 339 340 341 349 353 355 360 361 374 379 381 388 403 415 416 421 433 443 467 468 473 475 490 502 503 504 508 526 563 573 578 579 588 594 599 608 619 625 626 627 656 681 724 728 736 751 770 786 798 803 812 866 873 890 899 926 936 952 953 980 997 1061 1070 1071 1106 1114 1137 1138 1146 1147 1159 1160 1167 1168 1187 1213 1234 1247 1248 1270 1306 1310 1325 
28 29 38 39 49 50 60 89 90 117 139 181 182 185 186 222 231 232 312 313 316 317 330 331 370 371 372 373 404 405 407 413 444 445 458 465 469 479 507 517 518 521 522 532 554 587 591 617 633 636 638 659 660 666 671 679 680 683 690 699 737 755 760 761 762 764 782 789 793 810 822 825 849 855 919 920 937 960 964 965 983 984 1005 1009 1010 1014 1016 1017 1018 1019 1034 1054 1055 1062 1066 1074 1092 1099 1104 1110 1128 1132 1140 1155 1161 1163 1164 1165 1176 1184 1185 1191 1199 1209 1216 1217 1222 1224 1225 1256 1278 1280 1282 1288 1293 1296 1297 1305 1311 1314 1331 1342 1348 1354 
11 27 46 68 82 107 118 119 121 122 134 140 141 166 167 179 193 194 207 253 284 289 290 323 324 376 391 392 395 400 423 426 427 447 448 451 452 470 485 494 499 500 511 520 570 572 589 590 615 628 637 639 652 655 658 669 704 711 712 714 726 744 778 795 797 800 804 821 835 842 845 856 889 925 931 946 947 957 972 1007 1026 1027 1030 1042 1044 1045 1049 1072 1079 1211 1231 1272 1322 1323 
8 9 20 101 102 114 124 146 187 188 202 203 211 216 217 221 229 230 246 247 252 262 263 276 319 320 332 333 334 343 344 345 354 357 365 399 431 435 440 441 476 481 491 492 505 550 551 558 560 561 592 622 632 635 698 733 735 753 754 756 766 783 813 823 852 860 862 870 909 935 975 981 987 995 1029 1036 1038 1067 1087 1121 1129 1281 
2 3 21 105 106 109 110 127 128 136 137 170 171 176 191 192 223 224 233 260 261 264 265 347 348 393 419 420 437 460 477 478 486 487 512 542 564 571 597 616 623 624 634 691 692 710 715 721 771 809 819 901 915 974 1068 1083 1107 1108 1112 1135 1139 1142 1143 1183 1208 1241 1275 1290 1302 1313 1339 1347 
18 19 24 84 85 153 154 225 226 240 241 273 274 299 300 368 369 385 386 387 412 506 535 536 537 553 559 566 600 601 677 678 684 685 702 729 749 750 765 776 777 781 787 817 827 828 871 872 903 929 942 998 1003 1037 1056 1057 1148 1154 1169 1172 1215 1258 1264 1265 1279 1298 1301 1307 1308 1319 1321 1346 
14 15 61 62 115 266 267 326 396 513 565 596 611 646 647 651 743 759 805 806 826 868 876 877 896 906 907 913 968 990 1001 1004 1011 1025 1050 1090 1100 1134 1153 1158 1203 1230 1236 1242 1246 1259 1263 1266 1276 1286 1303 1309 1318 1326 1330 1334 1335 1336 1340 1341 
77 78 116 144 145 175 201 209 210 280 281 282 364 411 480 493 569 614 620 621 661 662 716 717 730 731 808 831 846 847 864 879 880 888 898 914 949 950 962 963 970 989 1015 1046 1047 1051 1052 1063 1065 1075 1082 1097 1101 1105 1192 1212 1228 1235 1269 
206 215 249 310 311 325 342 362 363 380 438 439 459 482 483 514 562 641 642 643 644 654 732 734 811 829 830 848 857 882 924 928 966 1028 1084 1122 1144 1145 1182 1189 1198 1349 
258 286 287 293 318 338 350 356 367 383 436 543 544 548 549 557 582 583 604 609 682 689 696 858 869 893 894 895 908 916 940 978 1006 1039 1053 1123 1178 1200 1249 
103 104 156 196 197 251 432 472 540 541 673 674 676 701 703 705 706 722 723 727 904 905 921 922 938 982 1002 1031 1043 1060 1170 1188 1196 1226 1285 1324 
51 52 227 228 442 463 495 640 697 971 1022 1023 1048 1117 1253 1267 1268 
283 529 530 664 694 695 839 859 930 999 1035 1317 
768 769 917 918 939 1179 1190 1274 1284 1304 1316 
198 199 270 297 298 335 533 958 959 973 
449 450 1086 1116 1156 1227 1255 1320 
525 602 603 853 1033 1081 1262 1292 
650 725 796 824 912 1119 1120 1201 
183 184 337 709 1069 1130 1204 
1126 1127 1174 
