20 24 39 64 65 69 72 75 109 124 130 139 140 152 163 171 174 178 186 208 209 225 231 235 236 243 259 266 279 296 319 322 329 330 338 356 368 376 383 391 392 404 431 434 435 449 459 460 473 474 488 503 515 527 528 542 548 553 554 558 564 570 576 577 579 594 613 617 618 619 621 625 626 630 634 654 680 682 685 689 715 716 727 747 749 764 786 805 808 816 819 825 828 831 836 845 846 852 857 861 867 868 871 877 887 889 903 917 919 920 921 932 933 937 965 968 977 989 1001 1012 1015 1022 1028 1046 1047 1051 1052 1054 1055 1060 1073 1082 1088 1116 1132 1138 1145 1164 1169 1175 1177 1189 1190 1194 1195 1197 1204 1216 1221 1225 1245 1254 1272 
0 1 2 3 4 5 6 7 10 12 13 15 21 22 23 26 27 35 37 38 41 44 47 49 58 62 74 82 86 89 97 123 142 143 170 173 199 202 203 217 229 298 299 308 309 328 344 411 456 469 472 486 489 509 537 556 571 574 629 636 637 676 679 791 814 822 835 898 899 902 905 922 924 960 983 997 1017 1027 1029 1066 1094 1117 1131 1147 1200 1212 1229 1266 1273 
28 29 40 63 84 93 98 114 127 129 134 135 145 146 177 191 224 239 244 257 258 268 272 276 331 332 333 334 351 357 366 379 397 445 496 521 530 541 563 566 581 583 584 590 609 631 633 660 700 712 732 771 788 837 843 864 879 880 910 911 927 985 994 1050 1075 1101 1115 1161 1185 1187 1193 1198 1210 1240 1262 1278 
54 68 100 101 113 153 188 260 261 325 346 370 373 393 403 427 444 447 468 480 500 512 545 546 552 562 585 606 610 612 628 647 651 675 683 690 724 725 730 748 754 759 811 832 875 896 897 944 945 992 1002 1019 1039 1086 1110 1123 1137 1188 1211 1237 1246 1258 1259 1271 1276 1283 1286 
31 32 83 102 105 128 141 156 185 218 245 246 247 292 336 350 352 363 367 420 450 475 478 482 483 493 568 599 616 684 691 694 697 701 731 772 773 778 809 849 873 901 909 939 949 1004 1007 1009 1037 1087 1119 1124 1146 1166 1250 
42 81 214 215 252 291 297 306 307 310 335 361 364 371 372 377 405 453 481 523 524 593 611 627 661 693 722 751 756 765 767 782 800 869 888 891 892 942 943 956 957 963 1025 1081 1107 1144 1233 1235 1253 1284 
92 107 187 267 390 399 401 414 424 463 495 532 538 540 547 555 559 589 600 607 608 639 663 746 750 760 813 818 850 851 866 874 906 912 926 961 962 1030 1033 1065 1109 1113 1125 1150 1151 1158 1159 1171 1285 
14 25 36 59 85 95 121 136 161 166 175 207 216 242 316 317 324 387 396 425 426 441 442 464 494 516 587 596 614 646 657 664 665 723 740 741 785 862 916 954 1068 1099 1100 1153 1191 1192 1264 1265 
46 94 176 281 321 326 345 348 407 412 465 501 518 526 543 544 653 658 659 662 687 707 720 721 770 779 815 838 882 883 886 936 973 978 993 1005 1006 1077 1095 1103 1155 1156 1181 1183 1209 1241 1242 1249 
76 116 149 150 184 222 270 271 274 275 283 302 327 337 347 360 369 380 384 385 386 418 429 479 484 531 533 569 572 624 642 739 755 820 885 940 941 1035 1044 1049 1063 1064 1174 1196 1282 1288 
154 189 221 228 230 250 269 277 300 301 406 648 699 761 775 776 784 802 803 812 842 847 856 870 890 894 904 929 947 948 958 988 1011 1026 1041 1042 1058 1070 1092 1098 1111 1112 1140 1172 1173 1215 
48 115 126 158 159 198 248 305 349 358 359 436 446 458 560 578 643 644 666 667 698 710 718 738 742 745 766 780 817 964 974 975 1013 1021 1091 1114 1142 1160 1167 1182 1203 1224 1257 
43 282 312 410 417 462 497 514 529 535 592 623 632 649 650 787 799 839 865 878 893 907 908 923 935 946 1008 1031 1061 1067 1072 1085 1105 1143 1168 1186 
17 45 50 53 201 354 355 381 382 413 415 416 454 499 674 696 711 744 781 823 833 834 840 930 931 959 966 1000 1003 1018 1048 1127 1279 1280 
60 110 111 151 197 303 304 323 365 388 394 421 603 638 645 652 729 753 853 914 955 979 986 987 1078 1102 1121 1126 1157 1184 1205 1238 
56 138 144 190 193 204 251 262 280 286 375 402 419 565 635 672 673 702 708 752 804 1016 1023 1080 1093 1236 1251 1263 1268 
9 55 112 125 164 172 205 232 249 256 265 273 278 287 498 505 670 671 678 717 769 826 895 972 1256 
16 120 192 233 234 313 428 430 492 504 580 677 757 806 807 881 967 991 1032 1062 1128 1136 1199 1270 
90 91 182 237 263 264 293 362 389 433 487 539 595 726 821 841 1053 1108 1122 1129 1134 1135 1139 1226 
8 18 19 30 33 52 66 71 108 162 374 455 573 688 737 762 801 900 1056 1059 1141 1214 1267 
51 57 194 195 220 238 340 341 437 491 525 598 728 796 824 996 1076 1118 1178 1243 1274 
61 106 122 241 255 448 471 586 602 656 719 793 794 860 1071 1079 1097 1202 1227 1255 1269 
70 79 80 96 99 183 254 294 339 511 792 876 928 984 1010 1024 1084 1130 1148 
137 165 169 179 223 466 467 508 534 557 567 615 969 1069 1089 1170 1217 1218 1260 
11 133 157 226 604 605 640 641 655 938 1040 1083 1104 1201 1213 1239 1244 
87 180 200 315 398 440 476 520 522 549 706 709 976 995 1149 1163 1179 
67 168 408 409 470 502 536 713 714 733 734 774 855 1090 1277 1281 
181 461 736 763 777 795 854 915 925 934 951 952 1133 1180 1222 
73 77 78 88 104 117 119 131 148 160 295 507 768 990 
118 285 288 378 668 692 703 783 859 1045 1074 1247 1248 1275 
147 167 400 517 551 582 588 743 858 913 981 1014 1228 
314 438 506 510 601 669 686 735 863 982 1020 1208 1287 
34 103 219 620 622 810 918 970 971 1034 1043 1162 
155 212 213 342 343 395 439 591 829 1223 1231 1232 
210 211 318 443 451 457 477 490 575 980 1206 1207 
132 227 240 253 353 550 704 705 830 950 
206 452 758 827 953 1106 1154 1165 1234 1252 
196 311 485 561 872 1038 1057 1230 
320 797 798 848 884 1120 1152 1176 
289 290 432 513 519 695 1036 
284 789 790 844 1096 
