0 36 49 58 60 61 62 69 70 73 82 110 111 115 117 131 134 144 150 151 157 158 159 160 174 182 183 195 199 208 210 216 217 227 242 248 294 295 296 309 313 317 333 345 349 350 352 363 379 380 390 399 411 414 424 446 464 465 475 477 480 481 485 488 490 495 500 506 526 531 533 541 551 561 566 569 571 577 578 589 594 603 614 621 622 624 625 629 637 638 652 653 661 670 671 675 684 687 692 698 703 707 711 713 714 720 725 744 745 747 768 790 791 812 822 845 860 866 887 913 919 922 927 942 943 974 976 987 1001 1010 1022 1035 1043 1047 1066 1074 1077 1079 1096 1098 1100 1102 1109 1119 1129 1151 1155 1156 1164 1169 1186 1194 1196 1198 1225 1226 1241 1249 1275 1288 
1 2 13 17 34 35 38 39 41 42 53 54 63 71 72 92 97 102 112 124 127 129 130 139 140 163 165 173 181 194 211 218 219 221 230 232 236 253 254 269 273 292 303 307 314 315 332 334 344 346 357 373 377 378 393 403 408 420 428 435 436 443 445 448 466 467 487 492 496 502 528 534 550 552 553 555 556 557 568 590 607 608 619 632 641 659 662 666 667 683 701 722 723 727 748 756 760 805 829 831 862 863 864 891 892 920 944 945 949 956 964 973 977 985 1019 1032 1039 1065 1076 1131 1143 1150 1202 1203 1206 1207 1212 1238 1250 1274 1284 1285 1287 
16 20 27 48 78 91 95 99 105 106 122 125 154 161 170 175 192 198 220 226 234 246 252 255 257 265 300 305 324 348 353 354 355 387 388 407 415 416 418 426 437 452 461 499 504 511 515 558 560 581 586 655 658 660 681 710 729 741 750 753 770 778 781 789 810 826 830 846 849 876 904 905 916 928 930 931 940 950 967 984 990 1002 1008 1014 1025 1029 1037 1051 1052 1064 1084 1091 1092 1095 1115 1116 1133 1142 1153 1154 1178 1183 1205 1210 1218 1224 1231 1232 1264 1269 1273 1280 1281 
68 86 87 101 109 136 166 176 184 188 200 202 205 207 212 213 250 256 278 283 291 302 304 310 325 360 369 382 385 395 404 451 462 468 508 512 513 521 522 529 549 572 587 591 602 626 690 709 735 736 746 757 758 763 764 775 777 779 782 783 788 795 798 806 820 838 844 847 850 851 853 854 859 870 874 875 877 878 914 925 934 979 980 997 1000 1011 1028 1030 1033 1078 1082 1086 1088 1105 1110 1111 1112 1113 1125 1128 1179 1188 1223 1233 1237 1240 1286 
44 45 46 50 51 57 76 81 93 94 107 116 128 137 149 186 187 222 223 243 247 259 260 261 266 272 275 277 297 298 299 312 318 323 356 362 365 370 372 386 413 456 458 493 494 509 517 542 554 570 573 574 582 597 599 604 606 612 616 627 628 642 646 651 679 680 706 719 731 749 751 767 773 786 816 818 819 824 832 834 858 867 868 869 885 903 906 918 965 969 986 1012 1015 1036 1049 1056 1058 1081 1085 1089 1124 1127 1138 1163 1184 1189 
5 55 56 83 96 100 133 138 141 148 155 156 167 185 193 204 240 241 244 245 262 264 281 289 290 320 321 326 327 367 376 398 402 412 419 430 431 432 447 450 476 478 482 483 484 530 563 565 579 600 601 605 609 630 672 695 699 702 708 742 771 780 804 815 840 841 843 848 873 909 911 912 915 960 1007 1013 1023 1040 1044 1045 1053 1083 1134 1135 1139 1160 1166 1172 1173 1174 1175 1182 1195 1271 1278 1283 
4 8 28 29 40 90 98 104 145 201 225 233 235 239 263 276 279 282 331 371 381 396 410 433 439 440 454 457 471 527 535 539 545 546 583 585 592 623 643 644 647 691 733 734 743 772 787 793 794 839 880 897 902 923 935 989 991 995 996 1018 1048 1050 1061 1067 1072 1073 1101 1136 1144 1171 1180 1197 1199 1215 1221 1227 1228 1255 1258 1259 1276 
113 120 121 123 147 152 153 164 231 238 249 280 328 330 368 383 384 394 427 429 459 489 497 505 516 523 524 548 575 588 596 613 617 618 635 656 685 689 700 715 716 739 759 762 765 784 808 817 828 836 852 861 894 917 924 932 933 941 975 983 1005 1006 1021 1054 1055 1080 1094 1126 1145 1149 1162 1190 1192 1209 1235 1246 1268 
6 12 21 22 26 43 47 59 258 306 336 361 375 400 401 438 501 547 640 645 694 705 737 738 792 823 827 833 871 882 883 886 953 955 961 962 963 970 971 978 1017 1034 1041 1042 1106 1121 1147 1152 1177 1181 1200 1262 1266 1267 
77 79 88 118 146 228 229 251 288 322 342 347 392 397 406 434 460 473 503 514 537 538 564 584 611 615 639 663 693 728 761 797 814 947 948 957 1046 1062 1070 1075 1093 1137 1247 1248 1256 
80 84 85 103 177 179 180 196 206 224 237 274 293 311 329 339 340 341 364 366 389 425 520 544 567 620 774 785 809 865 872 884 901 954 972 1026 1103 1107 1108 1176 1216 1230 1245 1272 1277 
7 114 119 126 172 203 287 308 319 335 343 374 391 409 455 491 532 536 649 654 674 686 712 717 721 732 755 856 857 895 910 921 936 946 968 1024 1118 1130 1159 1185 1204 1242 1254 
10 89 284 285 301 351 441 442 498 543 610 633 636 648 668 676 677 678 752 769 799 879 992 1016 1027 1031 1068 1117 1161 1213 1239 1244 1251 
67 74 171 214 215 405 417 421 449 453 469 479 519 525 593 634 696 697 704 800 855 893 896 952 966 981 988 1038 1063 1071 1146 1201 
18 32 189 190 197 270 286 444 463 510 665 724 730 740 835 907 908 959 982 1087 1157 1165 1236 1252 1263 1279 1282 
9 11 14 15 19 23 25 30 33 37 52 162 178 209 580 598 801 900 951 1059 1099 1141 1187 1222 1229 1243 
64 65 66 75 108 267 268 338 540 562 650 754 802 803 811 813 890 937 993 1132 
135 470 559 595 688 825 881 926 938 1009 1090 1097 1148 1158 1234 
316 358 359 486 657 718 726 766 821 1122 1214 1217 1257 
31 776 807 898 899 1069 1140 1167 1170 1270 
24 271 576 673 939 1168 1253 1260 1265 
132 664 682 888 889 1114 1123 
474 669 842 929 958 1020 1208 
142 143 168 169 518 1261 
3 337 507 994 
191 472 1057 1193 
631 796 837 1211 
1003 1004 1191 
1060 1104 1120 
