69 75 100 109 113 124 139 163 174 178 186 208 209 235 236 243 259 266 279 319 322 329 330 356 368 376 383 392 403 404 431 449 460 488 503 515 527 542 548 553 554 558 560 570 577 579 594 613 617 625 626 629 630 634 680 682 683 690 715 728 747 749 764 786 791 816 835 836 845 846 852 857 861 867 868 871 875 887 889 903 919 920 921 932 937 965 968 977 989 1001 1012 1015 1028 1029 1047 1051 1052 1054 1055 1073 1082 1116 1132 1137 1138 1164 1169 1177 1189 1195 1216 1221 1225 1245 1246 1271 1272 
0 1 2 3 4 5 6 7 10 12 15 20 21 22 23 24 26 27 35 41 44 47 49 62 63 74 82 86 95 129 135 140 170 173 180 198 199 202 203 217 229 308 309 328 391 397 411 428 434 469 472 473 474 486 520 537 564 571 574 581 636 637 679 712 814 902 905 922 924 960 983 997 1017 1046 1066 1094 1099 1117 1131 1147 1163 1175 1179 1193 1200 1212 1266 1273 
48 73 77 78 88 104 117 119 126 131 148 158 159 160 248 295 305 337 349 436 446 458 459 507 578 643 644 666 667 698 710 738 742 745 766 768 780 817 819 964 974 975 990 994 1013 1021 1091 1114 1142 1160 1167 1182 1203 
68 76 150 175 184 185 222 260 270 271 274 283 302 327 346 347 360 369 380 384 385 386 418 429 479 480 484 533 569 572 624 709 739 820 885 940 941 1019 1035 1044 1063 1064 1123 1153 1174 1188 1196 1237 1282 1288 
14 36 58 59 123 136 161 166 207 216 242 316 317 324 344 358 359 387 425 441 442 456 464 489 494 516 587 596 646 664 665 718 723 740 741 785 822 862 916 954 1068 1100 1191 1192 1257 1264 1265 
34 39 65 72 103 130 152 171 219 225 231 296 416 435 618 619 620 621 622 654 685 689 716 727 781 808 810 828 831 855 877 897 917 918 933 970 971 1034 1043 1088 1145 1162 1190 1194 1197 1204 1254 
46 94 176 326 345 348 407 412 465 501 526 543 544 653 658 659 662 687 707 720 721 770 779 815 838 882 883 886 895 936 973 978 993 1005 1006 1077 1095 1103 1112 1155 1156 1181 1183 1209 1241 1242 1249 
8 11 18 19 30 33 37 52 66 71 108 133 157 162 226 338 374 455 573 604 605 640 641 655 688 737 762 801 900 938 1040 1056 1059 1083 1104 1141 1201 1213 1214 1229 1239 1244 1267 
54 101 153 261 325 370 373 393 427 444 445 447 500 545 546 552 562 585 606 610 612 628 647 724 725 730 748 754 759 811 832 896 944 945 992 1002 1039 1086 1211 1258 1259 1276 1283 
17 45 50 53 220 340 341 354 355 381 382 390 413 437 454 499 525 674 711 729 744 823 824 834 840 930 931 959 966 1000 1003 1018 1020 1048 1119 1127 1178 1208 1279 1280 
70 79 80 90 91 96 99 182 183 237 254 263 293 294 339 362 389 487 511 539 595 726 792 841 876 928 984 1010 1024 1053 1084 1108 1122 1130 1134 1135 1139 1148 1226 
43 264 282 312 410 417 433 450 497 514 529 535 592 623 632 649 650 787 799 839 865 878 893 907 908 923 935 946 1008 1031 1061 1067 1072 1085 1105 1143 1168 1186 
32 102 105 142 143 168 298 299 336 350 352 367 475 478 483 493 509 518 568 599 614 657 684 691 694 697 701 731 772 773 821 909 949 1037 1087 1129 1250 
13 38 89 97 122 255 291 297 306 307 321 361 377 468 556 586 722 756 765 800 872 888 891 892 898 899 956 957 1038 1071 1107 1110 1144 1235 1269 1284 
92 107 116 149 187 267 275 399 401 424 463 495 531 540 547 555 600 642 673 755 813 818 850 851 874 926 1030 1033 1049 1113 1125 1150 1171 1263 1285 
154 189 228 247 250 269 277 300 301 406 648 812 856 873 890 904 947 948 958 988 1026 1041 1042 1058 1070 1092 1098 1111 1140 1146 1172 1173 1215 
25 114 134 145 239 244 272 276 333 351 426 496 530 541 563 583 584 597 631 633 681 837 879 880 910 927 1115 1161 1185 1187 1278 
28 29 40 42 93 98 127 147 167 191 224 252 257 258 331 335 366 400 517 551 582 588 693 743 858 913 981 1014 1025 1228 1262 
56 84 85 138 144 146 177 193 204 251 262 280 375 402 419 565 609 635 672 702 708 752 771 804 911 1016 1023 1080 1093 1251 1268 
83 118 141 156 245 285 288 292 363 378 420 482 616 668 692 703 783 849 859 1004 1007 1009 1022 1045 1074 1166 1247 1248 1275 
60 110 111 151 197 303 304 323 394 421 603 638 645 652 753 853 914 955 979 987 1078 1102 1121 1126 1157 1184 1205 1238 
64 81 121 196 310 311 364 371 372 396 481 485 523 524 561 611 627 661 782 869 942 943 963 1057 1060 1230 1253 
9 55 112 125 132 164 205 227 232 240 249 253 256 265 273 278 287 353 505 678 704 705 717 769 826 830 
241 268 332 334 357 379 521 550 590 660 700 732 788 842 843 860 864 929 950 1050 1075 1101 1210 1240 
16 31 120 192 233 234 313 492 580 677 757 806 807 881 967 991 1032 1062 1128 1136 1199 1270 
128 214 215 218 230 246 281 405 414 453 559 593 607 608 746 809 901 912 939 1065 1124 1158 
67 155 408 409 470 502 528 536 576 713 714 733 734 774 805 825 829 1090 1277 1281 
137 165 169 179 223 466 467 508 534 557 567 615 969 1069 1089 1170 1217 1218 1260 
221 388 462 699 761 775 776 784 802 803 847 870 894 906 961 962 1011 1159 1224 
181 461 736 763 777 795 854 915 925 934 951 952 1133 1180 1222 
61 106 448 471 602 656 719 793 794 1079 1097 1202 1227 1255 
87 200 315 398 430 440 476 504 522 549 706 976 995 1149 
190 286 314 438 506 510 601 669 686 735 863 982 1236 1287 
51 57 194 195 238 491 598 796 996 1076 1118 1243 1274 
210 211 318 443 451 457 477 490 575 980 1206 1207 
115 188 512 566 651 675 676 985 1027 1198 1286 
206 415 452 758 827 953 1106 1154 1165 1234 1252 
212 213 342 343 395 439 591 1223 1231 1232 
365 589 750 751 767 778 986 1081 1233 
320 797 798 848 884 1120 1152 1176 
532 538 639 663 760 866 1109 1151 
289 290 432 513 519 695 1036 
172 498 670 671 972 1256 
284 789 790 844 1096 
201 696 833 
