0 60 61 69 70 73 117 131 144 150 151 157 158 159 160 174 182 195 248 295 345 349 350 352 363 380 411 446 464 475 481 485 500 531 541 551 561 577 578 594 603 621 624 637 638 653 661 684 687 692 707 711 712 725 744 747 768 845 860 913 919 922 927 974 987 1001 1022 1047 1066 1074 1077 1079 1186 1194 1225 1226 1241 1275 
13 34 35 38 39 41 53 54 71 97 102 112 122 124 130 163 165 181 211 219 221 254 273 292 307 332 334 344 373 393 408 420 435 445 492 502 553 555 556 557 568 632 701 727 748 756 805 829 831 891 892 949 977 1032 1039 1131 1143 1250 1284 
44 45 46 50 51 57 76 81 93 94 116 128 149 261 272 275 297 298 299 362 413 493 494 509 517 554 574 582 599 614 642 646 719 749 773 796 816 832 868 869 903 906 950 965 1056 1058 1124 1127 1138 1184 1189 
183 216 217 227 242 294 313 379 399 424 465 480 495 526 533 622 625 652 670 671 709 713 714 745 790 812 822 866 887 1010 1043 1096 1100 1102 1164 1196 1198 1249 
55 56 83 138 141 148 155 156 167 204 244 245 281 326 367 412 450 482 483 579 609 699 702 742 771 804 840 841 909 1023 1160 1166 1178 1278 
77 79 118 129 146 228 229 251 255 288 347 392 397 406 428 434 514 564 611 615 728 957 1070 1075 1093 1137 1247 1248 1256 1269 
42 92 140 173 303 314 315 378 436 448 496 550 590 641 662 720 862 863 864 1076 1202 1203 1238 1274 1285 1287 
238 280 383 394 427 429 497 635 715 716 739 759 762 817 852 861 924 941 1021 1080 1126 1145 1268 
170 265 300 388 407 416 452 710 753 770 781 789 826 876 928 984 1091 1092 1224 1273 
9 11 14 15 23 25 30 33 37 52 162 801 900 951 985 1059 1141 1222 1229 
10 89 284 285 351 441 442 498 633 648 668 677 678 769 879 1068 1117 1161 
107 259 260 277 312 323 386 456 542 573 627 628 651 706 751 867 986 1085 
86 109 200 325 330 368 404 524 596 617 626 685 700 758 1111 1112 1230 
40 282 371 396 471 592 623 691 787 839 923 935 1072 1073 1227 1255 
113 249 287 505 548 575 588 765 784 894 895 933 1098 1149 1235 1246 
96 100 262 398 402 419 530 563 565 842 843 873 911 958 1271 
105 106 252 305 324 437 461 515 741 916 1008 1029 1051 1052 1133 
176 212 213 310 395 521 591 602 779 782 783 838 1082 1223 1233 
62 82 134 210 333 375 488 503 569 629 693 791 1119 1288 
184 185 283 302 360 369 385 478 572 630 820 1035 1040 1083 
258 335 336 532 694 721 737 738 953 970 971 1034 1242 1262 
90 263 264 410 433 440 535 643 644 757 806 1067 1128 
189 190 286 463 510 724 730 908 959 982 1236 1263 1279 
103 224 389 774 809 884 901 1026 1107 1108 1176 1277 
462 736 763 775 777 788 847 870 925 934 1011 1240 
7 126 205 256 278 391 717 798 1024 1159 1162 
36 111 296 506 698 703 942 943 976 1129 1169 
175 257 348 415 418 658 660 750 1153 1154 1183 
16 192 198 504 511 581 967 1116 1231 1232 
108 267 268 540 802 803 813 993 1130 1132 
114 203 308 343 686 732 856 857 921 1185 
115 545 552 566 647 656 675 676 1027 1171 
403 683 850 851 874 875 1030 1033 1113 1125 
543 636 752 799 992 1016 1213 1239 1244 1251 
1 2 58 346 443 487 528 723 1019 
6 47 696 697 833 1041 1042 1147 1266 
98 225 239 276 331 583 880 897 1197 
99 220 226 499 655 810 1014 1084 1280 
152 153 231 489 808 828 836 932 1190 
214 215 421 453 469 479 593 855 981 
384 459 516 613 917 975 1055 1094 1192 
119 374 409 455 491 536 936 1118 
439 527 546 793 794 1258 1259 1276 
5 20 571 600 601 645 695 
59 501 815 871 886 1152 1177 
68 136 512 529 587 1188 1237 
120 121 123 164 523 618 1054 
188 690 844 877 878 1105 1286 
206 274 340 341 544 872 1103 
241 327 484 1172 1173 1174 1175 
304 853 854 914 1028 1078 1088 
329 467 534 567 1216 1245 1272 
353 558 767 778 849 1081 1142 
27 246 990 1025 1095 1205 
72 232 377 956 1065 1150 
101 202 250 513 997 1086 
142 143 168 169 518 1261 
171 417 519 634 893 1063 
179 237 293 364 520 865 
186 187 243 266 356 824 
316 359 657 718 766 1214 
320 321 447 1013 1053 1283 
458 606 679 680 918 1015 
470 595 1007 1009 1158 1234 
4 104 201 381 1018 
12 882 883 978 1200 
21 22 26 43 1017 
28 233 454 1136 1144 
29 743 1050 1101 1228 
31 807 1140 1170 1270 
48 49 95 560 1179 
132 682 888 889 1123 
137 318 490 1036 1089 
154 387 426 1210 1264 
196 311 366 425 954 
235 279 585 586 1002 
328 414 722 814 983 
365 370 570 834 1012 
457 795 991 1180 1199 
474 669 929 1020 1208 
537 538 584 639 797 
733 734 1215 1218 1281 
776 898 899 1069 1167 
800 952 988 1071 1146 
3 337 507 994 
8 772 995 1221 
18 444 1087 1157 
32 197 1165 1252 
64 65 75 338 
66 562 811 937 
67 704 896 966 
74 525 1038 1201 
80 180 339 620 
84 85 177 972 
87 166 207 522 
127 619 659 973 
133 240 605 708 
139 218 230 466 
145 539 902 1048 
191 472 1057 1193 
253 269 666 667 
289 290 432 1044 
357 607 608 760 
376 430 431 1195 
382 549 764 1000 
400 547 792 1181 
576 673 1260 1265 
604 612 616 1049 
654 674 1204 1254 
17 63 1212 
19 598 1243 
78 161 830 
91 940 1064 
110 1109 1151 
125 147 1209 
135 688 938 
172 755 835 
222 223 885 
234 681 1115 
236 920 964 
291 468 1110 
301 610 1031 
306 361 823 
322 473 761 
355 390 729 
358 785 1257 
486 821 1122 
631 837 1211 
640 955 1121 
649 910 968 
650 754 890 
665 740 907 
689 1005 1006 
818 819 969 
825 1090 1097 
846 930 931 
848 915 1045 
859 979 980 
939 1168 1253 
961 962 963 
989 1061 1182 
1003 1004 1191 
1060 1104 1120 
1134 1135 1139 
