3 5 6 20 27 35 41 47 49 62 63 69 82 86 95 109 124 129 135 139 140 163 170 173 174 178 180 186 198 199 202 203 217 220 229 243 255 266 308 319 329 330 356 365 391 392 397 404 411 428 434 460 472 473 474 486 503 520 527 537 542 548 554 558 560 564 571 574 575 577 617 625 626 630 637 728 764 786 814 836 845 852 857 871 887 889 902 903 905 919 921 924 932 937 957 960 983 989 997 1012 1015 1046 1047 1051 1052 1055 1066 1073 1080 1082 1094 1099 1116 1117 1131 1132 1147 1163 1164 1169 1175 1177 1179 1212 1216 1221 1225 1245 1266 1269 1272 1273 
34 39 61 65 72 75 103 115 130 152 168 171 188 219 225 231 235 236 259 279 296 322 368 383 435 448 464 471 488 512 515 566 570 581 602 618 619 620 621 622 651 654 656 675 676 685 689 712 715 716 727 793 794 808 810 828 831 855 861 862 867 877 917 918 920 922 933 970 971 1027 1034 1043 1079 1088 1097 1138 1145 1162 1190 1194 1197 1198 1200 1202 1204 1227 1254 1255 1286 
31 48 73 77 78 88 104 117 119 120 126 131 148 158 159 160 192 233 234 248 295 305 313 349 436 446 458 492 507 578 580 643 644 666 667 677 698 710 738 742 745 757 766 768 780 806 807 817 881 964 967 974 990 991 1013 1021 1032 1062 1091 1114 1128 1136 1142 1160 1167 1182 1199 1203 1270 
54 68 100 101 106 113 153 260 261 320 325 346 370 373 393 403 427 444 445 447 480 500 545 546 552 562 585 606 610 612 628 647 683 690 719 724 725 730 748 754 759 797 811 832 875 896 897 944 945 992 1002 1019 1039 1086 1123 1137 1188 1211 1237 1246 1258 1259 1271 1276 1283 
0 1 2 4 7 10 12 14 21 22 23 26 36 37 58 59 74 147 161 166 207 216 242 316 317 324 328 358 359 425 441 442 469 494 516 596 614 636 646 657 664 665 718 723 740 741 785 821 916 954 981 1017 1068 1100 1129 1191 1192 1229 1257 1265 
46 94 176 326 340 341 345 348 407 412 437 465 468 501 525 526 543 544 653 658 659 662 687 707 720 721 770 779 815 824 838 882 883 886 895 936 973 978 993 1005 1006 1077 1095 1103 1110 1112 1155 1156 1178 1181 1183 1209 1241 1242 1249 
56 84 138 144 146 156 177 193 204 244 245 247 251 262 280 375 387 402 419 530 541 563 565 609 635 672 702 708 752 771 804 837 873 911 927 985 994 1016 1023 1093 1146 1166 1210 1251 1264 1268 1278 
81 116 121 149 275 364 372 396 459 489 523 524 531 550 553 613 627 642 661 680 682 747 749 755 816 819 822 846 868 869 906 942 943 950 961 962 965 968 975 977 1001 1028 1049 1159 1189 1253 1263 
25 28 40 114 127 134 145 239 241 268 272 276 332 333 334 357 366 379 426 496 521 583 584 590 597 631 660 679 681 700 732 788 842 843 860 864 880 910 929 1050 1075 1101 1115 1185 1187 1240 
8 18 30 33 52 71 154 162 228 250 269 277 300 374 406 455 648 688 762 801 812 856 890 900 904 947 948 958 1026 1041 1042 1056 1059 1070 1092 1098 1111 1140 1141 1172 1173 1215 
11 90 91 133 157 182 226 237 263 293 362 389 398 433 440 487 539 595 604 605 640 641 655 726 841 938 995 1040 1053 1083 1104 1108 1134 1135 1139 1201 1213 1226 1239 1244 
43 264 282 312 410 417 450 462 497 514 529 535 592 623 632 649 650 787 799 839 847 865 870 878 893 907 908 923 935 946 1008 1031 1061 1067 1072 1085 1105 1143 1168 1186 
76 150 175 184 185 222 270 271 274 283 302 327 337 347 360 369 380 384 385 386 418 429 479 484 569 572 624 739 820 885 940 1035 1044 1063 1064 1153 1174 1196 1282 1288 
9 55 85 112 125 132 164 172 205 227 232 240 249 253 256 265 273 278 287 353 498 505 670 671 678 704 705 717 769 798 826 830 848 884 972 1120 1152 1176 1256 
13 38 89 97 122 291 297 306 307 310 351 361 371 377 481 556 586 611 633 722 756 765 782 800 879 888 891 892 898 899 956 963 1071 1107 1144 1161 1235 1284 
24 42 167 208 209 252 309 335 376 400 431 449 517 551 579 582 588 594 629 634 693 743 791 835 858 913 1014 1025 1029 1054 1195 1228 
32 102 105 142 143 298 299 336 350 352 367 475 478 483 493 509 518 568 599 684 691 694 697 701 731 772 773 909 949 1037 1087 1250 
92 107 187 267 399 401 424 463 495 540 547 555 600 673 813 818 850 851 874 926 1030 1033 1113 1125 1150 1171 1285 
17 45 50 354 355 382 390 416 454 499 674 729 744 781 823 834 840 930 931 966 1000 1003 1020 1127 1208 1280 
83 118 141 285 288 292 363 378 420 482 616 668 692 703 783 849 859 1004 1007 1009 1022 1045 1074 1247 1248 1275 
155 206 415 452 502 528 576 713 714 733 734 758 805 825 827 829 953 1090 1106 1154 1165 1234 1252 1281 
60 151 197 304 323 394 421 603 638 645 652 753 853 914 955 979 987 1078 1121 1126 1157 1184 1205 
70 79 80 96 99 183 254 294 339 511 792 802 803 876 928 984 1010 1024 1084 1122 1130 1148 
128 214 215 218 230 246 281 405 414 453 559 593 809 901 912 939 1065 1124 1158 
137 165 169 179 223 466 467 508 534 557 567 615 969 1069 1089 1170 1217 1218 1260 
181 461 736 763 777 795 854 915 925 934 951 952 1133 1180 1222 
189 221 301 388 699 761 775 776 784 894 988 1011 1058 1224 
190 286 314 438 506 510 601 669 686 735 863 982 1236 1287 
16 53 381 413 533 709 711 941 959 1018 1048 1119 1279 
19 64 66 108 123 338 344 456 573 737 1060 1214 1267 
51 57 194 195 238 491 598 796 996 1076 1118 1243 1274 
67 136 201 408 409 470 536 587 696 774 833 1277 
87 200 315 430 476 504 522 549 706 976 1149 
191 196 311 321 485 561 872 1038 1057 1193 1230 
210 211 318 443 451 457 477 490 980 1206 1207 
15 29 44 93 98 224 257 258 331 1262 
110 111 303 538 639 663 1102 1109 1151 1238 
212 213 342 343 395 439 591 1223 1231 1232 
589 750 751 767 778 986 1081 1233 
289 290 432 513 519 695 1036 
532 607 608 746 760 866 
284 789 790 844 1096 
