44 45 46 50 51 57 76 81 93 94 107 116 128 149 222 223 259 260 261 272 275 297 298 299 312 323 362 365 370 386 413 458 493 494 509 517 542 554 570 574 582 597 599 604 606 612 616 642 646 679 680 706 719 749 773 816 832 834 867 868 869 885 903 906 918 965 986 1012 1015 1049 1056 1058 1085 1124 1127 1138 1184 1189 
0 60 61 69 70 73 131 144 150 151 157 158 159 160 174 183 195 217 248 295 345 349 350 352 380 446 464 475 481 485 500 531 541 551 566 577 578 594 603 621 622 624 637 638 661 687 692 698 707 711 713 714 725 747 791 845 913 919 922 927 974 987 1001 1043 1047 1066 1074 1079 1186 1194 1225 1241 1275 
42 72 92 129 173 314 315 344 377 378 428 435 436 448 496 550 552 555 590 641 662 862 863 864 956 1039 1065 1076 1202 1203 1274 1285 1287 
16 78 125 161 170 265 300 353 388 407 416 452 504 511 558 560 753 770 778 781 826 830 849 876 928 984 1037 1092 1142 1231 1232 1273 
113 152 153 231 328 368 383 489 524 596 617 656 689 700 715 716 739 759 762 808 828 836 852 932 941 983 1005 1006 1126 1190 1246 
1 2 53 124 127 139 140 163 218 230 236 303 346 443 466 467 487 528 534 619 659 723 727 805 829 920 964 973 1019 1238 
34 35 38 39 41 71 97 102 112 165 211 219 221 273 292 332 334 393 556 568 632 722 748 831 949 1131 1143 1250 
55 56 138 141 155 156 167 204 244 245 326 327 412 482 565 579 699 702 804 840 841 1007 1023 1166 1278 
49 58 62 82 134 199 208 210 294 309 317 333 411 477 488 490 533 569 571 589 629 1119 1288 
105 106 122 252 255 305 324 354 426 461 515 586 729 741 916 1002 1008 1029 1051 1052 1133 1269 
9 11 14 15 23 25 30 33 37 52 162 209 801 900 951 1059 1099 1141 1187 1222 1229 
77 79 118 146 228 229 251 288 347 514 537 615 728 797 814 957 1093 1247 1248 1256 
216 242 313 379 390 399 480 526 614 652 670 671 745 822 942 943 1100 1129 1164 1196 
29 282 371 396 410 471 535 592 623 691 787 839 923 935 1067 1072 1073 1227 1255 
13 181 254 307 373 403 408 420 492 502 683 701 756 891 892 985 1032 1284 
18 189 190 444 463 665 724 730 740 907 908 959 1087 1157 1236 1279 
184 283 302 360 369 385 508 572 735 736 763 777 795 820 925 934 
117 182 363 414 561 653 684 720 744 768 860 1022 1035 1077 1226 
96 100 262 398 402 419 530 563 609 771 843 873 911 1271 
176 310 521 782 783 850 874 875 1030 1033 1082 1113 1125 1233 
238 280 394 427 429 497 635 817 861 924 1021 1080 1145 1268 
20 175 257 348 415 418 658 660 750 1153 1154 1183 
99 220 226 355 437 499 655 810 1014 1084 1178 1280 
304 382 462 549 764 775 788 847 870 1000 1011 1240 
36 111 296 506 703 790 976 1096 1102 1169 1198 
227 424 465 495 625 812 866 887 1010 1098 1249 
249 505 548 575 588 765 784 894 933 1149 1235 
101 202 205 250 256 278 513 798 997 1086 
258 336 694 737 738 953 970 971 1034 1262 
10 285 351 498 633 668 879 1117 1161 
89 284 441 442 648 677 678 769 1068 
103 224 389 809 884 901 1026 1108 1176 
108 267 268 540 802 803 813 993 1132 
186 187 243 266 356 818 819 824 969 
206 274 340 341 544 785 872 1103 1230 
214 215 421 453 469 479 593 855 981 
392 397 406 434 564 611 1070 1075 1137 
543 636 676 752 799 992 1016 1027 1251 
98 225 239 331 583 880 897 1197 
212 213 395 591 602 779 838 1223 
264 320 321 447 1013 1053 1182 1283 
316 358 359 657 718 766 1214 1257 
319 343 391 455 856 857 921 946 
384 459 516 613 917 975 1162 1192 
6 47 375 1041 1042 1147 1266 
84 177 196 311 366 425 954 
109 136 325 404 587 626 758 
119 374 409 491 536 936 1118 
120 121 123 164 523 618 1054 
171 417 519 634 893 1038 1063 
188 690 844 877 878 1105 1286 
576 673 939 1168 1253 1260 1265 
4 104 201 381 454 1018 
7 126 717 1024 1130 1159 
27 246 990 1025 1095 1205 
59 501 871 886 1152 1177 
83 281 483 742 815 1160 
86 87 166 200 207 522 
90 263 433 440 643 644 
142 143 168 169 518 1261 
179 237 293 364 520 865 
241 484 1172 1173 1174 1175 
400 547 640 792 955 1181 
439 527 546 1258 1259 1276 
8 772 995 996 1221 
12 882 883 978 1200 
21 22 26 43 1017 
31 807 1140 1170 1270 
64 65 66 75 338 
68 512 529 1188 1237 
74 525 696 697 1201 
114 203 308 686 1185 
132 682 888 889 1123 
185 478 630 1040 1083 
192 581 681 967 1115 
322 473 503 693 761 
329 567 1216 1245 1272 
470 595 1009 1158 1234 
538 584 639 663 1046 
627 628 751 767 1081 
800 952 988 1071 1146 
3 337 507 994 
32 197 1165 1252 
54 130 445 557 
67 704 896 966 
80 180 339 620 
133 240 605 708 
137 318 1036 1089 
145 539 902 1048 
148 367 450 909 
154 387 1210 1264 
191 472 1057 1193 
253 269 666 667 
277 456 573 651 
289 290 432 1044 
306 361 823 833 
335 532 721 1242 
357 607 608 760 
376 430 431 1195 
457 991 1180 1199 
631 796 837 1211 
654 674 1204 1254 
710 1218 1224 1281 
743 1050 1101 1228 
853 854 1078 1088 
17 63 1212 
19 598 1243 
28 40 276 
91 940 1064 
110 1109 1151 
135 688 938 
194 553 977 
233 1136 1144 
235 279 585 
291 468 1110 
301 610 1031 
486 821 1122 
510 835 982 
545 647 1171 
562 811 937 
649 910 968 
650 754 890 
669 1020 1208 
709 851 1179 
733 734 1215 
757 806 1128 
774 1107 1277 
825 1090 1097 
846 930 931 
848 915 1045 
859 979 980 
898 1069 1167 
961 962 963 
1003 1004 1191 
1060 1104 1120 
1134 1135 1139 
1213 1239 1244 
