0 36 60 61 64 65 66 69 70 73 75 82 110 111 115 117 131 134 144 150 151 157 158 159 160 174 183 195 210 216 217 227 242 248 294 295 296 313 317 333 338 345 346 349 350 352 363 379 380 390 399 409 411 421 424 443 446 464 465 475 480 481 485 488 495 500 506 526 531 533 536 545 551 561 569 577 578 589 594 603 614 621 622 624 625 629 637 638 647 652 653 656 661 671 684 687 692 693 698 703 707 711 713 714 724 725 731 744 745 747 791 792 807 812 822 845 860 866 869 887 913 922 942 943 967 974 976 1001 1010 1019 1022 1043 1045 1047 1066 1074 1077 1079 1098 1102 1129 1138 1164 1169 1186 1196 1210 1225 1241 1249 1270 1275 1288 
1 2 6 34 35 38 39 41 42 53 54 71 92 97 102 112 124 127 130 139 140 163 165 173 181 194 211 214 215 218 219 221 230 232 252 253 254 269 273 292 307 314 315 332 334 343 344 357 373 377 378 393 408 420 435 436 448 453 492 496 502 528 550 552 553 555 556 557 568 590 593 607 608 619 632 641 659 662 666 667 699 701 712 723 728 732 748 756 757 760 777 805 806 831 856 857 862 863 864 891 892 921 944 945 948 949 952 956 957 973 977 996 1032 1039 1065 1076 1128 1131 1143 1150 1170 1202 1203 1238 1250 1266 1274 1284 1285 1287 
5 7 20 22 55 56 83 96 100 114 128 133 138 141 145 148 156 167 185 188 193 203 204 240 241 244 245 262 281 287 308 320 321 326 327 367 375 376 398 402 412 419 430 431 447 450 476 478 482 483 484 503 530 541 563 565 566 571 579 600 601 605 609 630 631 672 673 675 686 690 702 708 742 771 780 804 837 843 873 877 878 902 903 909 911 912 927 960 983 985 1013 1023 1024 1040 1048 1083 1124 1130 1160 1166 1172 1173 1174 1175 1182 1185 1195 1198 1211 1271 1278 1283 1286 
44 45 46 50 51 57 72 76 81 93 94 107 116 137 142 143 149 168 169 186 187 243 247 259 260 261 266 272 275 297 298 299 312 318 323 356 362 365 370 372 386 413 427 456 458 466 493 494 509 517 518 542 554 570 573 574 582 599 604 606 612 616 627 628 642 646 651 679 680 706 709 719 749 768 773 786 796 811 818 819 832 834 851 858 906 918 919 965 969 975 986 987 1007 1015 1036 1049 1056 1058 1089 1119 1127 1163 1179 1184 1189 1214 1261 
58 86 109 113 120 121 123 152 153 164 200 231 236 238 280 330 368 383 384 394 404 429 459 489 497 516 522 524 596 613 617 618 626 635 685 689 700 715 716 727 739 759 762 808 816 817 828 836 848 852 861 867 868 871 917 920 924 932 933 941 1005 1006 1021 1054 1055 1080 1094 1126 1145 1149 1152 1177 1190 1192 1230 1246 1268 
78 161 170 175 198 222 257 265 300 348 353 388 407 415 416 418 445 452 511 558 581 658 660 710 750 751 753 767 770 778 781 789 790 830 844 849 876 885 904 905 928 984 1081 1091 1092 1096 1105 1116 1142 1153 1183 1224 1231 1232 1273 
17 48 49 62 63 77 79 88 95 118 129 146 191 228 229 251 288 322 342 347 392 397 406 434 472 473 514 537 538 560 564 584 611 615 639 645 722 761 774 797 814 1057 1070 1075 1093 1107 1121 1137 1193 1212 1247 1248 1277 
91 105 106 122 154 166 207 234 237 255 305 324 354 387 389 426 461 515 576 586 597 649 681 729 741 910 916 939 940 950 968 1002 1008 1037 1051 1052 1064 1108 1115 1133 1168 1253 1260 1264 1265 1269 
258 270 306 336 361 400 401 414 438 532 547 640 654 663 674 694 705 720 721 737 738 823 827 953 955 970 971 1034 1046 1106 1109 1151 1154 1165 1181 1204 1242 1252 1254 1262 1267 1282 
8 28 29 40 74 171 282 371 396 410 417 471 525 535 592 623 691 697 743 772 787 839 893 923 935 989 995 1038 1050 1061 1063 1067 1072 1073 1101 1201 1221 1227 1228 1255 
136 176 212 213 303 304 310 382 395 403 462 521 549 587 591 602 683 764 779 782 783 788 838 850 859 874 875 979 980 1000 1033 1082 1113 1125 1223 1233 1240 
3 12 21 26 43 47 59 184 283 302 337 360 369 385 469 479 501 507 572 815 820 833 882 883 886 978 981 994 1017 1035 1041 1042 1147 1155 1156 1200 
108 132 267 268 329 540 562 567 664 682 775 802 803 813 847 870 888 889 937 993 1011 1012 1114 1123 1132 1216 1245 1272 
13 18 32 189 190 196 197 286 444 463 510 665 730 740 776 835 898 899 907 908 959 982 1087 1157 1236 1263 1279 
10 89 284 285 351 441 442 610 633 648 650 668 677 678 754 769 879 890 961 962 963 1031 1068 1117 1161 
9 11 14 15 19 23 25 30 33 37 52 162 178 580 598 801 826 900 951 1059 1141 1222 1229 1243 
90 155 182 263 264 433 440 467 486 487 539 643 644 821 840 841 964 1053 1122 1134 1135 1139 1194 1226 
80 179 180 206 274 293 339 340 341 364 520 544 620 785 824 865 872 947 1103 
125 126 223 256 523 534 717 733 734 784 798 894 895 1159 1162 1209 1215 1218 1281 
98 192 225 239 276 331 457 490 583 795 880 897 991 1100 1180 1187 1197 1199 
291 325 439 468 527 546 758 793 794 829 1110 1111 1112 1258 1259 1276 
4 31 104 201 233 235 279 381 454 585 696 1018 1136 1140 1144 
84 85 103 177 224 311 366 425 809 855 884 901 954 1026 1176 
172 208 209 309 498 670 755 810 846 930 931 972 1029 1099 1256 
68 101 202 205 250 277 278 512 529 997 1085 1086 1188 1237 
87 316 358 359 428 504 657 718 726 766 1069 1167 1217 1257 
328 543 636 676 752 799 992 1016 1027 1213 1239 1244 1251 
99 147 220 226 355 437 499 655 1014 1084 1178 1280 
67 301 405 449 704 800 896 966 988 1071 1146 
199 249 460 477 505 548 575 588 765 1062 1235 
16 24 27 246 271 335 990 1025 1095 1205 
119 319 374 391 455 491 936 946 1118 
470 559 595 881 926 1009 1148 1158 1234 
289 290 432 513 519 634 695 1044 
451 746 853 854 914 1028 1078 1088 
474 669 842 929 958 1020 1208 
508 735 736 763 915 925 934 
135 688 825 938 1090 1097 
1003 1004 1191 
1060 1104 1120 
