69 75 109 115 124 139 163 174 178 186 188 208 209 235 236 243 259 266 279 309 319 322 329 330 356 368 383 392 404 449 460 464 471 488 503 512 515 527 542 548 554 558 566 570 577 613 617 625 626 630 634 651 656 675 676 680 682 689 715 747 749 764 786 793 794 816 836 845 846 852 857 861 862 867 868 869 871 887 889 903 919 920 921 932 937 965 968 977 985 989 1001 1012 1015 1027 1028 1047 1051 1052 1055 1073 1080 1082 1116 1132 1163 1164 1169 1177 1189 1198 1221 1225 1227 1245 1255 1272 1286 
0 1 2 3 4 5 6 7 10 12 15 20 21 22 23 26 37 41 44 47 49 61 62 63 74 95 135 140 147 169 199 303 328 411 448 469 473 474 486 520 557 571 574 581 602 636 679 712 814 838 902 905 922 960 981 983 1017 1046 1069 1079 1094 1097 1099 1117 1131 1147 1175 1179 1202 1217 1229 1238 1266 
34 39 65 72 103 130 152 159 168 171 180 219 225 231 296 305 325 416 435 585 586 618 619 620 621 622 654 685 698 716 727 738 742 766 781 808 810 828 831 855 877 897 917 918 933 964 970 971 1002 1034 1043 1088 1145 1160 1162 1190 1194 1197 1200 1204 1254 1258 1259 1276 
31 48 73 77 78 88 104 117 119 120 126 131 148 158 160 192 233 234 248 295 313 349 436 446 458 492 507 578 580 643 644 666 667 677 710 745 757 768 780 806 807 817 881 931 967 974 990 991 994 1013 1032 1062 1091 1114 1128 1136 1142 1167 1182 1199 1203 1270 
11 90 91 133 157 182 226 237 263 264 293 362 389 398 410 417 433 440 450 462 497 514 519 535 539 595 604 605 640 641 649 650 655 662 726 792 799 847 865 870 938 995 1031 1040 1063 1067 1072 1083 1104 1108 1181 1201 1213 1226 1239 1244 
68 76 100 113 150 175 184 222 260 270 271 283 302 327 337 347 360 369 384 385 386 403 418 429 480 484 569 572 624 683 690 739 820 875 885 940 1019 1035 1044 1064 1123 1137 1153 1174 1188 1196 1237 1246 1271 1282 1288 
14 36 58 59 161 166 207 216 242 294 316 317 324 358 359 387 425 441 442 494 516 596 614 646 657 664 665 718 723 740 741 785 821 916 954 1029 1068 1100 1129 1191 1192 1210 1257 1264 1265 
28 40 84 85 93 98 114 127 134 145 177 224 239 244 257 258 272 276 331 333 351 366 496 530 541 563 583 584 597 631 633 681 837 879 880 910 911 927 972 1026 1115 1161 1185 1262 1278 
46 94 176 321 326 340 341 345 348 407 437 465 525 526 543 544 653 658 659 687 707 720 770 779 824 882 883 895 936 973 978 993 1005 1006 1077 1095 1103 1155 1156 1183 1209 1241 1249 
54 101 106 153 261 320 370 373 393 427 444 445 447 500 537 545 546 552 562 606 610 612 647 719 724 725 730 748 754 759 797 811 832 896 944 945 966 992 1039 1086 1211 1283 
55 112 125 132 164 172 198 205 206 227 232 240 249 253 256 265 273 274 278 287 353 452 498 505 560 575 670 671 678 704 705 717 769 798 830 848 884 1120 1152 1176 1234 
24 27 35 38 82 86 89 97 129 170 173 191 201 202 203 217 220 229 255 308 365 428 472 556 637 696 728 833 872 924 957 997 1038 1066 1193 1212 1269 1273 
25 268 332 334 357 379 426 489 521 550 590 660 700 732 736 763 777 788 795 822 842 843 864 915 925 929 934 950 958 1050 1075 1101 1180 1187 1240 
17 29 45 50 167 252 354 355 382 390 400 454 499 517 551 582 588 674 693 729 743 744 823 834 840 858 913 930 1000 1003 1014 1127 1228 1280 
19 43 64 66 108 123 277 282 312 338 344 456 529 573 592 623 632 737 787 839 893 907 908 923 946 1008 1021 1060 1061 1085 1143 1168 1214 1267 
32 102 105 142 143 185 298 299 336 350 352 367 475 478 483 493 509 518 568 599 684 691 694 697 701 731 772 773 909 949 1037 1087 1138 1250 
13 122 291 297 306 307 310 361 371 377 481 611 722 756 765 774 782 800 888 891 892 898 899 956 963 1071 1107 1121 1144 1235 1277 1284 
92 107 187 267 399 401 424 463 495 532 540 547 555 600 645 673 695 760 813 818 850 851 866 874 926 1030 1033 1113 1125 1150 1171 1285 
56 138 144 146 190 193 204 251 262 280 286 375 402 419 565 609 635 672 702 708 752 771 804 1016 1023 1093 1236 1251 1256 1263 1268 
83 111 118 141 156 245 285 288 292 363 378 380 420 482 616 668 692 703 783 849 859 1004 1007 1009 1022 1045 1074 1166 1247 1248 1275 
154 189 228 247 250 269 300 301 391 397 406 434 564 648 812 856 873 904 947 948 988 1058 1070 1092 1098 1111 1140 1146 1172 1173 1215 
51 70 79 80 96 99 116 149 183 254 275 339 511 531 598 642 755 802 803 876 928 984 1010 1024 1049 1084 1122 1130 1148 1243 
137 165 179 181 223 289 290 432 459 461 466 467 508 513 534 567 615 819 854 951 952 969 975 1036 1089 1133 1170 1218 1222 1260 
155 415 487 502 528 576 713 714 733 734 758 805 825 827 829 841 953 1053 1090 1106 1134 1135 1139 1154 1165 1252 1281 
128 214 215 218 230 246 281 405 414 453 559 593 607 608 746 809 890 901 912 939 1065 1124 1158 1205 1216 
60 151 197 304 323 394 421 603 638 652 753 853 914 955 979 987 1078 1126 1157 1184 
67 81 121 136 346 364 372 396 408 409 470 523 524 536 587 627 661 942 943 1253 
8 9 18 30 33 52 71 162 374 455 688 762 801 826 900 1056 1059 1141 
241 314 438 506 510 601 669 686 735 860 863 982 1020 1208 1287 
42 335 376 431 579 594 629 721 791 835 1025 1054 1195 1242 
221 388 699 761 775 776 784 894 906 961 962 1011 1159 1224 
16 53 381 413 533 709 711 941 959 1018 1048 1119 1279 
57 194 195 238 491 553 796 996 1076 1118 1274 
87 200 315 430 476 504 522 549 706 976 1149 
210 211 318 443 451 457 477 490 980 1206 1207 
212 213 342 343 395 439 591 1223 1231 1232 
412 468 501 815 886 1041 1042 1110 1112 1178 
589 750 751 767 778 986 1081 1233 
110 538 639 663 1102 1109 1151 
196 311 485 561 1057 1230 
284 789 790 844 1096 
878 935 1105 1186 
