109 113 120 121 123 136 152 153 164 188 231 238 249 280 287 325 330 368 383 384 394 404 427 429 459 489 497 503 505 516 523 524 545 548 566 575 587 588 596 613 617 618 626 635 647 656 685 689 690 700 715 716 739 758 759 762 765 784 808 816 817 828 836 844 852 861 868 877 878 894 895 903 917 919 924 932 933 941 975 1005 1006 1021 1054 1055 1056 1064 1080 1094 1098 1105 1111 1112 1126 1145 1149 1190 1192 1235 1246 1268 1286 
1 2 13 34 35 38 39 41 53 54 58 71 97 102 112 122 124 127 130 139 140 163 165 181 194 211 218 219 221 230 236 254 255 273 292 303 307 332 334 346 373 393 408 420 443 445 466 467 487 492 502 528 534 553 556 557 568 586 619 632 659 683 701 722 723 727 748 756 805 829 831 891 892 920 949 973 977 996 1019 1032 1131 1143 1238 1250 1269 1284 
0 60 61 69 70 73 131 144 150 151 157 158 159 160 174 195 248 295 345 349 350 352 380 446 464 475 481 485 500 531 541 551 577 578 594 603 621 624 637 638 661 687 692 707 711 712 725 747 845 922 927 974 987 1001 1015 1047 1066 1074 1079 1119 1186 1194 1225 1241 1275 
82 134 183 210 216 217 227 242 294 313 333 379 399 411 424 465 480 488 495 526 569 614 622 625 629 652 671 693 713 714 745 791 812 822 866 887 913 1010 1043 1100 1164 1196 1249 1288 
44 45 50 51 57 76 81 116 149 261 272 275 298 299 413 458 493 494 509 517 554 574 599 606 642 679 680 719 749 773 796 832 869 906 918 950 965 969 1058 1127 1138 1184 1189 
55 56 83 133 138 141 148 155 156 167 204 240 241 244 245 281 326 327 367 412 450 482 483 484 565 579 699 702 742 771 804 840 841 909 1023 1160 1166 1172 1173 1174 1175 1178 1278 
42 92 173 232 314 315 344 377 378 435 436 448 496 550 552 555 590 641 662 720 728 862 863 864 956 957 964 1039 1065 1076 1150 1202 1203 1274 1285 1287 
29 40 98 263 264 282 331 371 396 410 433 471 535 592 623 691 787 839 923 935 1067 1072 1073 1227 1255 
9 11 14 15 19 23 25 30 33 37 52 162 598 801 826 900 951 952 1059 1141 1222 1229 1243 
105 106 214 215 252 305 324 453 461 515 593 741 819 854 916 1008 1029 1051 1052 1133 
10 89 284 285 351 441 442 498 633 648 668 669 677 678 769 879 1068 1117 1161 
101 170 202 205 250 256 265 278 300 388 452 513 753 798 985 997 1086 1092 1273 
18 189 190 286 444 463 510 724 730 907 908 959 982 1087 1157 1236 1263 1279 
77 79 118 146 228 251 288 322 347 473 514 615 761 1093 1247 1248 1256 
184 283 302 360 369 385 508 572 735 736 763 777 795 820 925 934 
36 111 296 506 698 703 790 942 943 976 1096 1102 1129 1169 1198 
96 100 262 398 402 419 530 563 609 842 843 873 911 958 1271 
117 182 363 561 653 684 744 768 860 1022 1077 1226 
107 259 260 312 323 386 542 706 867 986 1085 
403 850 851 874 875 881 926 1030 1033 1113 1125 
108 267 268 540 802 803 813 993 1104 1132 
258 336 694 737 738 953 970 971 1034 1262 
328 414 537 538 584 639 797 814 983 1035 
392 397 406 434 472 564 611 1070 1075 1137 
543 636 752 799 992 1016 1213 1239 1244 1251 
99 220 226 437 499 810 1014 1084 1280 
103 224 389 809 884 901 1026 1108 1176 
277 456 573 627 628 651 751 767 1081 
4 104 201 381 416 454 781 1018 
6 47 375 833 1041 1042 1147 1266 
16 504 511 876 928 984 1231 1232 
114 129 203 229 308 686 732 1185 
119 374 409 455 491 536 936 1118 
175 348 415 658 660 1153 1154 1183 
192 198 234 581 681 967 1115 1116 
212 213 395 591 602 779 838 1223 
439 527 546 793 794 1258 1259 1276 
5 20 571 600 601 645 695 
7 126 717 1024 1130 1159 1162 
24 271 576 1168 1253 1260 1265 
59 501 815 871 886 1152 1177 
72 128 582 786 1124 1163 1179 
176 310 521 782 783 1082 1233 
225 239 276 583 880 897 1197 
319 343 391 856 857 921 946 
320 321 447 1013 1053 1182 1283 
340 341 358 544 785 1103 1257 
382 462 549 764 788 1000 1240 
27 246 990 1025 1095 1205 
46 93 94 297 362 646 
64 65 75 338 1060 1120 
86 87 166 200 207 522 
135 640 655 688 938 1090 
137 317 318 589 1036 1089 
142 143 168 169 518 1261 
179 237 293 364 520 865 
196 311 366 425 954 1230 
304 853 914 1028 1078 1088 
354 355 390 729 939 1037 
400 547 792 955 1121 1181 
428 776 898 899 1069 1167 
470 595 1007 1009 1158 1234 
12 882 883 978 1200 
21 22 26 43 1017 
28 743 1050 1101 1228 
31 807 1140 1170 1270 
68 512 529 1188 1237 
132 682 888 889 1123 
154 387 426 1210 1264 
171 417 519 893 1063 
185 478 630 1040 1083 
186 243 266 356 824 
257 418 533 709 750 
329 567 1216 1245 1272 
353 558 778 849 1142 
365 370 570 834 1012 
421 469 479 855 981 
3 337 507 994 
8 772 995 1221 
32 197 1165 1252 
48 49 95 560 
66 562 811 937 
67 704 896 966 
74 525 1038 1201 
80 180 339 620 
84 85 177 972 
90 440 643 644 
115 675 676 1027 
145 539 902 1048 
235 279 585 1002 
253 269 666 667 
289 290 432 1044 
335 532 721 1242 
357 607 608 760 
359 657 766 1214 
376 430 431 1195 
457 991 1180 1199 
474 929 1020 1208 
604 612 616 1049 
654 674 1204 1254 
670 846 930 931 
710 789 1091 1224 
775 847 870 1011 
800 988 1071 1146 
17 63 1212 
62 912 960 
78 161 830 
110 1109 1151 
125 147 1209 
172 755 835 
191 1057 1193 
206 274 872 
222 223 885 
233 1136 1144 
291 468 1110 
301 610 1031 
306 361 823 
405 449 634 
451 490 746 
486 821 1122 
631 837 1211 
649 910 968 
650 754 890 
733 734 1215 
757 806 1128 
774 1107 1277 
848 915 1045 
859 979 980 
961 962 963 
1003 1004 1191 
1134 1135 1139 
