46 64 69 75 94 109 115 124 139 163 174 178 186 208 209 235 236 243 259 266 279 319 322 329 330 338 345 356 368 383 392 404 449 459 460 465 488 503 515 527 542 543 544 548 554 558 560 570 577 613 617 625 626 630 634 637 653 680 682 707 715 747 749 764 779 786 816 819 836 838 845 846 852 857 861 867 868 871 882 883 887 888 889 903 917 919 920 921 932 937 956 965 968 977 978 989 1001 1005 1006 1012 1015 1022 1028 1047 1051 1052 1055 1060 1073 1077 1082 1095 1103 1116 1132 1138 1155 1156 1164 1169 1177 1189 1216 1221 1225 1245 1249 1272 
0 1 2 3 4 5 6 7 10 12 15 20 21 22 23 24 26 27 35 37 41 44 47 49 63 74 82 86 95 129 135 140 170 173 180 199 202 203 217 229 308 309 328 391 397 411 434 469 472 473 474 486 520 564 571 574 636 679 902 905 924 983 997 1017 1046 1066 1099 1117 1131 1147 1163 1175 1179 1193 1200 1212 1229 1266 1273 
14 36 58 59 121 123 136 161 166 175 207 216 242 316 317 324 344 358 359 387 396 425 441 442 456 464 489 494 516 587 596 646 664 665 718 723 740 741 785 822 862 916 954 1068 1100 1153 1191 1192 1257 1264 1265 
34 39 65 72 103 130 152 168 171 219 225 231 296 416 435 618 619 620 621 622 654 685 689 716 727 781 808 810 828 831 855 877 897 918 933 970 971 1034 1043 1088 1145 1162 1190 1194 1197 1204 1254 
68 76 150 184 185 222 260 270 271 274 283 302 327 337 346 347 360 369 380 384 385 386 418 429 479 480 484 569 572 624 739 820 885 940 1019 1035 1044 1064 1123 1174 1188 1196 1237 1282 1288 
54 101 153 261 325 370 373 393 427 444 447 468 500 546 562 585 606 610 612 628 675 676 724 725 730 748 754 759 811 832 896 944 945 966 1002 1027 1039 1086 1110 1211 1258 1259 1276 1283 
43 264 282 312 410 417 433 450 462 497 514 529 535 592 623 632 649 650 694 787 799 839 865 878 893 907 908 923 935 946 1008 1031 1061 1063 1067 1072 1085 1105 1143 1168 1186 
13 38 62 89 97 122 198 255 291 297 306 307 321 361 377 537 538 556 581 586 639 712 722 756 765 800 814 872 891 892 922 960 1038 1071 1094 1107 1144 1235 1269 1284 
48 73 77 78 88 104 117 119 126 131 148 160 248 295 428 430 436 446 458 504 507 578 666 667 710 745 768 780 974 975 990 1013 1091 1114 1142 1167 1182 1203 
56 83 84 85 138 141 146 156 177 193 214 215 218 230 245 246 292 363 405 420 453 482 593 609 616 672 752 771 849 901 911 939 994 1004 1007 1009 1166 
92 107 187 267 390 399 401 424 463 495 532 540 547 555 600 645 663 673 729 760 813 818 850 851 866 874 926 1030 1033 1109 1113 1125 1150 1151 1171 1285 
31 154 189 228 247 250 269 277 300 301 406 648 812 856 873 890 904 947 948 958 988 1026 1041 1042 1058 1070 1092 1098 1111 1140 1146 1172 1173 1215 
32 102 105 142 143 298 299 336 350 352 367 475 478 483 493 509 518 568 599 614 657 684 691 697 701 731 772 773 909 949 1037 1087 1119 1250 
81 116 149 196 275 310 311 364 371 372 481 485 523 524 531 561 611 627 642 661 755 782 869 942 943 963 1049 1057 1230 1253 
17 45 50 220 340 341 354 355 382 437 454 499 525 674 728 744 823 824 834 840 930 931 1000 1003 1020 1127 1178 1208 1280 
28 29 40 93 98 127 147 167 191 224 252 257 258 331 366 400 445 517 551 582 588 693 743 858 913 981 1014 1228 1262 
60 110 111 151 197 303 304 323 394 421 603 638 652 753 853 914 955 979 987 1078 1102 1121 1126 1157 1184 1205 1238 1251 
114 134 145 239 244 272 276 333 351 496 530 541 563 583 584 597 631 633 681 837 879 880 910 927 1115 1161 1185 1278 
9 55 112 125 132 164 205 227 232 240 249 253 256 265 273 278 287 353 505 678 704 705 717 769 826 830 
176 326 348 407 412 501 526 658 659 662 687 720 721 770 815 886 895 936 973 993 1112 1181 1183 1209 1241 1242 
25 268 332 334 357 379 426 521 550 590 660 700 732 788 842 843 864 929 950 1050 1075 1101 1187 1210 1240 
61 106 188 448 471 512 545 552 566 602 647 651 656 719 793 794 985 992 1079 1097 1198 1202 1227 1255 1286 
8 18 19 30 33 52 66 71 108 162 374 455 573 688 737 762 801 900 1056 1059 1141 1214 1267 
42 100 113 335 376 403 431 579 594 629 683 690 791 835 875 957 1025 1029 1054 1137 1195 1246 1271 
155 212 213 342 343 395 439 502 528 576 591 713 714 733 734 805 825 829 1090 1223 1231 1232 1281 
90 91 182 237 263 293 362 389 487 539 595 726 821 841 1053 1108 1122 1129 1134 1135 1139 1226 
144 190 204 251 262 280 286 375 402 419 565 635 702 708 804 1016 1023 1080 1093 1236 1263 1268 
16 120 192 233 234 313 492 580 677 757 806 807 881 967 991 1032 1062 1128 1136 1199 1270 
221 388 699 761 775 776 784 802 803 847 870 894 898 899 906 961 962 1011 1159 1224 
70 79 80 96 99 183 254 294 339 511 792 876 928 984 1010 1024 1084 1130 1148 
137 165 169 179 223 466 467 508 534 557 567 615 969 1069 1089 1170 1217 1218 1260 
11 133 157 226 604 605 640 641 655 938 1040 1083 1104 1201 1213 1239 1244 
181 461 736 763 777 795 854 915 925 934 951 952 1133 1180 1222 
51 57 194 195 238 491 553 598 796 996 1076 1118 1243 1274 
118 285 288 378 668 692 703 783 859 1045 1074 1247 1248 1275 
158 159 305 349 643 644 698 738 742 766 817 964 1021 1160 
241 314 438 506 510 601 669 686 735 860 863 982 1287 
87 200 315 398 440 476 522 549 706 976 995 1149 
128 281 414 559 607 608 746 809 912 1065 1124 1158 
210 211 318 443 451 457 477 490 575 980 1206 1207 
53 381 413 533 709 711 941 959 1018 1048 1279 
206 415 452 758 827 953 1106 1154 1165 1234 1252 
67 201 408 409 470 536 696 774 833 1277 
365 589 750 751 767 778 986 1081 1233 
320 797 798 848 884 1120 1152 1176 
289 290 432 513 519 695 1036 
172 498 670 671 972 1256 
284 789 790 844 1096 
