31 32 91 102 105 106 116 128 132 142 143 149 225 247 275 281 298 299 336 349 350 352 367 414 446 475 478 483 484 493 509 531 553 559 568 570 599 607 608 637 642 643 644 664 680 682 684 691 696 697 719 731 746 747 755 757 773 804 806 807 809 816 817 846 868 869 870 873 890 909 912 937 949 965 968 977 983 1001 1015 1018 1028 1037 1049 1065 1087 1114 1124 1128 1138 1146 1158 1174 1189 1197 1250 1270 
20 46 63 115 124 139 140 163 235 236 279 321 345 358 359 368 376 383 424 431 465 473 474 487 488 524 527 542 544 548 571 577 594 617 622 630 653 689 698 707 715 727 764 779 785 836 841 917 918 920 929 930 932 933 942 943 971 1005 1006 1034 1043 1046 1047 1051 1052 1054 1055 1066 1077 1082 1094 1103 1155 1156 1160 1162 1164 1175 1195 1225 1249 1257 
55 56 83 84 85 129 138 141 144 146 155 156 177 190 193 204 241 245 251 262 280 286 314 327 332 334 357 402 403 419 438 506 508 510 521 530 550 563 565 590 601 609 635 660 669 672 686 699 702 708 735 736 752 763 771 777 788 829 835 843 860 863 864 875 911 925 934 950 972 982 985 1016 1020 1023 1166 1208 1236 1240 1251 1263 1268 1287 
19 27 66 92 101 107 108 217 248 320 370 373 399 447 472 500 537 540 541 546 555 562 606 610 612 631 725 754 759 795 797 813 837 896 897 926 927 944 945 993 1039 1053 1060 1086 1104 1134 1135 1139 1150 1180 1211 1212 1283 1285 
28 29 40 62 98 114 120 123 127 134 135 145 191 192 224 233 234 239 244 257 272 276 277 313 331 333 344 366 456 492 496 539 583 584 677 681 842 880 881 910 958 960 967 991 1021 1026 1032 1062 1115 1136 1185 1199 1278 
35 67 94 109 136 153 158 173 174 178 188 198 201 202 261 310 325 329 330 371 382 404 408 468 481 503 512 585 586 587 611 626 651 665 740 786 833 852 903 907 919 963 997 1002 1012 1056 1110 1116 1121 1216 1245 1272 1286 
0 1 2 3 4 9 10 12 15 18 21 22 23 26 30 33 37 43 44 52 74 147 162 269 284 312 328 351 469 498 580 633 670 789 790 801 830 844 882 883 893 900 978 981 1017 1059 1085 1096 1141 1193 1200 1229 
13 14 38 81 89 93 97 100 122 161 181 255 258 291 297 306 307 361 362 377 461 556 646 662 683 701 756 765 792 800 821 854 872 888 891 892 956 1038 1071 1105 1107 1129 1133 1181 1235 1262 1269 1271 1284 
34 103 112 125 164 165 172 179 180 205 206 219 227 232 240 249 253 256 265 273 274 278 287 335 346 353 364 365 372 452 505 520 543 560 575 615 620 627 704 705 721 751 826 838 931 986 1142 1234 1242 
90 237 263 264 282 293 389 398 410 417 433 440 450 462 497 514 529 535 592 623 632 636 649 650 694 726 772 787 799 839 847 865 878 908 923 935 946 970 995 1008 1031 1061 1067 1072 1108 1143 1186 
65 130 182 218 230 246 292 363 412 420 458 459 482 528 576 578 595 613 616 619 621 661 666 667 685 687 780 805 819 825 849 887 901 939 975 1009 1088 1178 1194 1205 1226 1253 1258 1259 1276 
36 59 95 121 166 207 216 242 252 294 317 324 340 341 396 425 437 441 442 466 494 516 523 525 596 659 671 673 723 770 815 895 916 954 969 973 1029 1068 1100 1153 1183 1192 1265 
25 54 82 86 170 175 203 221 222 223 229 301 311 379 388 426 427 444 445 489 561 597 732 761 775 776 784 822 885 894 899 924 1011 1080 1095 1098 1187 1224 1273 
17 24 45 50 184 185 270 271 283 296 302 338 354 355 360 369 375 385 390 415 416 454 499 572 674 729 744 781 820 823 834 966 1000 1035 1093 1127 1280 1282 
7 48 73 77 78 88 104 117 119 126 131 148 160 295 337 436 507 511 678 710 717 745 768 769 876 928 974 984 990 994 1013 1063 1091 1182 1203 1232 1256 
5 41 49 58 61 168 169 199 268 411 448 486 557 574 581 602 629 679 700 712 791 802 803 814 902 905 922 1050 1075 1079 1101 1117 1131 1148 1217 1261 
110 111 118 285 288 303 378 380 502 538 639 663 668 692 703 713 714 733 734 783 859 1074 1090 1102 1109 1151 1198 1238 1247 1248 1275 1281 
76 150 167 267 347 384 386 400 401 418 429 463 517 547 551 569 582 588 624 739 743 858 913 940 1014 1044 1064 1196 1228 1288 
6 47 154 189 212 213 228 300 342 343 395 439 501 591 648 812 856 879 886 1041 1042 1092 1112 1147 1161 1172 1223 1231 1266 
39 42 72 152 171 231 428 430 435 504 618 654 693 716 722 808 828 831 877 898 957 1025 1069 1144 1145 1167 1190 1204 1254 
51 70 79 80 96 99 183 220 254 339 391 397 434 532 564 598 728 760 796 810 866 1010 1024 1058 1084 1122 1130 1243 
69 319 455 471 545 552 566 647 656 675 676 688 793 794 845 857 889 921 992 1027 1169 1171 1177 1227 1255 
75 197 259 304 322 323 393 603 638 652 737 738 742 748 749 753 832 867 955 979 980 1126 1165 1184 1252 
16 53 381 413 533 709 711 850 851 874 941 959 1030 1033 1048 1113 1119 1125 1163 1179 1279 
137 210 211 289 290 318 432 443 451 457 477 490 513 519 695 1036 1206 1207 
159 186 187 243 266 305 316 356 573 614 657 718 766 818 824 964 1214 1267 
11 133 157 226 604 605 640 641 655 938 1040 1083 1201 1213 1239 1244 
176 326 348 374 407 518 526 658 720 936 1004 1007 1097 1202 1209 1241 
214 215 405 409 421 453 470 479 536 579 593 628 774 811 855 1277 
68 113 260 480 690 758 827 953 1019 1106 1137 1154 1188 1237 1246 
208 209 308 309 449 634 724 730 951 952 988 989 1099 1222 
8 71 392 558 625 762 947 948 1073 1132 1221 
495 600 645 798 848 884 915 1045 1120 1152 1176 
64 460 549 554 706 871 1022 1089 1140 1170 
194 195 387 464 515 861 862 996 1210 1264 
250 406 782 904 1070 1111 1168 1173 1215 
60 151 394 853 914 987 1078 1157 
87 200 315 476 522 976 1149 
57 238 491 1076 1118 1274 
589 750 767 778 1081 1233 
467 534 567 1218 1260 
196 485 1057 1230 
906 961 962 1159 
840 1003 1191 
