20 61 62 64 75 118 124 139 140 163 194 195 208 209 235 236 259 279 288 322 329 330 368 371 376 383 387 392 411 431 448 459 464 471 473 481 486 488 503 515 527 542 553 554 558 574 577 579 594 602 611 613 617 625 630 634 656 679 680 682 715 747 749 764 793 794 796 814 816 819 836 845 846 852 861 862 867 868 871 887 902 903 920 922 932 960 963 965 968 977 996 1001 1012 1015 1017 1028 1046 1047 1051 1052 1054 1055 1060 1073 1079 1082 1094 1097 1132 1138 1164 1175 1189 1195 1202 1221 1225 1227 1245 1247 1248 1255 1264 1272 
0 1 2 3 4 5 6 7 10 12 13 21 22 23 26 35 37 38 41 42 47 49 58 74 81 82 86 89 97 113 123 142 143 170 173 196 199 202 203 220 229 252 298 299 308 309 311 328 344 364 372 456 469 485 489 509 523 524 556 561 571 629 636 637 661 676 693 728 791 822 835 869 872 898 899 905 924 942 943 957 983 997 1027 1029 1038 1057 1095 1117 1131 1137 1147 1229 1230 1246 1266 1273 
28 40 56 63 84 85 114 127 129 134 135 138 144 145 146 177 190 191 193 204 239 244 251 262 268 272 276 280 286 332 333 334 351 357 366 375 379 397 402 419 496 497 521 530 541 563 565 566 581 583 584 590 609 631 633 635 660 672 673 700 702 708 712 732 752 771 788 804 837 843 864 879 880 910 911 927 985 1016 1023 1050 1075 1080 1093 1101 1115 1161 1185 1187 1193 1198 1210 1236 1240 1263 1268 1278 
24 68 76 100 116 149 150 184 197 222 260 270 271 274 275 283 302 304 316 317 323 327 337 346 347 360 369 380 384 385 386 403 418 429 479 480 484 531 533 569 572 603 624 642 645 652 683 690 739 755 820 875 885 940 941 955 979 1019 1035 1044 1049 1056 1064 1121 1123 1126 1174 1184 1188 1196 1237 1271 1282 1288 
31 32 83 102 105 128 141 156 185 218 245 246 292 336 350 352 363 367 420 450 475 478 482 483 493 528 568 570 576 599 616 684 691 694 697 701 731 772 773 805 809 825 849 901 909 919 937 939 949 994 1004 1007 1009 1022 1037 1087 1119 1124 1166 1216 1250 1253 
17 25 45 50 53 95 110 111 166 201 207 285 303 324 354 355 378 381 413 415 416 425 426 454 499 638 668 674 692 696 703 711 729 740 741 744 753 783 823 833 834 840 859 916 954 959 1000 1003 1018 1045 1048 1074 1099 1102 1127 1191 1205 1238 1275 1279 1280 
43 282 291 297 306 307 312 361 377 410 417 462 502 514 529 535 592 623 632 649 650 713 714 722 733 734 756 765 774 787 799 800 839 878 891 892 893 908 923 935 946 1008 1031 1061 1063 1067 1072 1085 1090 1105 1107 1143 1144 1168 1186 1235 1277 1281 1284 
48 73 77 78 88 104 115 117 119 126 131 148 158 159 160 248 295 305 349 358 359 428 430 436 446 458 504 507 578 643 644 666 667 698 718 738 742 745 766 768 780 817 964 974 975 990 1013 1021 1091 1114 1142 1160 1167 1182 1203 1257 
46 175 176 281 321 326 345 348 407 412 465 501 518 526 543 544 653 658 659 662 687 707 710 720 721 770 779 815 821 838 882 883 886 930 931 936 973 978 993 1005 1006 1077 1103 1129 1155 1156 1181 1209 1224 1241 1242 1249 1265 
54 101 153 188 261 325 370 373 393 427 444 445 447 468 500 512 545 546 552 562 585 606 610 612 628 647 651 664 665 675 724 725 730 748 754 759 811 832 896 907 944 945 966 992 1039 1086 1110 1211 1258 1259 1276 1283 1286 
34 39 65 72 103 130 152 168 171 219 225 231 296 335 435 618 619 620 621 622 654 685 689 716 727 781 808 810 828 831 855 877 897 917 918 933 970 971 1025 1034 1043 1088 1145 1162 1190 1194 1197 1200 1204 1254 
8 18 30 33 52 71 154 162 189 228 247 250 277 300 301 455 648 688 762 801 812 842 856 857 873 890 900 921 929 951 958 988 989 1026 1041 1042 1058 1059 1092 1098 1140 1141 1146 1172 1173 1222 
92 107 187 267 390 399 401 414 424 463 495 540 547 555 559 600 802 803 813 818 847 850 851 870 874 912 926 1030 1033 1065 1113 1125 1150 1158 1171 1285 
27 90 91 182 217 237 263 264 293 362 389 391 433 434 472 487 539 564 595 726 841 865 1053 1066 1108 1122 1134 1135 1139 1212 1226 
67 94 109 136 174 178 186 243 266 310 356 374 382 404 408 409 449 460 470 474 536 548 587 626 782 786 1020 1116 1208 
9 55 112 125 132 164 198 205 227 232 240 249 253 256 265 273 278 287 353 505 560 678 704 705 717 769 826 895 
214 215 221 230 269 405 406 453 593 699 761 775 776 784 894 904 947 948 1011 1070 1111 1112 1215 
14 36 59 121 161 216 242 396 441 442 494 516 596 614 646 657 723 785 1068 1100 1153 1192 
51 70 79 80 96 99 183 254 294 339 511 598 792 876 928 984 1010 1024 1084 1130 1148 1243 
16 120 192 233 313 492 677 757 806 807 881 967 991 1032 1062 1128 1136 1199 1270 
137 165 169 179 223 466 467 508 534 557 567 615 969 1069 1089 1170 1217 1218 1260 
314 438 506 510 601 669 686 735 736 763 795 863 915 925 934 982 1180 1287 
11 133 157 226 604 605 640 641 655 938 1040 1083 1104 1201 1213 1239 1244 
57 238 365 491 589 627 750 751 767 778 986 987 1076 1081 1118 1233 1274 
87 180 200 315 398 440 476 520 522 549 706 709 976 995 1149 1163 1179 
147 167 400 517 551 582 588 743 858 913 981 1014 1228 
155 212 213 342 343 395 439 591 829 1223 1231 1232 
210 211 318 443 451 457 477 490 575 980 1206 1207 
532 538 607 608 639 663 746 760 866 1109 1151 
15 29 44 93 98 224 257 258 331 1262 
60 151 388 394 421 853 914 1078 1157 1251 
106 122 241 255 586 719 860 1002 1071 1269 
181 234 461 550 580 777 854 950 952 1133 
206 452 758 827 953 1106 1154 1165 1234 1252 
320 537 797 798 848 884 1120 1152 1176 
19 66 108 338 573 737 1214 1267 
69 319 888 889 956 1169 1177 
172 498 670 671 830 972 1256 
289 290 432 513 519 695 1036 
340 341 437 525 824 1178 1183 
284 789 790 844 1096 
906 961 962 1159 
