34 103 113 115 124 139 140 163 208 209 219 329 330 368 376 383 392 431 449 459 471 473 487 488 503 527 542 554 558 566 577 579 581 594 613 617 620 622 625 629 630 634 637 656 675 676 680 682 689 690 698 712 715 727 747 749 764 793 794 810 814 816 819 836 841 845 846 852 861 868 869 871 887 903 917 918 919 922 932 933 937 965 968 970 971 972 975 977 983 989 1001 1012 1015 1027 1028 1034 1043 1046 1047 1051 1052 1053 1054 1073 1082 1132 1134 1135 1137 1139 1162 1164 1175 1189 1195 1221 1225 1227 1245 1246 1255 1272 
27 32 54 101 102 105 153 175 185 217 222 223 247 248 261 320 367 370 373 393 411 427 444 445 447 450 472 475 478 483 486 500 537 541 545 546 552 562 574 606 610 612 631 647 679 684 724 725 730 731 748 754 759 773 797 811 832 837 866 873 885 896 897 902 909 927 944 945 966 992 1039 1066 1086 1122 1146 1180 1211 1212 1250 1258 1259 1276 1283 
0 1 2 4 10 12 14 19 21 22 23 26 36 58 59 64 66 74 108 121 147 161 216 242 294 316 317 338 351 358 359 371 387 396 441 442 464 465 469 481 494 498 515 516 523 543 596 611 633 646 661 671 718 723 785 862 882 883 963 978 981 1017 1019 1060 1068 1100 1121 1123 1153 1192 1200 1210 1249 1257 1264 
3 5 20 41 47 49 56 63 65 84 95 100 130 138 144 146 177 180 190 193 199 204 251 262 280 286 296 308 309 402 403 419 520 530 563 565 571 609 619 621 635 672 683 685 699 708 752 771 804 875 905 911 985 1016 1023 1080 1088 1099 1117 1131 1147 1163 1179 1194 1251 1268 1271 
7 31 48 73 77 78 88 104 117 119 126 131 148 158 159 160 225 235 236 279 295 305 337 349 436 446 458 507 573 578 643 644 664 666 710 737 738 742 745 757 766 768 806 807 817 920 931 964 974 990 994 1013 1021 1091 1114 1128 1142 1160 1167 1182 1197 1203 1214 1236 1256 1267 1270 
46 81 94 109 136 174 178 186 188 196 243 266 310 311 321 325 345 356 364 372 374 382 404 460 474 485 512 524 544 548 561 585 587 626 651 653 707 779 786 872 930 942 943 1002 1005 1006 1020 1038 1057 1077 1095 1103 1116 1155 1156 1208 1230 1286 
55 70 79 80 96 99 112 125 132 164 172 183 198 205 206 227 232 240 249 253 254 256 265 273 278 287 339 353 391 397 434 452 505 511 532 560 564 575 670 678 704 705 717 760 769 802 803 830 876 928 984 1010 1024 1084 1130 1234 
92 107 128 187 218 230 246 267 281 399 401 414 424 463 495 540 547 555 559 600 607 608 645 673 695 746 809 813 818 850 851 874 890 901 912 926 939 1030 1033 1065 1113 1124 1125 1148 1150 1158 1171 1205 1216 1253 1285 
142 143 176 298 299 326 336 340 341 348 350 352 407 412 437 468 493 501 509 518 525 526 568 599 658 659 687 691 697 701 720 770 772 815 824 886 895 936 949 973 993 1037 1087 1110 1112 1178 1183 1209 1241 
90 182 237 263 264 293 362 389 398 410 417 433 440 462 497 514 519 535 539 592 595 614 623 650 657 662 694 726 787 792 799 821 847 865 870 995 1031 1063 1067 1072 1108 1129 1181 1226 
13 39 72 122 152 171 231 241 291 297 306 307 361 377 435 586 618 654 716 722 756 765 800 808 828 831 860 877 888 891 892 898 899 956 1071 1107 1144 1145 1190 1204 1235 1254 1284 
83 111 118 141 155 156 245 285 288 292 363 378 380 420 482 502 528 576 616 668 692 703 713 714 733 734 783 805 825 829 849 859 1004 1007 1009 1022 1074 1090 1166 1247 1248 1275 1281 
221 268 301 332 334 357 379 388 489 521 550 590 660 700 732 736 761 763 775 776 777 782 784 788 795 822 842 843 864 894 915 925 929 934 950 1011 1050 1058 1075 1098 1101 1224 1240 
76 116 149 150 184 270 271 274 275 283 302 327 347 360 369 384 385 386 418 429 484 531 533 569 572 624 642 709 739 755 820 940 941 1035 1044 1049 1064 1174 1196 1263 1282 1288 
16 62 120 135 181 191 192 233 234 313 333 461 492 496 580 597 677 681 854 881 910 951 952 960 967 991 1032 1055 1062 1094 1115 1133 1136 1193 1199 1222 
17 45 50 53 354 355 375 381 390 413 415 416 454 499 674 711 729 744 781 823 834 840 959 1000 1003 1018 1048 1093 1119 1127 1279 1280 
25 28 40 85 93 114 123 127 134 145 224 239 244 257 258 272 276 277 331 344 366 426 456 583 584 880 958 1026 1185 1187 1262 1278 
6 69 154 189 228 250 269 300 319 406 648 812 856 857 889 904 921 988 1041 1042 1092 1111 1140 1169 1172 1173 1177 1215 1266 
68 75 197 259 260 304 322 323 480 570 603 638 652 753 758 827 867 953 955 979 1106 1126 1154 1165 1184 1188 1237 1252 
35 38 82 86 89 97 129 170 173 201 202 203 220 229 255 365 428 556 696 728 833 924 957 997 1269 1273 
8 9 15 18 30 33 37 44 52 71 162 455 688 762 801 826 900 947 948 1056 1059 1070 1141 1229 
57 67 168 238 408 409 421 470 479 491 536 628 774 855 1076 1118 1261 1274 1277 
314 438 506 510 601 669 686 702 735 798 848 863 884 982 1045 1120 1152 1176 1287 
11 91 133 157 226 604 605 640 641 655 938 1040 1083 1104 1201 1213 1239 1244 
43 282 312 529 632 649 839 893 907 908 923 946 1008 1061 1085 1143 1168 
87 166 200 207 315 430 476 504 522 549 667 706 780 976 1149 
324 425 466 665 740 741 791 835 916 954 969 1029 1191 1265 
24 42 214 215 252 335 405 453 593 693 721 1025 1242 
29 98 167 400 517 551 582 588 743 858 913 1014 1228 
61 106 303 448 602 719 838 1079 1097 1202 1238 
137 165 179 289 290 432 513 615 1036 1089 1170 
210 211 318 443 451 457 477 490 980 1206 1207 
169 467 508 534 557 567 1069 1217 1218 1260 
212 213 342 343 395 439 591 1223 1231 1232 
346 589 627 750 751 767 778 986 1081 1233 
51 194 195 553 598 796 996 1243 
60 151 394 853 914 987 1078 1157 
110 538 639 663 1102 1109 1151 1198 
284 789 790 844 1096 
906 961 962 1138 1159 
328 636 879 1161 
878 935 1105 1186 
