44 45 46 50 51 57 76 81 93 94 107 116 137 149 222 223 259 260 261 272 275 297 298 299 312 318 323 362 370 386 413 458 493 494 509 517 542 554 570 574 582 599 604 606 612 614 616 642 646 679 680 706 719 749 773 816 832 834 867 868 885 903 906 918 965 975 1012 1015 1036 1049 1056 1058 1085 1089 1119 1127 1138 1184 1189 
0 60 61 69 70 73 117 131 144 150 151 157 158 159 160 174 182 195 248 295 349 350 352 363 380 446 464 475 481 485 500 531 541 551 561 566 577 578 594 603 621 624 637 638 653 661 684 687 692 707 711 725 744 747 768 845 860 913 919 922 927 974 1001 1022 1047 1066 1074 1077 1079 1186 1225 1226 1241 1275 
36 49 62 82 110 111 115 134 183 208 210 216 217 227 242 294 296 313 317 333 379 390 399 411 424 465 480 488 495 506 526 533 569 589 622 625 652 670 671 698 703 713 714 745 790 812 822 866 869 887 942 943 972 976 1010 1043 1096 1100 1102 1129 1164 1169 1196 1198 1210 1249 1288 
1 34 35 38 39 41 53 90 97 102 112 124 125 127 139 140 163 165 211 218 219 221 230 236 263 264 273 292 303 334 346 433 443 466 487 556 568 619 632 659 722 723 727 805 831 920 949 973 1019 1131 1143 1238 1250 
58 113 120 121 123 152 153 164 199 231 368 383 384 459 477 489 516 545 596 613 617 618 629 647 656 689 700 715 716 739 759 762 808 828 836 848 852 917 932 933 941 1005 1006 1045 1054 1109 1126 1149 1152 1171 1190 1192 1246 
42 71 72 92 173 184 283 302 314 315 332 344 360 369 377 378 385 414 435 436 448 496 550 552 555 572 590 641 662 720 820 862 863 864 956 1035 1039 1065 1076 1202 1203 1274 1285 1287 
55 56 83 128 138 141 148 155 156 167 204 240 241 244 245 281 326 327 367 412 450 482 483 484 579 609 699 702 742 771 804 815 909 1007 1023 1124 1160 1166 1172 1173 1174 1175 1278 
54 130 181 254 307 373 393 403 408 420 492 502 557 683 701 748 756 777 891 892 985 1032 1284 
105 106 122 252 255 305 324 354 426 461 515 586 729 741 916 1002 1008 1029 1037 1051 1052 1133 1269 
9 11 13 14 15 23 25 30 33 37 52 162 209 801 900 951 1059 1099 1141 1222 1229 
40 282 371 396 410 440 471 535 592 623 691 787 839 923 935 1067 1072 1073 1227 1255 
170 265 300 388 407 416 452 511 558 753 770 781 826 876 928 984 1092 1231 1232 1273 
77 79 118 146 228 229 251 288 322 347 473 514 615 761 1093 1247 1248 1256 
86 87 109 136 166 200 207 291 325 404 468 522 524 587 626 758 1110 1230 
18 189 190 444 463 665 724 730 740 907 908 959 1087 1157 1236 1279 
176 310 521 782 783 850 874 875 1030 1033 1082 1113 1125 1233 
238 280 394 427 429 497 635 817 861 924 1021 1080 1145 1268 
258 335 336 694 721 737 738 953 970 971 1034 1242 1262 
20 175 257 348 415 418 445 658 660 1153 1154 1183 
96 100 262 398 402 419 530 563 565 843 911 1271 
98 225 239 276 331 583 880 897 1187 1197 
10 285 351 498 633 668 879 1117 1161 
22 114 129 203 308 309 571 686 1185 
89 284 441 442 648 677 678 769 1068 
99 220 355 437 499 810 1084 1178 1280 
103 224 389 809 884 901 1026 1108 1176 
126 205 278 287 534 717 1024 1130 1159 
186 187 243 266 356 818 819 824 969 
320 321 345 447 675 1013 1182 1218 1283 
439 527 546 793 794 829 1258 1259 1276 
543 636 676 752 799 992 1016 1027 1251 
16 27 246 873 990 1025 1095 1205 
108 267 268 540 803 813 993 1132 
192 198 581 597 681 967 1115 1116 
212 213 395 591 602 779 838 1223 
304 382 462 549 764 788 1000 1240 
316 358 359 657 718 766 1214 1257 
319 343 391 455 856 857 921 946 
392 406 434 564 611 1070 1075 1137 
6 375 696 833 1041 1042 1266 
101 202 250 728 957 997 1086 
119 374 409 491 536 936 1118 
188 690 844 877 878 1105 1286 
353 750 767 778 849 1081 1142 
508 735 736 763 915 925 934 
4 104 201 381 454 1018 
21 26 43 47 1017 1147 
28 29 743 1050 1101 1228 
32 197 807 1165 1252 1270 
142 143 168 169 518 1261 
179 237 293 364 520 865 
206 274 544 785 872 1103 
214 215 405 449 453 593 
277 456 573 627 628 651 
329 467 567 1216 1245 1272 
400 547 792 955 1121 1181 
523 784 894 895 1098 1162 
537 538 584 639 797 814 
576 939 1168 1253 1260 1265 
8 772 995 996 1221 
12 882 883 978 1200 
59 501 871 886 1177 
68 512 529 1188 1237 
132 682 888 889 1123 
135 640 655 688 938 
185 478 630 1040 1083 
196 311 366 425 954 
457 795 991 1180 1199 
470 595 1009 1158 1234 
775 802 847 870 1011 
800 952 988 1071 1146 
3 337 507 994 
17 63 397 1212 
64 65 75 338 
66 562 811 937 
67 704 896 966 
80 180 339 620 
91 226 940 1064 
145 539 902 1048 
171 417 893 1063 
191 472 1057 1193 
253 269 666 667 
357 607 608 760 
376 430 431 1195 
428 504 1069 1167 
505 548 575 588 
631 796 837 1211 
654 674 1204 1254 
733 734 1215 1281 
853 854 1078 1088 
7 328 983 
19 598 1243 
31 1140 1170 
48 95 560 
78 161 830 
84 85 177 
133 605 708 
147 1014 1209 
154 387 1264 
193 672 673 
194 553 977 
233 1136 1144 
235 279 585 
249 765 1235 
290 432 513 
301 610 1031 
306 361 823 
365 986 987 
372 751 858 
451 490 746 
469 479 981 
486 821 1122 
503 693 791 
510 835 982 
525 697 1201 
600 645 695 
643 644 964 
649 910 968 
650 754 890 
669 1020 1208 
709 851 1179 
757 806 1128 
774 1107 1277 
776 898 899 
825 1090 1097 
846 930 931 
859 979 980 
961 962 963 
1003 1004 1191 
1060 1104 1120 
1134 1135 1139 
1213 1239 1244 
