3 5 20 41 47 49 58 61 63 64 65 95 115 124 130 139 140 142 143 163 180 199 296 298 299 308 309 324 329 330 371 376 411 425 431 446 448 459 460 466 473 474 481 486 487 503 509 520 527 542 548 554 571 574 577 581 594 602 611 613 617 619 621 629 630 637 664 675 676 679 680 682 685 698 712 727 747 764 791 814 816 819 835 836 845 846 852 868 869 871 902 903 905 916 919 922 929 932 937 954 963 965 968 969 975 977 983 1001 1012 1015 1022 1027 1028 1029 1046 1047 1051 1052 1053 1054 1060 1079 1082 1088 1097 1099 1114 1117 1121 1131 1134 1135 1138 1139 1147 1148 1163 1164 1175 1179 1189 1191 1194 1195 1202 1225 1245 1265 1272 
13 56 84 100 122 138 141 144 146 155 156 177 190 193 204 241 245 251 262 280 286 291 297 306 307 332 334 357 361 402 403 419 521 530 550 563 565 586 590 609 635 660 672 683 699 701 702 708 752 756 765 771 782 788 800 804 829 842 843 860 864 875 891 892 911 950 985 1016 1023 1071 1107 1166 1235 1240 1251 1263 1268 1271 1284 
27 54 101 153 175 217 222 223 248 261 320 370 373 427 444 445 447 472 500 537 541 545 546 552 562 606 610 612 631 647 724 725 730 754 759 797 798 811 837 848 866 884 885 896 897 927 944 945 966 992 997 1039 1045 1066 1080 1086 1120 1152 1176 1180 1211 1212 1258 1259 1276 1283 
46 176 292 321 326 345 348 363 407 412 420 465 468 482 518 526 528 544 576 616 653 658 659 661 687 707 720 770 779 805 815 825 849 887 895 930 936 973 993 1004 1005 1006 1007 1009 1077 1095 1103 1110 1155 1156 1178 1183 1209 1218 1241 1249 
39 72 152 171 208 209 231 368 383 392 435 449 464 471 488 515 558 566 618 625 634 654 656 689 715 716 722 793 794 808 828 831 861 862 877 933 951 989 1073 1132 1144 1145 1190 1204 1221 1222 1227 1254 1255 
7 48 73 77 78 88 104 117 119 126 131 148 158 160 225 295 337 349 436 458 507 578 643 644 666 710 745 757 768 817 931 974 990 994 1013 1021 1091 1128 1142 1167 1182 1197 1203 1236 1256 
194 195 263 264 282 398 410 417 433 440 462 497 514 519 529 535 553 592 623 632 649 650 694 787 796 839 847 865 907 908 923 946 995 996 1008 1031 1061 1063 1067 1072 1143 1168 
14 36 59 121 161 216 242 294 316 317 358 359 377 387 396 441 442 494 516 523 543 596 646 665 671 718 723 740 741 785 888 956 1019 1068 1100 1123 1153 1192 1210 1257 1264 
51 70 79 80 96 99 112 183 254 265 339 391 397 434 511 532 564 598 678 717 760 769 802 803 826 876 928 984 1010 1024 1084 1122 1130 1243 
92 107 116 149 267 275 399 401 424 463 495 531 540 547 555 600 642 645 673 695 755 813 850 851 874 926 1030 1033 1049 1113 1125 1150 1171 1285 
0 1 2 4 10 12 15 21 22 23 26 37 43 44 74 147 312 328 469 636 799 879 882 883 893 978 981 1017 1085 1161 1200 1229 
31 32 83 102 105 106 185 247 350 367 450 475 478 483 684 719 731 773 806 807 870 873 909 982 1018 1037 1146 1250 1270 
76 150 184 270 283 302 327 347 360 369 384 385 386 418 429 484 569 572 624 739 820 940 1035 1044 1064 1174 1196 1282 1288 
57 67 168 214 215 238 405 408 409 421 453 470 479 491 501 536 579 593 628 774 855 886 1076 1112 1118 1261 1274 1277 
6 17 45 50 354 355 375 390 415 416 454 499 674 729 744 781 823 834 840 1000 1003 1041 1042 1093 1127 1266 1280 
19 28 40 66 108 114 123 127 134 145 191 239 244 272 276 277 344 366 456 539 583 584 880 1185 1193 1278 
24 42 75 252 259 322 336 352 393 493 568 570 599 614 657 691 693 697 748 749 772 832 867 949 1025 1087 
81 94 109 136 174 178 188 310 325 364 372 374 382 404 512 524 585 587 626 651 786 942 943 1002 1116 1286 
34 103 110 219 303 538 620 622 639 663 810 838 841 917 918 970 971 1034 1043 1102 1109 1151 1162 1198 1238 
35 38 82 86 89 97 129 170 173 201 202 203 220 229 255 365 428 556 696 728 833 924 957 1269 1273 
62 120 135 192 233 234 313 333 492 496 580 597 677 681 881 910 960 967 991 1032 1055 1062 1094 1115 1136 
25 221 268 301 379 388 426 489 700 732 761 775 776 784 822 894 1011 1050 1058 1075 1098 1101 1187 1224 
69 154 189 228 250 269 300 319 406 648 812 856 857 889 904 921 988 1092 1111 1169 1172 1173 1177 1215 
181 314 438 461 506 510 601 669 686 735 736 763 777 795 854 863 915 925 934 952 1020 1133 1208 1287 
137 165 169 179 289 290 432 467 508 513 534 557 567 615 898 899 1036 1069 1089 1140 1170 1217 1260 
55 125 164 172 198 205 206 232 249 256 273 274 278 287 335 452 505 560 575 721 1234 1242 
111 118 285 288 378 380 502 668 692 703 713 714 733 734 783 859 1074 1090 1247 1248 1275 1281 
128 218 230 246 281 414 559 607 608 746 809 890 901 912 939 1065 1124 1158 1205 1216 1253 
8 9 18 30 33 52 71 162 455 688 762 801 900 947 948 1056 1059 1070 1141 
11 91 133 157 226 604 605 640 641 655 938 1040 1083 1104 1201 1213 1239 1244 
68 197 260 304 323 480 603 638 652 753 955 979 1126 1165 1184 1188 1237 1252 
87 166 200 207 315 430 476 504 522 549 667 706 780 976 1149 
90 182 237 293 362 389 595 662 726 792 821 1108 1129 1181 1226 
159 235 236 279 305 573 737 738 742 766 920 964 1160 1214 1267 
16 53 381 413 533 709 711 941 959 1048 1119 1279 
29 85 93 98 224 257 258 331 958 972 1026 1262 
167 400 517 551 582 588 743 858 913 1014 1228 
186 187 243 266 340 341 356 437 525 818 824 
210 211 318 443 451 457 477 490 980 1206 1207 
212 213 342 343 395 439 591 1223 1231 1232 
346 589 627 750 751 767 778 986 1081 1233 
113 690 758 827 953 1106 1137 1154 1246 
132 227 240 253 353 670 704 705 830 
196 311 485 561 872 1038 1057 1199 1230 
60 151 394 853 914 987 1078 1157 
284 351 498 633 789 790 844 1096 
878 935 1105 1186 
906 961 962 1159 
