0 60 61 69 70 73 115 117 131 144 150 151 157 158 159 160 174 182 195 248 295 349 350 352 363 380 411 446 464 475 480 481 485 500 531 541 551 561 566 569 577 578 594 603 621 624 637 638 653 661 675 684 687 692 698 707 711 725 744 747 768 845 860 913 919 922 927 974 987 1001 1022 1047 1066 1074 1077 1079 1186 1225 1226 1241 1275 1288 
44 45 46 50 51 57 76 81 93 94 107 116 149 222 223 259 260 261 272 275 297 298 299 312 323 362 365 370 386 413 458 493 494 509 517 542 554 570 574 582 599 604 606 612 616 642 646 679 680 706 719 749 773 816 832 834 867 868 869 885 903 906 918 965 986 1012 1015 1049 1056 1058 1085 1127 1138 1184 1189 
1 2 34 35 38 39 41 53 97 102 112 124 127 139 140 163 165 211 218 219 221 230 236 273 292 303 334 346 443 466 467 487 528 534 556 568 619 632 659 722 723 727 805 831 920 949 973 1019 1131 1143 1238 1250 
55 56 83 128 138 141 148 155 156 167 204 240 241 244 245 281 326 327 367 412 450 482 483 484 565 579 609 699 702 742 771 804 815 840 841 873 909 911 985 1007 1023 1124 1160 1166 1172 1173 1174 1175 1278 
183 216 217 227 242 294 313 379 390 399 424 465 495 526 614 622 625 652 670 671 713 714 745 812 822 866 887 1010 1043 1100 1164 1196 1249 
77 79 118 146 228 229 251 256 288 322 347 473 514 537 538 584 615 639 728 761 797 798 814 957 1093 1247 1248 1256 
42 71 92 173 314 315 332 378 436 448 496 550 590 641 662 720 862 863 864 964 1076 1202 1203 1274 1285 1287 
120 121 123 164 328 368 414 524 596 617 618 656 689 700 715 716 739 852 933 983 1005 1006 1054 1109 1149 
54 130 181 254 307 373 393 403 408 420 435 445 492 502 555 557 683 701 748 756 891 892 1032 1284 
105 106 122 252 255 305 324 354 426 461 515 586 729 741 916 1002 1008 1029 1037 1051 1052 1133 1269 
176 212 213 310 395 521 591 602 779 782 783 838 850 874 875 1030 1033 1082 1113 1125 1223 1233 
9 11 13 14 15 23 25 30 33 37 52 162 209 801 900 951 1059 1099 1141 1222 1229 
49 58 62 82 134 199 208 210 309 317 333 375 477 488 490 533 571 589 629 1119 
29 282 371 396 410 471 535 592 623 691 787 839 923 935 1067 1072 1073 1227 1255 
18 189 190 444 463 510 665 724 730 740 907 908 959 982 1087 1157 1236 1279 
238 280 394 427 429 497 635 759 762 817 861 924 941 1021 1080 1126 1145 1268 
10 89 284 285 351 442 498 633 648 668 677 678 769 879 1117 1161 
170 265 300 388 407 416 452 753 770 781 826 876 928 984 1092 1273 
86 87 109 136 166 200 207 325 404 468 522 587 626 758 1110 
36 111 296 506 703 790 942 943 976 1096 1102 1129 1169 1198 
152 153 231 383 489 808 828 836 848 915 932 1045 1152 1190 
258 335 336 532 694 721 737 738 953 970 971 1034 1242 1262 
99 220 226 355 437 499 655 810 1014 1084 1178 1280 
462 736 763 775 777 788 847 870 925 934 1011 1240 
16 192 291 511 581 597 681 967 1115 1231 1232 
20 175 257 348 415 418 658 660 1153 1154 1183 
40 98 225 239 276 331 583 880 897 1187 1197 
96 100 262 398 402 419 530 563 843 1271 
184 283 302 360 369 385 508 572 735 820 
103 224 389 809 884 901 1026 1108 1176 
108 267 268 540 802 803 813 993 1132 
186 187 243 266 356 818 819 824 969 
214 215 421 453 469 479 593 855 981 
384 441 459 516 613 917 975 1068 1192 
392 397 406 434 564 611 1070 1075 1137 
543 636 676 752 799 992 1016 1027 1251 
84 177 196 311 366 425 954 1230 
101 202 205 250 278 513 997 1086 
316 358 359 657 718 766 1214 1257 
319 343 391 455 856 857 921 946 
320 321 345 447 1013 1182 1218 1283 
353 558 750 767 778 849 1081 1142 
400 547 640 645 792 955 1121 1181 
90 263 264 433 440 643 644 
113 287 505 548 575 588 1246 
119 374 409 491 536 936 1118 
188 690 844 877 878 1105 1286 
439 527 546 829 1258 1259 1276 
6 47 1041 1042 1147 1266 
7 126 717 1024 1130 1159 
27 246 990 1025 1095 1205 
32 197 807 1165 1252 1270 
72 232 377 956 1065 1150 
114 129 203 308 686 1185 
142 143 168 169 518 1261 
171 417 519 634 893 1063 
179 237 293 364 520 865 
206 274 544 785 872 1103 
277 456 573 627 628 651 
523 784 894 895 1098 1162 
576 939 1168 1253 1260 1265 
853 854 914 1028 1078 1088 
3 337 507 994 1035 
4 104 201 381 1018 
8 772 995 996 1221 
12 882 883 978 1200 
21 22 26 43 1017 
28 233 454 1136 1144 
59 501 871 886 1177 
68 512 529 1188 1237 
132 682 888 889 1123 
185 478 630 1040 1083 
304 382 549 764 1000 
329 567 1216 1245 1272 
428 504 898 1069 1167 
457 795 991 1180 1199 
470 595 1009 1158 1234 
800 952 988 1071 1146 
64 65 75 338 
66 562 811 937 
67 704 896 966 
80 180 339 620 
125 198 560 1116 
137 318 1036 1089 
145 539 902 1048 
154 387 1210 1264 
191 472 1057 1193 
253 269 666 667 
289 290 432 1044 
306 361 823 833 
357 607 608 760 
376 430 431 1195 
525 696 697 1201 
631 796 837 1211 
654 674 1204 1254 
733 734 1215 1281 
743 1050 1101 1228 
17 63 1212 
19 598 1243 
31 1140 1170 
78 161 830 
91 940 1064 
133 605 708 
135 688 938 
172 755 835 
193 672 673 
194 553 977 
235 279 585 
249 765 1235 
301 610 1031 
344 552 1039 
372 751 858 
486 821 1122 
503 693 791 
545 647 1171 
649 910 968 
650 754 890 
669 1020 1208 
709 851 1179 
757 806 1128 
774 1107 1277 
825 1090 1097 
846 930 931 
859 979 980 
961 962 963 
1003 1004 1191 
1060 1104 1120 
1134 1135 1139 
1213 1239 1244 
