0 1 2 3 4 5 6 7 9 10 12 13 21 22 23 26 37 41 42 47 49 58 74 75 82 113 123 124 139 140 163 170 199 203 208 209 235 236 252 259 279 308 309 322 328 344 368 376 383 392 430 431 456 469 473 488 489 504 527 528 542 554 558 570 571 577 579 594 617 625 629 630 634 636 637 676 693 715 764 822 836 845 852 867 871 887 898 899 905 920 924 932 937 983 1012 1017 1027 1046 1047 1051 1052 1054 1055 1073 1082 1094 1095 1117 1131 1132 1137 1147 1164 1175 1195 1200 1221 1225 1229 1246 1266 1273 
54 68 100 101 186 187 188 243 260 266 329 330 346 356 370 373 393 427 444 445 447 480 500 503 512 545 546 552 562 606 610 612 628 645 647 651 675 683 690 748 754 759 811 818 819 824 832 896 897 919 944 945 992 1019 1030 1039 1086 1123 1171 1188 1211 1237 1245 1271 1272 1283 1286 
27 35 61 62 118 129 173 202 217 220 229 255 268 288 365 378 411 420 428 448 471 472 486 574 602 616 656 679 692 700 703 722 728 774 783 793 794 814 859 902 922 957 986 987 997 1004 1007 1015 1045 1050 1066 1074 1075 1079 1101 1107 1144 1202 1212 1227 1247 1248 1269 1275 1277 
28 40 85 93 114 127 134 145 146 177 193 198 224 239 244 257 258 272 276 331 332 333 334 357 366 379 403 496 521 530 541 563 566 581 583 584 590 609 631 660 672 673 712 732 771 788 837 843 864 875 880 910 911 927 985 994 1115 1185 1187 1198 1210 1240 1262 1278 
15 44 142 143 168 247 298 299 336 350 352 459 493 509 518 553 568 599 613 614 657 680 682 691 694 697 701 731 747 749 772 791 816 821 835 868 869 873 903 906 949 961 962 965 968 977 1001 1028 1029 1037 1087 1129 1138 1146 1159 1189 
20 24 39 63 65 72 130 135 152 153 171 195 225 231 261 296 325 335 387 397 435 464 468 515 585 618 619 621 654 664 665 685 689 716 727 808 828 831 861 862 877 907 933 1025 1088 1110 1145 1190 1194 1197 1204 1254 1258 1259 1264 1276 
14 17 25 36 45 50 59 84 95 121 161 175 201 216 242 354 355 396 425 426 441 442 454 494 499 516 596 646 674 696 723 729 740 741 744 785 823 833 834 840 916 954 966 1000 1003 1068 1099 1100 1102 1127 1153 1192 1280 
46 176 281 321 326 345 348 412 465 501 526 544 653 658 659 662 687 707 720 721 770 779 815 846 882 883 886 930 931 936 973 978 993 1005 1006 1077 1103 1155 1156 1181 1209 1241 1242 1249 1265 
8 18 30 33 52 69 71 154 162 228 250 277 300 319 455 648 688 762 801 812 842 856 857 888 889 890 900 921 929 956 958 1026 1041 1042 1056 1059 1092 1098 1140 1141 1169 1172 1173 1177 
48 73 77 78 88 104 117 119 126 131 148 160 248 295 436 446 458 507 578 666 667 710 745 768 780 802 803 847 870 974 975 990 1013 1091 1114 1130 1142 1167 1203 1224 
76 150 184 222 270 271 274 283 302 327 337 347 360 369 380 384 385 386 418 429 479 484 533 569 572 624 739 820 885 940 941 1035 1044 1063 1064 1174 1196 1282 1288 
31 32 56 83 102 105 128 138 141 156 185 218 245 246 292 363 367 475 478 482 483 684 752 773 809 849 901 909 939 1009 1022 1119 1124 1166 1216 1250 1251 1253 
43 282 291 297 306 307 312 361 377 529 592 597 623 632 649 681 756 765 787 800 839 878 891 892 893 908 923 935 946 1008 1061 1085 1105 1143 1168 1186 1235 1284 
64 67 94 109 136 174 178 310 338 351 371 374 382 404 408 409 449 460 470 474 481 523 536 548 587 611 626 633 661 782 786 879 963 1060 1116 1120 1161 1233 
90 91 182 237 263 264 293 362 389 410 417 433 450 462 487 514 535 539 595 650 726 799 841 865 1031 1053 1067 1072 1108 1122 1134 1135 1139 1226 
189 221 269 301 391 406 434 564 699 724 725 730 761 775 776 784 894 895 904 947 948 951 952 960 988 989 1011 1058 1070 1111 1182 1215 1222 
38 81 89 97 116 149 196 275 311 364 372 485 524 531 556 561 627 642 751 755 767 778 872 942 943 1038 1049 1057 1081 1230 
86 87 166 180 194 200 207 315 324 398 440 476 520 522 549 706 709 850 851 874 976 995 996 1113 1125 1149 1163 1179 1191 
34 103 110 111 219 303 538 543 620 622 639 663 810 838 855 917 918 970 971 1034 1043 1109 1151 1162 1238 
16 120 191 192 233 234 313 492 550 677 757 806 807 881 950 967 991 1032 1062 1128 1136 1193 1199 1270 
55 112 125 164 172 205 232 249 256 265 273 278 287 498 505 670 671 678 717 769 826 972 1256 
144 190 204 251 262 280 286 375 402 419 497 565 635 702 708 804 1016 1023 1080 1093 1236 1263 1268 
70 79 80 96 99 183 254 294 339 407 415 416 511 781 792 876 928 984 1010 1024 1084 1148 
137 165 169 179 223 466 467 508 534 557 567 576 615 969 1069 1089 1170 1217 1218 1260 
115 158 159 305 349 358 359 643 644 698 718 738 742 766 817 964 1021 1160 1257 
285 314 438 506 510 601 668 669 686 735 736 763 863 925 934 982 1020 1208 1287 
92 107 267 390 399 401 424 463 495 540 547 555 600 813 926 1033 1150 1285 
11 133 157 226 604 605 640 641 655 938 1040 1083 1104 1201 1213 1239 1244 
29 98 147 167 400 517 551 582 588 743 858 913 981 1014 1228 
197 304 323 603 638 652 753 955 979 1121 1126 1184 1205 
60 151 388 394 421 532 760 853 866 914 1078 1157 
155 212 213 342 343 395 439 591 829 1223 1231 1232 
210 211 318 443 451 457 477 490 575 980 1206 1207 
206 452 758 805 827 953 1106 1154 1165 1234 1252 
51 57 238 491 598 796 1076 1118 1243 1274 
53 381 413 711 959 1018 1048 1255 1279 
132 227 240 253 353 560 704 705 830 
320 537 797 798 848 884 915 1152 1176 
502 713 714 733 734 825 1090 1097 1281 
106 122 241 586 719 860 1002 1071 
414 559 607 608 746 912 1065 1158 
19 66 108 573 737 1214 1267 
214 215 230 405 453 593 1112 
289 290 432 513 519 695 1036 
181 461 580 777 854 1133 
340 341 437 525 1178 1183 
284 789 790 844 1096 
316 317 589 750 
