109 124 139 163 178 198 319 329 330 404 460 503 527 542 548 554 560 575 577 617 625 626 630 764 836 845 852 871 887 903 919 932 937 1012 1015 1047 1051 1052 1080 1082 1164 1177 1216 1225 1245 1272 
43 264 282 312 410 417 450 497 514 529 535 592 623 632 649 650 787 799 839 865 878 893 907 908 923 935 946 1031 1061 1067 1072 1085 1105 1143 1186 
56 84 138 144 146 156 177 204 245 247 251 262 280 375 402 419 565 609 702 708 752 771 804 873 911 985 994 1023 1093 1146 1166 1251 
101 346 370 373 393 427 447 500 562 606 612 628 724 725 730 748 754 759 811 832 896 897 1019 1086 1123 1211 1283 
0 1 2 4 7 10 12 21 23 26 36 37 58 74 147 242 469 596 614 657 723 821 981 1129 1229 
5 20 47 49 63 95 135 140 411 473 474 486 537 571 574 814 902 983 1046 1099 1147 1175 1179 
39 65 130 152 171 225 231 296 619 621 654 685 808 828 831 1088 1145 1190 1194 1197 1200 1204 1254 
13 122 291 297 306 307 361 377 586 756 765 800 888 891 892 898 899 956 1071 1235 1284 
142 143 298 299 336 350 493 509 518 568 599 691 694 697 701 772 949 1037 1087 
268 332 334 357 379 521 590 660 700 732 788 842 843 864 929 1050 1075 1101 1240 
459 553 613 680 682 747 749 816 819 846 868 869 965 968 975 977 1001 1028 1189 
17 45 50 354 355 390 416 454 499 674 729 744 781 823 834 966 1127 1280 
184 185 270 271 274 283 302 337 360 369 380 385 479 572 820 1035 1282 
154 228 300 648 812 856 890 958 1026 1041 1042 1092 1098 1140 1172 1173 
120 192 233 234 313 492 580 677 881 967 991 1032 1062 1136 1199 
137 165 169 179 223 466 467 508 534 557 567 615 969 1218 1260 
153 261 325 545 546 552 585 610 647 992 1002 1039 1258 1259 1276 
118 285 288 378 668 692 703 783 859 1045 1074 1247 1248 1275 
32 102 105 352 367 475 478 483 684 731 773 909 1250 
35 129 173 202 220 229 255 365 428 728 957 997 1269 
48 73 77 78 88 117 119 131 148 160 295 507 768 
61 448 471 602 656 793 794 922 1079 1097 1202 1227 1255 
70 294 511 792 802 803 876 928 984 1010 1024 1122 1130 
11 133 157 604 605 640 641 655 938 1040 1083 1104 
76 150 327 347 384 429 484 940 1044 1063 1064 1174 
90 91 226 237 293 362 389 433 440 539 726 1108 
181 736 763 777 795 915 925 934 951 952 1180 1222 
59 216 316 317 441 442 494 516 1068 1100 1192 
60 304 323 394 603 853 914 955 979 1078 1126 
92 267 399 401 424 463 540 547 555 1150 1285 
175 222 386 418 569 624 739 885 1153 1196 1288 
8 18 30 33 52 162 801 900 1059 1141 
42 208 209 309 449 629 634 791 835 1029 
46 94 345 653 707 779 1005 1006 1077 1095 
115 188 512 566 651 675 676 1027 1198 1286 
126 436 710 745 974 1013 1091 1142 1182 1203 
214 215 218 230 246 405 453 593 901 939 
620 622 810 917 918 970 971 1034 1043 1162 
83 141 363 420 482 616 1004 1007 1022 
158 248 349 446 643 644 817 1021 1114 
210 211 318 443 451 457 477 490 980 
235 236 279 368 383 488 715 920 1138 
673 850 851 874 1030 1033 1113 1125 1171 
81 364 372 524 627 942 943 1253 
82 86 170 203 308 637 924 1273 
114 134 145 239 272 276 880 1185 
116 149 275 531 642 755 1049 1263 
159 305 698 738 742 766 964 1160 
166 207 324 425 916 954 1191 1265 
167 400 517 582 588 858 913 1014 
174 186 243 266 356 786 1116 1163 
212 213 342 343 395 439 591 1223 
388 761 775 776 784 894 1011 1224 
526 662 720 721 1181 1209 1241 1242 
528 576 758 805 825 953 1165 1252 
589 750 751 767 778 986 1081 1233 
196 321 485 872 1038 1057 1230 
244 530 541 563 837 927 1278 
256 798 848 884 1120 1152 1176 
289 290 432 513 519 695 1036 
659 770 895 936 973 993 1183 
31 757 806 807 1128 1270 
71 374 455 688 762 1056 
100 113 690 1137 1246 1271 
128 281 414 809 1124 1158 
176 326 348 407 658 687 
227 253 353 704 705 830 
269 406 904 1070 1111 1215 
310 371 481 611 782 963 
333 496 597 681 910 1115 
340 341 437 525 824 1178 
376 431 579 594 1054 1195 
382 930 931 1000 1020 1208 
392 558 989 1073 1132 1221 
458 578 666 667 780 1167 
465 543 544 838 1103 1249 
3 6 41 1131 1266 
27 217 472 1066 1212 
29 98 224 257 331 
34 103 168 219 855 
68 260 480 1188 1237 
75 259 322 570 867 
79 80 96 183 339 
110 663 1102 1109 1151 
112 265 678 717 769 
125 164 249 273 505 
180 199 520 905 1117 
190 286 510 982 1236 
238 491 1076 1118 1274 
284 789 790 844 1096 
358 359 718 785 1257 
381 413 711 1018 1119 
409 470 536 774 1277 
506 601 669 686 863 
882 883 978 1155 1156 
16 533 709 941 
28 40 127 366 
38 89 97 556 
53 959 1048 1279 
62 960 1055 1094 
67 136 408 587 
72 435 716 877 
85 172 972 1256 
99 254 1084 1148 
121 396 523 661 
151 421 987 1157 
182 263 595 1226 
189 301 988 1058 
200 522 549 706 
314 438 735 1287 
351 633 879 1161 
391 397 434 564 
415 827 1106 1154 
464 515 861 862 
501 815 886 1112 
502 713 714 1090 
573 737 1214 1267 
618 689 727 933 
906 961 962 1159 
1069 1089 1170 1217 
1201 1213 1239 1244 
14 161 646 
19 66 108 
24 335 1025 
25 426 1187 
51 598 1243 
54 444 445 
64 338 1060 
69 857 921 
87 430 504 
93 258 1262 
107 813 926 
111 303 1238 
123 344 456 
194 195 996 
197 652 1184 
201 696 833 
205 232 278 
206 452 1234 
241 679 860 
292 849 1009 
387 1210 1264 
403 683 875 
412 468 1110 
461 854 1133 
462 847 870 
487 841 1053 
498 670 671 
532 760 866 
551 743 1228 
559 912 1065 
583 584 631 
607 608 746 
635 1016 1268 
638 753 1205 
722 1107 1144 
733 734 1281 
1134 1135 1139 
