0 36 60 61 69 70 73 82 111 117 131 134 144 150 151 157 158 159 160 174 182 183 195 210 216 217 227 242 248 294 295 296 313 333 345 349 350 352 363 379 380 399 411 424 446 464 465 475 480 481 485 488 495 500 506 526 531 541 551 561 569 577 578 594 603 614 621 622 624 625 629 637 638 652 653 661 671 684 687 692 693 698 703 707 711 712 713 714 725 744 745 747 768 790 791 812 822 845 860 866 887 913 922 927 942 943 974 976 987 1001 1010 1015 1022 1043 1047 1066 1074 1077 1079 1096 1100 1102 1119 1129 1155 1156 1164 1169 1186 1194 1196 1198 1225 1226 1241 1249 1275 1288 
1 2 13 34 35 38 39 41 42 53 54 58 71 92 97 102 112 122 124 127 130 139 140 163 165 173 181 194 211 218 219 221 230 232 236 253 254 255 269 273 292 303 307 314 315 332 334 344 346 357 373 377 378 393 408 420 435 436 443 445 448 466 467 487 492 496 502 528 534 550 552 553 555 556 557 568 586 590 607 608 619 632 641 659 662 666 667 683 701 720 722 723 727 728 748 756 760 805 829 831 862 863 864 891 892 920 944 945 949 956 957 964 973 977 996 1019 1032 1039 1065 1076 1131 1143 1150 1202 1203 1206 1207 1238 1250 1269 1274 1284 1285 1287 
109 113 115 120 121 123 136 152 153 164 188 231 238 249 280 287 291 325 330 368 383 384 394 404 427 429 459 468 489 497 503 505 516 523 524 545 548 566 575 587 588 596 613 617 618 626 635 647 656 675 676 685 689 690 700 715 716 739 757 758 759 762 765 784 806 808 816 817 828 836 844 852 861 868 877 878 894 895 903 917 919 924 932 933 941 975 1005 1006 1021 1027 1054 1055 1056 1064 1080 1094 1098 1105 1110 1111 1112 1126 1128 1145 1149 1190 1192 1235 1246 1268 1286 
5 17 20 55 56 62 63 83 96 100 133 138 141 148 155 156 167 185 193 204 240 241 244 245 262 281 320 321 326 327 367 376 398 402 412 419 430 431 447 450 460 476 478 482 483 484 530 563 565 571 579 600 601 605 609 630 645 672 695 699 702 708 742 771 780 804 840 841 842 843 848 873 909 911 912 915 958 960 1013 1023 1040 1045 1053 1062 1083 1134 1135 1139 1160 1166 1172 1173 1174 1175 1178 1182 1195 1212 1271 1278 1283 
44 45 46 50 51 57 72 76 81 93 94 107 116 128 137 149 222 223 247 259 260 261 272 275 277 297 298 299 312 317 318 323 362 365 370 372 386 413 456 458 493 494 509 517 542 554 570 573 574 582 589 599 604 606 612 616 627 628 642 646 651 679 680 706 719 731 749 751 767 773 786 796 832 834 858 867 869 885 906 918 950 965 969 986 1012 1036 1049 1058 1081 1085 1089 1124 1127 1138 1163 1179 1184 1189 
16 68 78 86 87 101 154 161 166 170 186 187 192 198 200 202 205 207 234 243 250 256 265 266 278 300 353 354 355 356 387 388 390 407 426 452 504 511 512 513 522 529 558 581 670 681 710 729 753 770 778 789 798 818 824 830 846 849 876 904 905 928 930 931 939 967 984 985 997 1037 1086 1091 1092 1115 1116 1142 1188 1210 1224 1231 1232 1237 1264 1273 
4 8 28 29 40 90 98 104 201 225 233 235 239 263 264 276 279 282 331 371 381 396 410 416 433 439 440 454 457 471 527 535 546 583 585 592 623 643 644 649 691 733 734 743 772 781 787 793 794 839 880 897 910 923 935 968 989 991 995 1002 1018 1050 1061 1067 1072 1073 1101 1136 1144 1180 1197 1199 1215 1221 1227 1228 1255 1258 1259 1276 
176 184 212 213 283 302 304 310 360 369 382 385 395 451 462 490 508 521 549 572 591 602 735 736 746 763 764 775 777 779 782 783 788 795 820 838 847 853 859 870 914 925 934 979 980 1000 1011 1028 1078 1082 1088 1223 1233 1240 
24 27 91 99 105 106 214 215 220 226 246 252 271 305 324 437 453 461 499 515 576 593 673 741 810 819 854 916 940 990 1008 1014 1025 1029 1051 1052 1084 1095 1133 1168 1171 1205 1253 1260 1265 1280 
77 79 88 118 146 191 228 251 288 322 342 347 392 397 406 434 472 473 514 564 611 615 663 761 947 948 1046 1057 1070 1075 1093 1137 1193 1247 1248 1256 
10 89 284 285 301 351 438 441 442 498 543 610 633 636 648 668 669 677 678 752 769 799 879 992 1016 1031 1068 1117 1161 1213 1239 1244 1251 1267 
7 114 119 126 129 172 203 229 308 319 343 374 391 409 455 491 536 686 717 732 755 835 856 857 921 936 946 1024 1118 1130 1159 1162 1185 
6 12 21 22 26 43 47 59 375 501 696 697 815 833 871 882 883 886 961 962 963 978 1017 1041 1042 1147 1152 1177 1200 1266 
9 11 14 15 19 23 25 30 33 37 52 162 178 580 597 598 801 826 900 951 952 1059 1141 1187 1222 1229 1243 
18 32 189 190 197 270 286 444 463 510 665 724 730 740 907 908 959 982 1087 1157 1165 1236 1252 1263 1279 1282 
80 179 180 199 206 237 274 293 339 340 341 358 364 477 520 544 620 726 785 865 872 1103 1217 1257 
64 65 66 75 108 267 268 338 540 562 650 754 802 803 811 813 890 937 993 1060 1104 1120 1132 
67 74 171 289 290 417 432 519 525 704 800 893 896 966 988 1038 1044 1063 1071 1146 1201 
258 306 336 361 400 401 547 694 705 737 738 792 823 953 955 970 971 1034 1121 1181 1262 
48 49 95 125 147 328 414 537 538 559 560 584 639 797 814 983 1035 1148 1209 
103 224 389 421 469 479 774 809 855 884 901 981 1026 1107 1108 1176 1277 
175 257 348 415 418 533 658 660 709 750 827 1106 1153 1154 1183 
135 470 595 640 655 688 938 1007 1009 1090 1158 1234 
31 428 776 807 898 899 1069 1140 1167 1170 1270 
110 335 532 654 674 721 1109 1151 1204 1242 1254 
403 850 851 874 875 881 926 1030 1033 1113 1125 
84 85 177 196 311 366 425 954 972 1230 
316 359 486 657 718 766 821 1122 1214 
145 474 539 902 929 1020 1048 1208 
132 664 682 888 889 1114 1123 
208 209 309 405 449 634 1099 
142 143 168 169 518 1261 
329 567 1216 1245 1272 
3 337 507 994 
631 837 1211 
1003 1004 1191 
