64 65 75 329 330 349 399 446 464 465 480 481 482 483 488 493 494 503 509 524 526 531 533 542 554 569 570 574 577 578 582 585 586 588 599 602 603 606 612 613 614 616 618 621 622 624 625 626 629 630 637 638 644 651 652 653 661 674 679 680 682 687 689 690 692 693 698 700 703 706 707 711 716 719 722 723 731 739 743 744 745 747 749 754 759 762 764 773 785 808 816 822 828 832 836 845 846 852 860 861 867 868 869 887 903 905 906 909 916 917 919 922 924 927 932 933 937 950 965 968 972 974 976 977 1001 1002 1012 1015 1017 1022 1024 1028 1037 1039 1055 1056 1060 1065 1066 1080 1106 1109 1138 1164 1167 1189 1192 1204 1210 1228 1241 1246 1258 1259 1272 1276 1288 
55 56 83 100 101 128 138 141 144 145 146 154 155 156 167 177 182 193 204 244 245 246 247 262 280 281 326 327 375 376 398 402 403 452 475 476 506 530 559 563 565 566 609 699 702 708 752 760 771 786 792 801 804 873 911 914 985 994 1014 1023 1071 1124 1146 1151 1166 1185 1226 1271 1278 
48 49 102 103 112 113 125 126 130 163 164 165 172 198 202 203 205 206 211 232 249 256 265 273 278 287 288 352 353 457 460 505 511 560 575 590 670 671 695 721 856 894 895 904 973 990 991 1036 1046 1114 1149 1168 1169 1174 1175 1232 1242 
0 1 2 3 4 5 6 7 8 9 10 11 12 13 14 15 18 19 21 22 23 25 26 30 33 37 43 47 52 58 59 74 147 162 269 328 469 487 899 900 981 983 1059 1075 1141 1147 1193 1209 1229 1239 1245 1266 
34 35 38 39 53 54 71 82 89 92 97 120 122 181 218 219 332 377 378 393 436 448 521 550 556 594 617 619 660 715 727 831 862 949 1004 1007 1038 1040 1054 1078 1088 1157 1158 1181 1196 1198 1200 1230 1233 1285 
263 264 362 363 371 396 410 417 433 440 450 462 471 478 497 514 529 535 539 592 595 623 632 649 650 691 694 726 772 787 799 839 865 881 893 908 923 946 1018 1031 1061 1067 1072 1073 1143 1186 1247 1248 
139 140 306 307 314 334 357 373 420 435 492 496 502 528 576 659 683 701 732 750 767 778 805 825 829 849 859 953 1025 1032 1081 1170 1238 1250 1286 1287 
41 42 72 114 115 129 171 173 178 220 228 229 238 239 250 255 319 347 365 428 513 686 728 756 844 863 864 871 957 1103 1105 1131 1177 1269 1284 
184 185 270 271 274 275 283 302 337 338 344 346 360 369 380 381 384 385 414 429 447 479 508 572 589 761 820 827 1035 1053 1237 
67 68 93 94 109 136 161 170 188 200 201 221 304 310 325 372 374 382 383 404 512 523 549 587 751 1020 1188 1208 1273 
28 29 40 98 216 217 224 225 242 257 258 331 379 424 495 527 551 789 866 1050 1077 1100 1101 1176 1180 1212 1262 1267 
60 61 69 70 73 150 151 157 158 159 174 248 316 317 350 477 712 857 921 1079 1089 1093 1155 1256 
44 45 46 50 51 57 76 81 137 149 272 297 318 335 336 517 642 720 1062 1107 1127 1172 
343 677 678 705 717 769 788 802 803 812 813 847 1090 1091 1092 1130 1142 1159 1162 1184 1224 1240 
233 234 313 438 439 461 501 580 581 648 823 833 1085 1086 1119 1122 1133 1140 1152 1264 
79 96 183 320 321 339 345 713 714 872 918 947 948 979 980 1041 1042 1049 1218 
84 85 107 108 127 253 254 276 277 282 311 455 456 573 646 1021 1148 1205 
77 78 88 104 117 118 119 131 148 160 295 499 500 507 541 1009 1280 
99 415 416 454 558 685 770 775 781 826 830 876 897 928 984 1110 1197 
391 392 397 406 434 472 564 961 962 995 996 1070 1132 1221 1249 
358 395 543 544 596 620 779 838 959 1213 1244 1255 1257 1279 
186 208 209 243 266 356 370 449 634 824 842 1111 1116 
408 409 470 491 536 579 774 886 1010 1118 1203 1236 1277 
62 63 95 134 135 210 294 333 411 607 1094 1179 
175 176 348 407 658 710 913 1076 1097 1202 1274 1281 
116 222 223 261 418 427 597 885 1145 1187 1263 
214 215 230 252 405 421 453 593 800 1112 1251 
236 279 443 600 601 645 920 1019 1045 1123 1160 
354 355 390 489 515 729 790 939 1096 1102 1283 
31 32 806 807 870 982 1165 1252 1270 1282 
187 850 851 874 875 926 1030 1033 1113 1125 
291 292 361 368 468 681 765 910 1084 1235 
545 546 552 647 656 793 794 992 1171 1217 
724 725 730 951 952 960 988 989 1182 1222 
16 17 20 24 27 36 296 966 1013 
121 123 259 260 312 322 323 386 1126 
212 342 387 388 394 532 591 1223 1231 
86 87 166 207 324 522 1191 1194 
105 106 124 305 818 819 1051 1052 
389 797 798 848 884 915 1108 1120 
735 736 763 777 795 925 934 1268 
809 810 890 901 958 1026 1098 1216 
814 815 935 936 1115 1128 1137 1144 
66 143 561 562 964 997 1199 
179 180 199 315 364 520 1253 
289 290 432 519 1044 1063 1064 
486 657 662 821 942 943 1129 
604 605 640 641 688 737 938 
90 91 226 237 293 1163 
132 133 227 240 241 367 
142 168 169 518 855 1261 
412 413 568 834 1117 1178 
466 467 534 557 567 615 
510 654 755 791 835 1254 
635 636 675 676 1016 1027 
782 783 1074 1082 1173 1275 
189 190 286 419 444 
194 195 553 796 837 
213 400 401 463 547 
284 285 351 498 633 
340 341 525 1183 1201 
627 628 811 858 1211 
643 817 967 1190 1260 
738 742 955 1121 1136 
843 888 889 929 956 
191 192 366 445 
231 610 611 709 
267 268 540 555 
359 718 766 1214 
430 431 504 1195 
441 442 516 1068 
451 490 608 746 
458 459 969 975 
473 474 548 902 
484 485 684 1057 
537 538 639 663 
668 669 748 1008 
879 880 963 1161 
882 883 978 1156 
970 971 1034 1043 
1005 1006 1087 1095 
152 153 907 
196 197 251 
235 437 1029 
298 299 768 
308 309 571 
425 426 954 
583 584 631 
666 667 780 
672 673 1265 
704 986 987 
733 734 1215 
757 758 1227 
776 784 1011 
840 841 1003 
877 878 1150 
891 892 1243 
930 931 1000 
993 1083 1104 
1047 1048 1225 
1134 1135 1139 
