73 131 134 144 159 160 182 183 210 216 217 227 242 248 294 295 313 333 345 352 363 379 380 399 411 424 464 465 475 480 481 485 488 495 500 503 526 533 541 551 569 603 614 621 622 624 625 629 637 638 652 661 671 687 692 693 698 707 709 712 713 714 725 731 744 745 747 791 812 822 845 846 866 869 887 913 919 922 927 942 943 1001 1010 1015 1022 1043 1074 1100 1129 1138 1186 1194 1196 1226 1249 1275 1288 
109 115 152 153 231 238 280 368 383 394 404 427 429 489 497 524 545 566 596 617 626 635 647 656 675 676 689 700 715 716 739 759 762 808 816 817 828 836 852 861 868 903 917 924 932 933 941 950 1005 1006 1021 1027 1080 1109 1126 1145 1190 1268 
44 45 46 50 51 57 76 81 93 94 116 128 149 247 272 275 297 298 299 362 413 493 494 509 517 554 574 582 599 642 646 719 749 773 786 832 965 1058 1124 1127 1163 1179 1184 1189 
34 35 39 41 53 102 112 124 127 139 140 163 165 211 218 219 221 230 236 273 292 303 334 346 443 466 467 487 534 568 619 632 701 727 831 920 949 969 1019 1131 1143 1238 1250 
13 38 54 82 97 122 130 181 254 255 307 332 373 393 403 408 420 435 445 492 502 555 556 557 576 586 683 748 756 805 825 829 891 892 952 1032 1269 1284 
55 56 83 138 141 155 156 167 204 244 245 281 412 482 483 565 579 609 699 702 742 771 804 840 841 1023 1160 1166 1178 1278 
0 60 61 69 70 150 151 157 158 174 349 350 446 531 577 578 594 711 974 987 1047 1066 1079 1119 1164 1225 1241 
42 71 92 173 314 315 378 436 448 496 550 590 641 662 720 728 862 863 864 957 964 1076 1202 1203 1274 1285 1287 
29 40 98 263 264 282 331 371 396 410 433 471 535 592 623 691 787 839 923 1067 1072 1227 1255 
9 11 14 15 19 23 25 30 33 37 52 162 598 801 826 900 951 1059 1141 1222 1229 1243 
86 101 170 202 250 265 300 388 452 513 753 876 928 984 985 997 1086 1092 1273 
105 106 214 215 252 305 324 453 461 515 593 741 819 916 1008 1029 1051 1052 1133 
184 283 302 328 360 369 385 414 537 538 572 584 639 797 814 820 983 1035 
77 79 118 146 228 251 288 322 347 473 514 615 761 1093 1247 1248 1256 
189 190 286 444 463 510 724 730 907 908 959 982 1157 1236 1263 1279 
96 100 262 398 402 419 530 563 842 843 873 911 958 1271 
133 148 240 241 326 327 367 450 484 909 1172 1173 1174 1175 
80 180 206 274 340 341 358 544 620 785 872 1103 1257 
113 249 505 548 575 588 765 784 894 1098 1149 1235 1246 
325 546 757 758 793 794 806 1111 1112 1128 1258 1259 1276 
36 111 296 506 703 790 976 1096 1102 1169 1198 
99 220 226 339 437 499 810 1014 1084 1280 
108 267 268 540 802 803 813 993 1104 1132 
114 129 203 229 391 686 732 1024 1130 1185 
258 336 694 737 738 953 970 971 1034 1262 
277 372 456 573 627 628 651 751 858 1056 
353 558 670 767 778 849 930 931 1081 1142 
392 397 406 434 472 564 611 1070 1075 1137 
850 851 874 875 881 926 1030 1033 1113 1125 
7 126 205 256 278 717 798 1159 1162 
16 192 198 511 581 967 1116 1231 1232 
89 284 441 442 648 677 678 769 1068 
103 224 389 809 884 901 1026 1108 1176 
508 735 736 763 777 795 915 925 934 
1 2 58 528 659 722 723 973 
6 47 375 833 1041 1042 1147 1266 
119 374 409 455 491 536 936 1118 
212 213 395 591 602 779 838 1223 
261 458 606 679 680 906 918 1012 
304 382 462 549 764 788 1000 1240 
384 459 516 613 975 1055 1094 1192 
543 636 752 1016 1213 1239 1244 1251 
5 20 571 600 601 645 695 
59 501 815 871 886 1152 1177 
64 65 66 75 338 1060 1120 
68 136 512 529 587 1188 1237 
107 259 260 312 386 542 1085 
120 121 123 164 523 618 1054 
135 640 655 688 938 1090 1097 
175 257 418 660 750 1153 1183 
176 310 521 782 783 1082 1233 
188 690 844 877 878 1105 1286 
320 321 447 1013 1053 1182 1283 
24 271 1168 1253 1260 1265 
27 246 990 1025 1095 1205 
72 232 377 956 1065 1150 
142 143 168 169 518 1261 
179 237 293 364 520 865 
194 195 553 796 977 996 
196 311 366 425 954 1230 
225 239 276 583 880 1197 
400 547 792 955 1121 1181 
470 595 1007 1009 1158 1234 
12 882 883 978 1200 
21 22 26 43 1017 
28 743 1050 1101 1228 
31 807 1140 1170 1270 
87 166 200 207 522 
132 682 888 889 1123 
154 387 426 1210 1264 
171 417 519 893 1063 
185 478 630 1040 1083 
186 243 266 356 824 
316 317 318 589 1089 
329 567 1216 1245 1272 
359 657 718 766 1214 
421 469 479 855 981 
3 337 507 994 
8 772 995 1221 
10 351 498 633 
32 197 1165 1252 
48 49 95 560 
67 704 896 966 
74 525 1038 1201 
90 440 643 644 
145 539 902 1048 
222 223 885 1218 
235 279 585 1002 
253 269 666 667 
285 879 1117 1161 
289 290 432 1044 
335 532 721 1242 
343 856 857 921 
348 407 658 770 
355 390 729 939 
357 607 608 760 
376 430 431 1195 
381 416 454 1018 
457 991 1180 1199 
474 929 1020 1208 
561 653 860 1077 
604 612 616 1049 
654 674 1204 1254 
710 789 1091 1224 
733 734 1215 1281 
775 847 870 1011 
776 898 899 1069 
800 988 1071 1146 
853 854 1078 1088 
935 989 1061 1073 
4 104 201 
17 63 1212 
62 912 960 
78 161 830 
91 940 1064 
117 684 768 
125 147 1209 
172 755 835 
191 1057 1193 
208 308 309 
233 1136 1144 
234 681 1115 
291 468 1110 
301 610 1031 
306 361 823 
323 706 867 
344 552 1039 
370 570 834 
405 449 634 
428 504 1167 
451 490 746 
486 821 1122 
562 811 937 
631 837 1211 
649 910 968 
650 754 890 
774 1107 1277 
859 979 980 
961 962 963 
1003 1004 1191 
1134 1135 1139 
