69 75 109 124 139 163 174 178 186 195 209 235 236 243 259 266 279 319 322 329 330 356 368 376 383 392 404 431 459 460 464 488 503 515 527 542 548 550 553 554 558 570 577 579 594 613 617 625 626 630 680 682 715 747 749 764 786 816 819 836 845 846 852 857 861 862 867 868 869 871 887 889 903 919 920 921 932 937 950 965 968 975 977 989 1001 1012 1015 1028 1047 1051 1052 1054 1055 1073 1080 1082 1116 1132 1138 1164 1169 1177 1189 1195 1221 1225 1245 1272 
3 5 6 20 24 27 35 41 42 47 49 62 63 82 86 95 129 135 140 142 143 170 173 180 199 202 203 208 217 220 229 255 268 298 299 308 309 335 365 405 411 428 449 472 473 474 486 509 518 520 571 574 581 629 634 637 679 700 712 722 728 791 814 835 902 905 922 924 957 960 983 997 1025 1029 1046 1050 1066 1075 1094 1099 1101 1107 1117 1131 1144 1147 1163 1175 1179 1180 1212 1266 1269 1273 
25 28 40 56 84 114 127 134 138 141 144 145 146 156 177 190 193 204 239 244 245 247 251 262 272 276 280 286 332 333 334 357 366 375 379 402 419 426 496 521 530 541 563 565 583 584 590 609 631 660 672 702 708 732 752 771 788 804 837 842 843 864 873 880 910 911 927 929 985 994 1023 1093 1115 1146 1166 1185 1187 1236 1240 1251 1263 1278 
54 68 100 101 113 153 175 260 261 320 325 346 370 373 393 403 427 444 445 447 480 500 537 545 546 552 562 585 606 610 612 628 647 683 690 724 725 730 748 754 759 797 798 811 832 848 875 884 896 897 944 945 966 992 1002 1019 1039 1086 1120 1123 1137 1152 1176 1188 1211 1237 1246 1258 1259 1271 1276 1283 
0 1 2 4 7 10 12 14 21 22 23 26 36 37 58 59 74 147 161 166 207 216 242 294 316 317 324 328 358 359 387 425 441 442 469 489 494 516 596 614 636 646 657 664 665 718 723 740 741 785 821 822 916 954 981 1017 1068 1100 1129 1153 1191 1192 1210 1229 1257 1264 1265 
34 39 65 72 103 130 152 159 168 171 219 225 231 296 305 435 479 618 619 620 621 622 654 685 689 698 716 727 738 742 766 808 810 828 831 855 877 917 918 933 964 970 971 1034 1043 1088 1145 1160 1162 1190 1194 1197 1200 1204 1254 
46 94 176 326 340 341 345 348 407 412 437 465 468 501 525 526 543 544 653 658 659 662 687 707 720 721 770 779 815 824 838 882 883 886 895 936 973 978 993 1005 1006 1077 1095 1103 1110 1112 1155 1156 1178 1181 1183 1209 1241 1242 1249 
13 38 64 81 89 97 121 122 291 297 306 307 310 361 364 371 372 377 396 481 523 524 556 586 611 627 661 756 765 782 800 888 891 892 942 943 956 963 1060 1071 1235 1253 1284 
48 73 77 78 88 104 117 119 126 131 148 158 160 248 295 349 436 446 458 507 578 635 643 644 666 667 710 745 768 780 817 974 990 1013 1016 1021 1091 1114 1142 1167 1182 1203 1268 
11 90 91 133 157 182 226 237 263 264 293 362 389 398 433 440 450 535 539 595 604 605 640 641 655 726 792 799 865 938 995 1040 1067 1072 1083 1104 1108 1201 1213 1226 1239 1244 
154 189 214 215 228 250 269 277 300 301 391 397 406 434 453 564 648 812 856 890 904 947 948 958 988 1026 1041 1042 1058 1070 1092 1098 1111 1140 1172 1173 1215 
9 55 85 112 125 132 164 172 198 205 227 232 240 249 253 256 265 273 278 287 353 498 505 560 575 670 671 678 704 705 717 769 826 830 972 1256 
76 150 184 185 222 270 271 274 283 302 327 337 347 360 369 380 384 385 386 418 429 484 569 572 624 739 820 885 940 1035 1044 1064 1174 1196 1282 1288 
43 282 312 410 417 462 497 514 529 592 623 632 649 650 787 839 847 870 878 893 907 908 923 935 946 1008 1031 1061 1063 1085 1105 1143 1168 1186 
67 136 155 201 408 409 470 487 502 528 536 576 587 696 713 714 733 734 774 805 825 829 833 841 1053 1090 1134 1135 1139 1277 1281 
92 107 187 267 399 401 424 463 495 532 540 547 555 600 673 760 813 818 850 851 866 874 926 1030 1033 1113 1125 1150 1171 1285 
8 18 19 30 33 52 66 71 108 123 162 338 344 374 455 456 573 688 737 762 801 900 1056 1059 1141 1214 1267 
70 79 80 96 99 116 149 183 254 275 339 511 531 642 755 802 803 876 928 984 1010 1024 1049 1084 1122 1130 1148 
137 165 169 179 223 289 290 432 466 467 508 513 519 534 557 567 615 695 898 969 1036 1069 1089 1170 1217 1218 1260 
32 102 105 336 350 352 367 475 478 483 493 568 599 684 691 694 697 701 731 772 773 909 949 1037 1087 1250 
17 45 50 354 355 382 390 416 454 499 674 729 744 781 823 834 840 930 931 1000 1003 1020 1127 1208 1280 
61 106 115 188 448 471 512 566 602 651 656 675 676 719 793 794 1027 1079 1097 1198 1202 1227 1255 1286 
60 151 197 304 323 394 421 603 638 645 652 753 853 914 955 979 987 1078 1121 1126 1157 1184 1205 
31 120 192 233 234 313 492 580 677 757 806 807 881 967 991 1032 1062 1128 1136 1199 1270 
241 314 438 506 510 601 669 686 735 736 763 777 795 860 863 915 925 934 982 1287 
83 218 230 246 292 363 420 482 593 616 849 901 939 1004 1007 1009 1022 1216 
221 388 699 761 775 776 784 894 899 906 961 962 1011 1159 1224 
118 285 288 378 668 692 703 783 859 1045 1074 1247 1248 1275 
16 53 381 413 533 709 711 941 959 1018 1048 1119 1279 
167 252 400 517 551 582 588 693 743 858 913 1014 1228 
51 57 194 238 491 598 796 996 1076 1118 1243 1274 
128 281 414 559 607 608 746 809 912 1065 1124 1158 
87 200 315 430 476 504 522 549 706 976 1149 
191 196 311 321 485 561 872 1038 1057 1193 1230 
206 415 452 758 827 953 1106 1154 1165 1234 1252 
210 211 318 443 451 457 477 490 980 1206 1207 
15 29 44 93 98 224 257 258 331 1262 
110 111 303 538 639 663 1102 1109 1151 1238 
212 213 342 343 395 439 591 1223 1231 1232 
284 351 633 789 790 844 879 1096 1161 
589 750 751 767 778 986 1081 1233 
181 461 854 951 952 1133 1222 
