75 109 115 124 139 163 178 235 236 259 279 319 322 329 330 368 383 404 459 460 488 503 515 527 542 548 554 560 570 577 613 617 626 630 637 680 682 715 747 749 764 816 819 836 845 846 852 861 867 868 871 887 903 917 919 920 932 937 965 968 977 1001 1012 1015 1022 1028 1047 1051 1052 1055 1082 1138 1164 1177 1189 1216 1225 1245 1272 
43 264 282 312 410 417 433 450 462 497 514 529 535 592 623 632 649 650 694 787 799 839 865 878 893 907 908 923 935 946 1031 1061 1063 1067 1072 1085 1105 1143 1186 
0 1 2 4 5 7 10 12 20 21 22 23 26 37 47 74 82 86 140 170 203 308 309 469 473 474 571 924 983 1017 1046 1147 1175 1193 1200 1229 1273 
39 65 130 152 171 225 231 296 416 619 621 654 685 781 808 828 831 897 1088 1145 1190 1194 1197 1204 1254 
13 122 255 291 297 306 307 361 377 586 756 765 800 891 892 1071 1235 1269 1284 
76 150 327 346 347 384 386 429 484 569 624 940 1019 1044 1064 1123 1174 1288 
142 143 298 299 336 350 493 509 518 568 599 691 697 701 772 949 1037 1087 
31 154 228 300 648 812 856 890 958 1026 1041 1042 1092 1098 1140 1172 1173 
184 185 270 271 274 283 302 337 360 369 380 385 479 572 820 1035 1282 
137 165 169 179 223 466 467 508 534 557 567 615 969 1218 1260 
332 334 357 379 521 590 660 732 788 842 843 864 929 1210 1240 
32 102 105 352 367 475 478 483 684 731 773 909 1119 1250 
56 83 138 141 146 156 245 363 482 609 752 771 994 1166 
101 370 373 500 562 612 628 754 759 811 896 966 1086 1211 
17 45 50 354 355 454 499 674 744 823 834 1127 1280 
48 73 77 78 88 117 119 131 148 160 295 507 768 
81 196 364 372 485 524 627 869 942 943 1057 1230 1253 
114 134 145 239 272 276 351 583 633 879 880 1161 1185 
61 448 471 602 656 793 794 1079 1097 1202 1227 1255 
107 673 813 850 851 874 926 1030 1033 1113 1125 1171 
120 192 233 234 313 580 881 967 991 1062 1136 1199 
49 95 135 411 486 574 679 902 1099 1163 1179 
144 190 204 262 286 402 419 565 708 1236 1263 
153 261 325 546 585 610 1002 1039 1258 1259 1276 
208 209 392 449 558 625 634 989 1073 1132 1221 
8 18 30 33 52 162 801 900 1059 1141 
46 94 345 653 707 779 1005 1006 1077 1095 
70 294 511 792 876 928 984 1010 1024 1130 
92 267 390 399 424 540 555 729 1150 1285 
112 125 164 249 265 273 505 678 717 769 
126 436 710 745 974 1013 1091 1142 1182 1203 
197 304 323 603 652 955 979 1121 1126 1184 
210 211 318 443 451 457 477 490 575 980 
214 215 218 230 246 405 453 593 901 939 
393 427 447 606 675 676 748 832 1027 1283 
428 430 458 504 578 666 667 780 975 1167 
16 492 677 757 806 807 1032 1128 1270 
365 589 750 751 767 778 986 1081 1233 
620 622 810 918 970 971 1034 1043 1162 
36 121 216 242 396 596 723 1100 
59 175 316 317 494 516 1153 1192 
90 91 237 293 362 389 726 1108 
159 305 698 738 742 766 964 1160 
166 207 324 425 916 954 1191 1265 
212 213 342 343 395 439 591 1223 
220 340 341 437 525 728 824 1178 
285 668 692 783 859 1045 1074 1275 
320 797 798 848 884 1120 1152 1176 
526 662 720 721 1181 1209 1241 1242 
11 157 226 641 1040 1083 1104 
87 200 476 522 549 706 976 
116 149 275 531 642 755 1049 
167 400 517 582 588 858 913 
174 186 243 266 356 786 1116 
176 326 348 407 412 658 687 
188 512 566 651 985 1198 1286 
189 247 301 873 988 1058 1146 
244 530 541 563 837 927 1278 
251 280 635 1016 1023 1080 1268 
388 761 775 784 894 1159 1224 
415 827 953 1106 1154 1165 1252 
659 770 895 936 973 993 1183 
736 763 795 915 925 934 1180 
24 27 217 472 1066 1212 
28 40 127 191 366 445 
35 129 173 202 229 997 
42 629 791 835 957 1029 
58 123 344 456 489 822 
71 374 455 688 762 1056 
100 113 690 1137 1246 1271 
118 288 378 703 1247 1248 
133 604 605 640 655 938 
158 349 643 644 817 1021 
227 253 353 704 705 830 
269 406 904 1070 1111 1215 
310 371 481 611 782 963 
314 438 510 735 982 1287 
333 496 597 681 910 1115 
376 431 579 594 1054 1195 
382 930 931 1000 1020 1208 
465 543 544 838 1103 1249 
487 821 841 1053 1122 1129 
532 663 760 866 1109 1151 
537 722 814 922 1107 1144 
3 6 41 1131 1266 
14 136 161 587 646 
29 98 224 257 331 
34 103 168 219 855 
60 394 853 914 1078 
68 260 480 1188 1237 
79 80 96 183 339 
110 111 303 1102 1238 
128 281 809 1124 1158 
151 421 987 1157 1251 
180 199 520 905 1117 
181 777 951 952 1222 
182 263 539 595 1226 
222 418 739 885 1196 
238 491 1076 1118 1274 
268 700 1050 1075 1101 
284 789 790 844 1096 
358 359 718 785 1257 
409 470 536 774 1277 
414 559 607 912 1065 
506 601 669 686 863 
882 883 978 1155 1156 
38 89 97 556 
53 959 1048 1279 
72 435 716 877 
84 85 177 911 
99 254 1084 1148 
194 195 553 996 
205 232 256 278 
206 452 758 1234 
289 513 519 1036 
375 702 804 1093 
381 413 711 1018 
387 464 862 1264 
420 616 1004 1007 
501 815 886 1112 
502 713 714 1090 
528 576 805 825 
545 552 647 992 
573 737 1214 1267 
618 689 727 933 
776 898 899 1011 
802 803 847 870 
888 889 956 1169 
1069 1089 1170 1217 
1201 1213 1239 1244 
19 66 108 
25 426 1187 
51 598 1243 
62 960 1094 
64 338 1060 
69 857 921 
93 258 1262 
147 981 1014 
172 972 1256 
198 581 712 
201 696 833 
248 446 1114 
290 432 695 
292 849 1009 
321 872 1038 
391 434 564 
398 440 995 
401 463 547 
403 683 875 
441 442 1068 
461 854 1133 
495 600 645 
498 670 671 
533 709 941 
551 743 1228 
638 753 1205 
724 725 730 
733 734 1281 
906 961 962 
1134 1135 1139 
