124 139 163 527 542 577 617 630 680 682 698 727 747 764 816 836 845 846 852 868 869 903 932 937 965 968 977 1001 1012 1015 1028 1047 1051 1052 1082 1138 1164 1189 1225 
56 84 138 141 144 146 156 177 190 204 245 251 262 280 286 402 403 419 530 563 565 609 699 708 752 771 804 875 911 985 1023 1251 1263 
263 264 282 410 417 433 440 497 514 519 529 535 592 623 632 649 650 694 787 839 865 907 908 923 946 1008 1031 1061 1063 1067 1072 1143 1168 
101 248 370 373 427 447 500 541 562 606 612 631 725 754 759 811 837 866 896 897 927 966 997 1080 1086 1211 1283 
76 150 184 270 283 302 327 347 360 369 384 385 386 429 484 569 572 624 820 940 1035 1044 1064 1174 1282 1288 
13 100 122 291 297 306 307 361 586 683 701 756 765 800 891 892 1071 1107 1235 1271 1284 
0 1 2 4 10 12 21 22 23 26 37 74 147 328 469 981 1017 1200 1229 
17 45 50 354 355 390 415 416 454 499 674 729 744 781 823 834 1000 1127 1280 
5 47 49 58 142 143 298 299 446 503 509 629 637 664 983 1114 1147 
39 152 171 231 618 654 722 808 828 831 1144 1145 1190 1204 1254 
70 391 397 434 511 564 802 803 876 928 984 1010 1024 1122 1130 
83 102 105 185 350 367 450 475 478 483 684 773 909 1037 1250 
120 192 233 234 313 492 580 677 881 967 991 1032 1062 1136 
59 216 316 317 441 442 494 516 718 1068 1100 1153 1192 
94 109 136 178 310 325 374 382 404 585 587 626 1002 
176 326 348 407 518 526 658 720 936 1004 1007 1209 1241 
35 129 173 202 220 229 255 365 428 728 957 1269 
36 242 294 377 543 596 671 723 888 956 1019 1123 
209 392 449 558 625 634 951 989 1073 1132 1221 1222 
332 334 357 521 590 660 782 788 842 843 864 1240 
8 9 18 30 33 52 162 801 900 1059 1141 
48 73 77 78 88 119 131 148 160 295 
67 408 409 470 536 579 774 886 1118 1277 
95 324 425 916 954 1099 1163 1179 1191 1265 
158 225 349 643 644 757 817 1021 1128 1197 
212 213 342 343 395 439 591 1223 1231 1232 
329 330 371 481 611 919 963 1121 1245 1272 
336 352 493 568 599 691 697 772 949 1087 
465 544 653 779 1005 1006 1077 1095 1103 1249 
471 566 656 689 793 794 861 933 1227 1255 
545 546 552 610 647 992 1039 1258 1259 1276 
7 126 710 931 1013 1091 1142 1182 1256 
28 40 127 145 191 272 366 539 1193 
125 164 172 198 249 273 505 560 575 
210 211 318 443 451 457 477 490 980 
221 301 388 761 775 894 1058 1098 1224 
11 91 157 226 641 1040 1083 1104 
31 32 806 807 870 982 1018 1270 
46 321 345 707 930 1155 1156 1218 
92 267 399 424 540 555 1150 1285 
110 303 538 639 663 1109 1151 1238 
128 281 414 607 809 890 1124 1158 
154 250 300 648 812 1092 1172 1173 
167 400 517 582 588 858 913 1014 
218 230 246 901 939 1205 1216 1253 
285 380 668 692 783 859 1074 1275 
620 622 810 838 841 917 918 1162 
29 98 224 257 331 958 1026 
69 228 319 856 857 921 1177 
87 166 200 207 522 549 706 
111 118 288 378 703 1247 1248 
116 149 275 531 642 755 1049 
130 296 619 621 685 1088 1194 
194 195 398 553 796 995 996 
363 420 482 616 661 687 887 
506 601 669 686 863 1020 1208 
659 770 815 895 973 993 1183 
736 763 777 795 915 925 934 
20 63 140 487 571 1053 
27 217 472 1066 1180 1212 
55 205 232 256 278 287 
61 448 602 1079 1097 1202 
64 460 554 871 1022 1060 
75 259 322 570 749 867 
81 364 372 524 942 943 
82 86 170 203 924 1273 
112 265 678 717 769 826 
133 604 605 640 655 938 
137 289 290 432 513 1036 
159 737 738 742 964 1160 
168 421 479 628 855 1261 
304 323 603 955 979 1126 
320 537 797 798 884 1176 
333 496 597 681 910 1115 
346 627 751 767 986 1081 
473 474 548 929 1046 1175 
850 851 874 1033 1113 1125 
24 42 252 693 1025 
57 238 491 1076 1274 
60 394 853 914 1078 
65 459 613 819 975 
68 260 480 1188 1237 
71 455 688 762 1056 
79 80 96 183 339 
114 134 276 880 1185 
132 227 240 704 705 
180 199 520 905 1117 
181 461 854 952 1133 
186 243 266 356 824 
197 652 1165 1184 1252 
208 368 383 488 715 
214 215 405 453 593 
239 244 583 584 1278 
268 700 1050 1075 1101 
269 406 904 1111 1215 
284 789 790 844 1096 
305 573 766 1214 1267 
314 438 510 735 1287 
376 431 594 1054 1195 
411 486 574 679 902 
436 745 974 1203 1236 
466 791 835 969 1029 
485 872 1038 1057 1230 
6 1041 1042 1266 
16 533 709 941 
38 89 97 556 
43 312 893 1085 
53 959 1048 1279 
54 175 444 445 
72 435 716 877 
90 362 726 792 
113 690 1137 1246 
115 675 676 1027 
123 277 344 456 
155 702 829 1166 
188 512 651 1286 
196 311 561 1199 
206 274 452 1234 
235 236 279 920 
237 293 389 1108 
247 731 873 1146 
340 341 437 525 
358 359 785 1257 
381 413 711 1119 
412 468 1110 1178 
458 578 666 1167 
476 667 780 976 
495 600 645 695 
502 713 714 1090 
528 576 805 825 
636 799 879 1161 
662 821 1129 1181 
848 1045 1120 1152 
906 961 962 1159 
970 971 1034 1043 
1201 1213 1239 1244 
3 41 1131 
14 161 646 
19 66 108 
25 426 1187 
34 103 219 
51 598 1243 
62 135 960 
93 258 1262 
99 254 1084 
107 813 926 
121 396 523 
151 987 1157 
165 179 615 
169 557 1217 
174 786 1116 
182 595 1226 
201 696 833 
222 223 885 
292 849 1009 
335 721 1242 
337 507 994 
351 498 633 
387 1210 1264 
393 748 832 
401 463 547 
418 739 1196 
464 515 862 
508 567 1260 
551 743 1228 
559 912 1065 
635 1016 1268 
665 740 741 
673 1030 1171 
733 734 1281 
776 784 1011 
814 922 1148 
827 1106 1154 
882 883 978 
898 899 1069 
947 948 1070 
1089 1140 1170 
1134 1135 1139 
