64 65 66 75 142 316 317 329 330 349 399 446 464 465 480 481 482 483 488 493 494 503 509 518 524 526 531 533 542 554 569 570 574 577 578 582 585 586 588 599 602 603 606 612 613 614 616 618 621 622 624 625 626 629 630 637 638 644 651 652 653 661 674 679 680 682 687 689 690 692 693 698 700 703 706 707 711 716 719 722 723 731 739 743 744 745 747 749 754 759 762 764 773 785 808 816 822 828 832 836 845 846 852 860 861 867 868 869 887 903 905 906 909 916 917 919 922 924 927 932 933 937 950 965 968 972 974 976 977 983 1001 1002 1012 1015 1017 1022 1024 1028 1037 1039 1055 1056 1065 1066 1080 1106 1109 1138 1145 1164 1167 1189 1192 1204 1210 1228 1241 1246 1258 1259 1272 1276 1288 
55 56 83 100 101 128 138 141 144 145 146 154 155 156 167 177 182 193 204 244 245 246 247 262 280 281 326 327 375 376 398 402 403 452 475 476 506 530 559 563 565 566 609 699 702 708 752 760 771 786 792 801 804 873 911 914 985 994 1014 1023 1071 1124 1146 1151 1158 1166 1185 1226 1271 1278 
0 1 2 3 4 5 6 7 8 9 10 11 12 13 14 15 18 19 21 22 23 25 26 30 33 37 43 47 52 58 59 74 147 162 269 328 358 359 467 469 487 657 718 899 900 981 1059 1141 1147 1193 1229 1239 1245 1257 1266 
263 264 362 363 371 396 410 417 433 440 450 462 471 478 497 514 529 535 539 592 595 623 632 649 650 691 694 726 772 787 799 839 865 881 893 908 923 946 1018 1031 1061 1067 1072 1073 1143 1186 1247 1248 
34 35 38 39 53 54 71 82 89 92 97 120 122 181 218 219 332 393 556 557 594 617 619 715 727 831 948 949 1004 1007 1038 1040 1054 1078 1088 1157 1196 1198 1200 1285 
41 42 72 114 115 129 171 173 178 220 228 229 238 239 250 255 319 347 365 428 513 686 728 756 844 863 864 871 957 1103 1105 1131 1177 1187 1269 1284 
67 68 93 94 109 136 161 170 188 200 201 221 304 310 325 372 374 382 383 404 512 523 549 587 696 848 1020 1120 1188 1208 1273 
184 185 270 271 274 275 283 302 337 338 344 346 360 369 380 381 384 385 414 429 447 479 508 572 589 761 820 827 1035 1237 
44 45 46 50 51 57 76 81 116 137 149 272 297 318 335 336 517 642 720 1062 1107 1127 1172 1263 
139 140 314 315 334 357 435 496 502 528 571 576 659 732 805 825 829 849 953 1183 1238 1250 1286 1287 
343 567 677 678 705 717 769 788 802 803 812 813 847 931 1090 1091 1092 1130 1142 1159 1184 1224 1240 
48 49 125 126 163 172 198 265 352 353 457 460 511 560 575 904 991 1100 1168 1232 1256 
60 61 69 70 73 150 151 157 158 159 174 248 350 712 857 921 1079 1087 1089 1093 1155 
28 40 98 216 217 242 379 424 495 527 551 789 866 967 1050 1077 1101 1180 1212 1267 
102 103 112 113 130 164 165 211 249 273 505 670 671 721 1036 1114 1149 1153 1154 1242 
85 107 108 127 253 254 276 277 282 311 455 456 573 646 766 1021 1098 1205 1214 
233 234 313 425 426 438 439 461 501 580 581 648 823 954 1112 1119 1122 1133 1140 
77 78 88 104 117 118 119 131 148 160 295 499 500 507 541 797 1009 1280 
79 183 320 321 345 713 714 841 872 918 947 979 980 1041 1042 1049 1070 1218 
186 187 243 266 290 356 370 432 449 519 634 666 667 780 842 1030 1111 1116 
391 392 397 406 434 472 564 733 734 961 962 995 996 1132 1215 1221 1249 
415 416 454 558 685 770 775 781 826 830 876 897 928 984 1110 1197 
341 395 543 544 596 620 779 838 959 1213 1244 1255 1265 1279 
545 546 552 647 656 757 758 793 794 898 992 1069 1217 1227 
169 408 409 470 491 536 579 774 855 886 1010 1118 1277 
179 180 199 364 520 809 810 890 901 958 1026 1216 1253 
62 63 95 134 135 210 294 333 411 516 607 1094 
202 203 205 206 232 256 278 287 288 590 833 1174 
152 153 231 354 355 390 489 515 729 907 1283 
16 17 20 24 27 36 296 966 1013 1025 
175 176 348 407 658 710 913 1076 1274 1281 
214 215 230 252 405 421 453 593 800 1251 
291 292 361 368 468 681 765 910 1084 1235 
306 307 373 420 492 683 701 859 1032 1170 
377 378 436 448 521 550 660 862 1181 1230 
525 697 951 952 960 988 989 1182 1201 1222 
814 815 935 936 1075 1115 1128 1137 1144 1148 
86 87 166 207 324 522 1053 1191 1194 
212 342 388 591 894 1162 1209 1223 1231 
610 611 709 724 725 730 851 939 1121 
735 736 763 777 795 915 925 934 1268 
29 224 225 257 258 331 1176 1262 
121 123 259 260 312 322 323 386 
604 605 641 688 776 784 938 1011 
90 226 237 293 389 884 1108 
105 106 124 305 818 1051 1052 
110 111 303 753 790 1096 1102 
208 209 235 437 466 600 1029 
222 223 261 418 427 597 885 
443 490 601 645 1019 1045 1160 
537 538 583 584 631 639 663 
132 133 227 240 241 367 
143 561 562 964 997 1199 
412 413 568 834 1117 1178 
486 662 821 942 943 1129 
510 654 755 791 835 1254 
635 636 675 676 1016 1027 
640 737 738 742 955 1136 
990 1046 1165 1175 1252 1282 
32 806 807 870 1270 
80 96 99 339 655 
84 484 485 684 1057 
168 298 299 768 1261 
189 190 286 419 444 
194 195 553 796 837 
213 400 401 463 547 
284 285 351 498 633 
458 459 819 969 975 
473 474 477 548 902 
627 628 811 858 1211 
750 751 767 778 1081 
782 783 1074 1173 1275 
843 888 889 929 956 
850 874 926 1033 1125 
191 192 366 445 
196 197 251 615 
267 268 540 555 
430 431 504 1195 
643 817 1190 1260 
668 669 748 1008 
879 880 963 1161 
882 883 978 1156 
970 971 1034 1043 
993 1060 1083 1104 
1047 1048 1082 1225 
236 279 920 
387 394 532 
441 442 1068 
451 608 746 
672 673 1171 
695 895 973 
704 986 987 
740 741 1123 
875 1113 1233 
877 878 1150 
891 892 1243 
940 941 1126 
1005 1006 1095 
1058 1099 1179 
1134 1135 1139 
