115 124 139 140 163 208 209 368 383 449 459 487 488 527 542 554 577 613 617 625 629 630 634 680 682 698 715 727 747 749 764 816 819 836 841 845 846 852 868 869 871 887 903 932 937 965 968 972 975 977 1001 1012 1015 1028 1047 1051 1052 1053 1055 1082 1138 1164 1189 1225 
55 56 84 138 144 146 156 177 190 204 262 286 402 419 530 563 565 609 699 708 752 771 804 911 985 1023 1166 1236 1251 1263 
76 150 184 271 283 302 327 347 360 369 384 385 386 429 484 569 572 624 820 940 1035 1044 1064 1174 1196 1288 
81 94 109 136 178 310 311 325 364 372 374 382 404 460 524 548 585 587 626 942 943 1002 1020 1208 
112 125 164 172 198 205 232 249 256 265 273 278 287 505 560 575 671 678 717 721 769 1242 
13 122 291 297 306 307 361 377 586 701 756 765 800 888 891 892 898 899 956 1235 1284 
113 244 248 329 330 446 503 541 637 664 690 919 927 983 1114 1137 1245 1246 1272 1278 
17 45 50 354 355 390 415 416 454 499 729 744 781 823 1000 1127 1280 
101 370 373 500 562 612 724 725 730 754 759 811 896 897 966 1086 1211 
282 529 592 623 632 649 650 694 787 839 907 908 923 946 1061 1143 
332 334 357 379 521 590 660 732 736 782 788 842 843 864 929 1240 
0 1 2 4 10 12 21 22 23 26 74 147 469 981 1017 
48 73 77 78 88 117 119 131 148 160 295 337 507 768 994 
120 192 233 234 313 492 580 677 881 967 991 1032 1062 1136 1199 
11 91 133 157 226 604 605 640 641 655 938 1040 1083 1104 
90 264 362 410 433 440 514 535 726 792 865 1031 1067 1072 
35 129 173 202 220 229 255 365 428 728 957 997 1269 
8 18 30 33 37 52 162 801 900 1059 1141 1229 
31 158 349 643 644 757 806 807 817 1021 1128 1270 
102 185 350 367 450 475 478 483 684 909 1037 1250 
107 673 813 850 851 874 926 1030 1033 1113 1125 1171 
154 228 250 300 648 812 856 921 1092 1140 1172 1173 
221 301 388 761 775 776 784 894 1011 1058 1098 1224 
46 321 345 653 707 779 930 1005 1006 1077 1095 
63 134 135 239 333 496 583 597 681 910 1115 
152 231 618 654 808 828 831 1145 1190 1204 1254 
166 207 324 425 665 740 741 916 954 1191 1265 
5 20 47 49 95 571 1099 1147 1163 1179 
65 130 225 296 619 621 685 1088 1194 1197 
336 352 493 568 599 691 697 772 949 1087 
620 622 810 917 918 970 971 1034 1043 1162 
36 58 242 294 543 596 723 1019 1123 
59 216 316 317 494 516 1100 1153 1192 
70 99 254 511 876 928 984 1084 1148 
82 86 170 203 308 309 561 924 1273 
159 235 236 279 305 766 920 964 1160 
188 512 566 651 675 676 1027 1198 1286 
197 304 323 603 652 955 979 1126 1184 
210 211 318 443 451 457 477 490 980 
7 126 710 931 1013 1091 1142 1182 
64 338 371 481 611 963 1060 1121 
92 267 399 424 540 555 1150 1285 
128 281 809 890 958 1026 1124 1158 
142 143 168 298 299 509 518 1261 
194 195 553 584 631 796 837 996 
212 213 342 343 395 439 591 1223 
218 230 246 901 939 1205 1216 1253 
471 656 689 793 794 933 1227 1255 
528 576 758 805 825 953 1165 1252 
19 66 108 465 544 1103 1249 
110 538 639 663 1102 1109 1151 
111 118 288 378 703 1247 1248 
116 149 275 531 642 755 1049 
174 186 243 266 356 786 1116 
181 461 854 951 952 1133 1222 
251 280 497 635 1016 1080 1268 
380 668 692 783 859 1074 1275 
391 802 803 1010 1024 1122 1130 
393 427 447 606 748 832 1283 
411 486 574 679 814 902 922 
659 770 895 936 973 993 1183 
16 418 533 709 739 941 
27 217 472 1066 1180 1212 
28 40 127 257 331 366 
61 448 602 1079 1097 1202 
83 141 245 363 482 1022 
114 145 272 276 880 1185 
137 289 290 432 513 1036 
176 326 348 407 658 687 
196 485 872 1038 1057 1230 
269 406 904 1070 1111 1215 
314 438 510 735 982 1287 
320 537 797 798 884 1176 
328 351 636 799 879 1161 
376 431 579 594 1054 1195 
392 558 989 1073 1132 1221 
546 610 1039 1258 1259 1276 
751 767 778 986 1081 1233 
763 777 795 915 925 934 
29 98 551 743 1228 
57 238 491 1076 1274 
60 394 853 914 1078 
68 260 480 1188 1237 
71 455 688 762 1056 
75 259 322 570 867 
79 80 96 183 339 
100 403 683 875 1271 
132 227 240 704 705 
180 199 520 905 1117 
182 263 539 595 1226 
214 215 405 453 593 
222 223 534 885 1218 
268 700 1050 1075 1101 
284 789 790 844 1096 
340 341 437 525 824 
358 359 718 785 1257 
381 413 711 1018 1119 
414 559 607 912 1065 
466 791 835 969 1029 
506 601 669 686 863 
722 774 1107 1144 1277 
6 1041 1042 1266 
38 89 97 556 
43 312 893 1085 
53 959 1048 1279 
54 175 444 445 
69 319 857 1177 
72 435 716 877 
121 396 523 661 
167 400 517 582 
200 522 549 706 
206 274 452 1234 
237 293 389 1108 
247 731 873 1146 
277 573 1214 1267 
375 702 1093 1256 
409 470 536 1118 
412 468 1110 1178 
420 616 1004 1007 
421 479 628 855 
436 745 974 1203 
458 578 666 1167 
464 515 861 862 
473 474 1046 1175 
476 667 780 976 
495 600 645 695 
501 815 886 1112 
502 713 714 1090 
526 720 1209 1241 
545 552 647 992 
588 858 913 1014 
662 821 1129 1181 
848 1045 1120 1152 
882 883 978 1200 
906 961 962 1159 
1201 1213 1239 1244 
3 41 1131 
14 161 646 
24 335 1025 
25 426 1187 
32 105 773 
34 103 219 
39 171 1071 
42 252 693 
51 598 1243 
62 960 1094 
87 430 504 
93 258 1262 
123 344 456 
151 987 1157 
165 179 615 
169 467 557 
201 696 833 
285 498 633 
292 849 1009 
303 838 1238 
387 1210 1264 
397 434 564 
401 463 547 
417 519 1063 
441 442 1068 
462 847 870 
508 567 1260 
532 760 866 
733 734 1281 
737 738 742 
827 1106 1154 
1134 1135 1139 
