0 36 48 49 60 61 62 69 70 73 82 95 110 111 117 131 134 144 150 151 157 158 159 160 174 182 183 195 208 210 216 217 227 242 248 294 295 296 309 313 317 333 345 349 350 352 363 375 379 380 399 411 424 446 464 465 475 480 481 485 488 495 500 506 526 531 533 541 551 561 569 577 578 589 594 603 621 622 624 625 629 637 638 652 653 661 670 671 684 687 692 693 698 703 707 709 711 712 713 714 725 731 744 745 747 768 790 791 812 822 845 860 866 887 913 919 922 927 942 943 974 976 987 1001 1010 1015 1022 1043 1047 1066 1074 1077 1079 1096 1100 1102 1109 1119 1129 1151 1155 1156 1164 1169 1186 1194 1196 1198 1225 1226 1241 1249 1275 1288 
1 2 13 34 35 38 39 41 42 53 54 58 71 72 92 97 102 112 122 124 125 127 130 139 140 163 165 173 181 194 211 218 219 221 230 232 236 253 254 255 269 273 292 303 307 314 315 332 334 344 346 357 373 377 378 393 403 408 420 435 436 443 445 448 466 467 487 492 496 502 528 534 550 552 553 555 556 557 568 586 590 607 608 619 632 641 659 662 666 667 683 701 720 722 723 727 748 756 760 805 829 831 850 851 862 863 864 874 875 891 892 920 944 945 949 956 964 973 977 985 1002 1019 1032 1033 1039 1065 1076 1113 1125 1131 1143 1150 1202 1203 1206 1207 1238 1250 1269 1274 1284 1285 1287 
44 45 46 50 51 57 76 81 93 94 107 116 128 137 149 186 187 222 223 243 247 259 260 261 266 272 275 277 297 298 299 312 318 323 356 362 365 370 372 386 413 456 458 493 494 509 517 542 554 570 573 574 582 599 604 606 612 614 616 627 628 642 646 651 679 680 706 719 749 751 773 786 816 818 819 824 832 834 858 867 868 869 885 903 906 918 965 969 986 1012 1030 1036 1049 1056 1058 1085 1089 1124 1127 1138 1163 1179 1184 1189 
113 115 120 121 123 147 152 153 164 231 238 249 280 328 330 368 383 384 394 414 427 429 441 459 489 497 503 505 516 523 524 548 566 575 588 596 613 617 618 635 647 656 675 676 685 689 700 715 716 739 759 762 765 784 808 817 828 836 852 861 894 917 924 932 933 941 975 983 1005 1006 1021 1027 1035 1054 1055 1068 1080 1094 1098 1126 1145 1149 1162 1190 1192 1209 1230 1235 1246 1268 
55 56 83 96 100 133 138 141 145 155 156 167 193 204 244 245 262 281 320 321 376 398 402 412 419 430 431 447 474 476 482 483 530 539 559 563 565 579 605 609 672 699 702 708 742 771 780 804 840 841 843 873 902 911 929 1013 1020 1023 1048 1053 1134 1135 1139 1148 1160 1166 1182 1195 1208 1218 1271 1278 1283 
16 78 161 170 175 192 198 234 257 265 300 348 353 388 407 415 416 418 452 504 511 558 560 581 649 658 660 681 710 750 753 767 770 778 781 789 826 830 846 849 876 904 905 910 928 930 931 950 967 968 984 1081 1091 1092 1115 1116 1142 1153 1154 1183 1224 1231 1232 1273 1281 
28 29 40 90 98 225 233 239 263 264 276 282 331 371 396 410 433 439 440 454 457 471 527 535 546 583 592 623 643 644 691 743 787 793 794 795 839 880 897 923 935 989 991 1050 1061 1067 1072 1073 1101 1136 1144 1180 1197 1199 1227 1228 1255 1258 1259 1276 
77 79 88 118 129 146 191 228 229 251 288 322 342 347 392 397 406 434 472 473 514 537 538 564 584 611 615 639 663 728 761 797 814 947 948 957 1046 1057 1070 1075 1093 1137 1193 1247 1248 1256 
27 91 99 105 106 154 220 226 246 252 305 324 354 355 387 390 426 437 461 499 515 655 729 741 810 916 940 990 1008 1014 1025 1029 1037 1051 1052 1064 1084 1095 1133 1178 1205 1210 1264 1280 
68 86 87 101 109 136 166 188 200 202 205 207 250 256 278 291 325 404 468 512 513 522 529 587 626 690 757 758 798 806 844 877 878 997 1086 1105 1110 1111 1112 1128 1188 1237 1286 
176 184 212 213 283 302 304 310 360 369 382 385 395 462 508 521 549 572 591 602 735 736 763 764 775 777 779 782 783 788 820 838 847 870 925 934 1000 1011 1082 1223 1233 1240 
6 12 21 22 26 43 47 59 306 361 501 696 815 823 833 859 871 882 883 886 961 962 963 978 979 980 1017 1041 1042 1147 1152 1177 1200 1266 
7 114 119 126 172 203 287 308 319 343 374 391 409 455 491 536 686 717 732 755 856 857 895 921 936 946 1024 1118 1130 1159 1185 
10 89 284 285 301 351 442 498 543 610 633 636 648 668 669 677 678 752 769 799 879 992 1016 1031 1117 1161 1213 1239 1244 1251 
84 85 103 177 196 214 215 224 311 366 389 421 425 453 469 479 593 774 809 855 884 901 954 972 981 1026 1107 1108 1176 1277 
9 11 14 15 19 23 25 30 33 37 52 162 178 209 580 597 598 801 900 951 1059 1099 1141 1187 1222 1229 1243 
18 32 189 190 197 270 286 444 463 510 665 724 730 740 835 907 908 959 982 1087 1157 1165 1236 1252 1263 1279 1282 
148 185 240 241 326 327 367 450 460 478 484 630 909 912 960 1040 1062 1083 1172 1173 1174 1175 
258 336 400 401 438 547 640 694 705 737 738 792 827 953 955 970 971 1034 1106 1181 1262 1267 
64 65 66 75 108 267 268 338 540 562 650 754 802 803 811 813 890 937 993 1132 
5 17 20 63 289 290 432 571 600 601 645 695 848 915 1044 1045 1121 1212 
67 171 405 417 449 519 634 704 800 893 896 952 966 988 1063 1071 1146 
4 8 104 201 235 279 381 585 733 734 772 995 996 1018 1215 1221 
135 470 595 688 825 881 926 938 1007 1009 1090 1097 1158 1234 
329 335 532 567 654 674 721 1204 1216 1242 1245 1254 1272 
80 179 180 199 237 293 339 364 477 520 620 865 
206 274 340 341 358 544 726 785 872 1103 1217 1257 
24 271 545 576 673 939 1168 1171 1253 1260 1265 
31 428 776 807 898 899 1069 1140 1167 1170 1270 
316 359 486 657 718 766 821 1122 1214 
451 490 746 853 854 914 1028 1078 1088 
132 664 682 888 889 1114 1123 
142 143 168 169 518 1261 
74 525 697 1038 1201 
3 337 507 994 
631 796 837 1211 
1003 1004 1191 
1060 1104 1120 
