124 139 140 163 329 460 473 474 503 527 528 542 548 554 576 577 617 630 764 805 825 836 845 852 871 887 903 917 1012 1015 1017 1046 1047 1051 1052 1082 1164 1175 1225 1245 1272 
0 1 2 4 5 7 10 12 13 21 22 23 26 37 47 49 74 82 86 113 170 203 308 309 469 571 629 637 898 899 924 983 1137 1147 1229 1246 1273 
142 143 298 299 336 459 493 509 518 553 568 570 599 613 680 682 691 697 701 747 749 772 816 819 846 868 937 949 965 968 977 1001 1022 1028 1087 1189 
43 282 312 410 417 462 514 529 535 592 623 632 649 650 694 787 799 839 865 878 893 907 908 923 935 946 1031 1061 1067 1072 1085 1105 1143 1186 
68 100 150 260 327 346 347 384 386 429 480 484 569 624 683 690 940 1019 1044 1056 1063 1064 1123 1174 1188 1237 1271 1288 
20 24 39 152 171 225 231 296 330 416 621 654 685 781 808 828 831 897 1145 1190 1194 1197 1200 1204 1254 
101 370 373 393 427 447 500 562 606 612 628 675 724 725 730 748 754 759 811 832 896 966 1086 1211 1283 
84 146 177 244 403 530 541 563 566 609 771 837 875 911 927 985 994 1198 1278 
56 138 144 190 204 262 286 375 402 419 565 702 708 752 804 1093 1236 1263 
154 228 250 277 300 648 812 856 890 958 1026 1041 1042 1092 1098 1140 1172 1173 
102 128 185 350 352 367 450 475 478 483 684 731 809 909 1037 1124 1250 
112 125 164 198 205 232 249 256 265 273 278 505 560 678 717 769 
130 153 261 325 545 546 552 585 610 647 992 1002 1039 1258 1259 1276 
184 270 271 274 283 302 337 360 369 380 385 479 572 820 1035 1282 
114 129 134 145 239 272 276 351 583 633 879 880 1161 1185 1187 
137 165 169 179 223 466 467 508 534 557 567 615 969 1218 1260 
208 209 235 236 279 368 383 449 488 625 634 715 920 932 1138 
291 297 306 307 361 377 756 765 800 888 891 892 956 1235 1284 
332 334 357 379 521 581 590 660 712 732 788 843 864 1210 1240 
11 133 157 226 604 605 640 641 655 938 1040 1083 1104 1239 
81 196 364 372 485 524 869 872 942 943 1038 1057 1230 1253 
126 248 436 446 710 745 974 1013 1091 1114 1142 1182 1203 1224 
17 45 50 354 355 454 499 674 744 834 1000 1127 1280 
48 73 77 78 88 117 119 131 148 160 295 507 768 
107 187 813 818 850 851 874 926 1030 1033 1113 1125 1171 
115 159 305 358 359 698 718 738 742 766 964 1160 1257 
61 448 471 602 656 793 794 1079 1097 1202 1227 1255 
94 109 136 178 310 374 382 404 587 626 782 1233 
120 192 233 234 313 580 881 967 991 1062 1136 1199 
28 29 40 98 127 191 224 257 331 366 1193 
36 121 216 242 396 596 614 657 723 785 1100 
465 544 653 779 919 1005 1006 1077 1095 1103 1249 
543 620 622 810 838 918 970 971 1034 1043 1162 
8 18 30 33 52 162 801 900 1059 1141 
65 118 288 537 619 814 922 1088 1247 1248 
70 294 511 792 876 928 984 1010 1024 1130 
95 166 207 324 425 916 954 1099 1191 1265 
155 212 213 342 343 395 439 591 829 1223 
176 326 348 407 412 501 658 687 886 1209 
210 211 318 443 451 457 477 490 575 980 
285 378 668 692 703 783 859 1045 1074 1275 
428 430 458 504 578 666 667 780 975 1167 
16 492 677 757 806 807 1032 1128 1270 
58 123 199 344 456 489 822 905 1117 
67 168 408 409 470 536 774 855 1277 
92 267 390 399 424 540 555 1150 1285 
197 304 323 603 652 955 979 1126 1184 
526 662 720 721 821 1129 1181 1241 1242 
59 175 316 317 494 516 1153 1192 
76 222 418 533 739 885 941 1196 
220 340 341 437 525 728 824 1178 
251 280 497 635 1016 1023 1080 1268 
281 659 770 815 936 973 993 1183 
320 797 798 848 884 1120 1152 1176 
532 538 639 663 760 866 1109 1151 
83 141 156 245 363 482 1166 
106 122 255 586 719 1071 1269 
116 149 275 531 642 755 1049 
167 400 517 582 588 858 913 
174 186 243 266 356 786 1116 
189 247 301 873 988 1058 1146 
289 290 432 513 519 695 1036 
365 627 751 767 986 987 1081 
506 601 669 686 863 1020 1208 
761 775 776 784 894 904 1011 
46 321 345 707 930 931 
57 238 491 1076 1118 1274 
60 388 394 853 914 1078 
64 371 481 611 963 1060 
110 111 303 729 1102 1238 
158 349 643 644 817 1021 
314 438 510 735 982 1287 
376 431 579 594 1054 1195 
387 464 515 861 862 1264 
392 558 989 1073 1132 1221 
3 6 41 1131 1266 
27 217 472 1066 1212 
31 32 105 773 1119 
35 173 202 229 997 
69 319 857 921 1177 
79 80 96 183 339 
87 200 476 522 976 
90 362 433 539 726 
91 237 293 389 1108 
181 777 951 952 1222 
218 246 901 939 1216 
227 253 353 704 705 
264 487 841 1053 1122 
268 700 1050 1075 1101 
269 406 1070 1111 1215 
284 789 790 844 1096 
411 486 574 679 902 
549 706 709 1163 1179 
736 763 915 925 934 
882 883 978 1155 1156 
14 85 161 646 
19 66 108 338 
38 89 97 556 
42 252 693 957 
53 959 1048 1279 
71 455 688 762 
72 435 716 877 
75 259 322 867 
99 254 1084 1148 
151 421 1157 1251 
180 315 520 1149 
182 263 595 1226 
188 512 651 1286 
194 195 796 996 
201 696 823 833 
214 215 405 593 
292 778 849 1009 
328 636 676 1027 
333 496 910 1115 
381 413 711 1018 
415 827 1106 1154 
420 616 1004 1007 
498 670 671 830 
502 713 714 1090 
573 737 1214 1267 
618 689 727 933 
758 953 1165 1252 
802 803 847 870 
906 961 962 1159 
1069 1089 1170 1217 
34 103 219 
51 598 1243 
54 444 445 
55 287 895 
63 135 397 
93 258 1262 
147 981 1014 
172 972 1256 
193 672 673 
206 452 1234 
230 453 1112 
391 434 564 
398 440 995 
401 463 547 
441 442 1068 
461 854 1133 
551 743 1228 
559 912 1065 
607 608 746 
638 753 1205 
722 1107 1144 
733 734 1281 
791 835 1029 
1134 1135 1139 
1201 1213 1244 
