0 36 48 49 60 61 64 65 66 69 70 73 75 82 95 110 111 117 131 134 144 150 151 157 158 159 160 174 183 195 210 216 217 227 242 248 294 295 296 313 317 333 338 345 349 350 352 363 379 380 390 399 411 421 424 446 464 465 475 480 481 485 488 495 500 506 526 531 533 551 561 569 577 578 589 594 603 614 621 622 624 625 637 638 652 653 661 671 684 687 692 693 698 703 707 711 713 714 724 725 731 744 745 747 790 791 792 807 812 822 845 860 866 869 882 883 887 913 919 922 942 943 967 974 976 978 1001 1010 1015 1022 1043 1045 1047 1066 1074 1077 1079 1096 1098 1102 1129 1138 1155 1156 1164 1169 1186 1196 1210 1225 1241 1249 1270 1275 1288 
1 2 3 6 17 34 35 38 39 41 42 53 54 63 71 92 97 102 119 124 127 130 139 140 163 165 173 181 194 214 215 218 219 221 230 232 252 253 254 269 273 292 307 314 315 332 334 337 343 344 346 357 373 377 378 393 397 408 409 420 435 436 448 453 491 492 496 502 507 528 536 550 552 553 555 556 557 562 568 590 593 607 608 619 632 641 659 662 664 666 667 699 701 712 723 732 748 756 757 760 777 805 806 831 844 856 857 862 863 864 891 892 921 936 937 944 945 948 949 952 956 973 977 994 996 1019 1032 1039 1065 1076 1105 1114 1118 1128 1131 1143 1150 1170 1202 1203 1212 1238 1250 1266 1274 1284 1285 1287 
44 45 46 50 51 57 72 76 81 86 93 94 107 116 128 137 142 143 149 166 168 169 186 187 200 207 234 243 247 259 260 261 266 272 275 297 298 299 312 318 323 356 362 365 370 372 386 413 427 456 458 466 493 494 509 517 518 522 524 542 554 570 573 574 582 599 604 606 612 616 627 628 642 646 651 679 680 706 709 719 749 751 767 768 773 778 786 796 811 818 819 832 834 851 858 906 918 950 965 969 975 986 987 1007 1012 1036 1049 1056 1058 1081 1085 1089 1119 1124 1127 1163 1179 1184 1189 1214 1230 1261 
5 7 12 20 21 22 26 43 47 56 59 83 96 100 114 133 138 141 145 148 156 167 185 188 193 203 204 240 244 245 262 281 308 326 367 375 376 398 402 412 419 430 431 450 468 476 478 482 483 501 503 530 541 563 565 566 571 579 600 601 605 609 630 631 672 673 686 690 702 708 742 771 780 804 815 833 837 843 873 877 878 886 902 903 909 911 927 983 985 1017 1023 1024 1040 1041 1042 1048 1083 1110 1130 1147 1152 1160 1166 1185 1195 1198 1200 1211 1271 1278 1286 
58 109 113 120 121 123 152 153 164 199 231 236 238 249 280 330 368 383 384 394 404 429 459 460 477 489 497 505 516 520 548 575 588 596 613 617 618 626 635 656 685 689 700 715 716 727 739 759 762 765 808 816 817 828 836 848 852 861 867 868 871 917 920 924 932 933 941 1005 1006 1021 1054 1055 1062 1080 1094 1126 1145 1149 1177 1190 1192 1235 1246 1268 
62 68 77 79 88 101 118 129 146 202 205 212 228 229 250 251 277 278 288 322 342 347 392 406 434 473 512 514 529 537 538 564 584 611 615 639 645 722 728 761 774 797 814 957 997 1070 1075 1086 1093 1107 1121 1137 1188 1237 1247 1248 1277 
16 78 112 161 170 175 198 222 257 265 300 348 353 388 407 415 416 418 445 452 511 558 560 581 658 660 710 717 750 753 770 781 789 830 876 885 904 905 928 984 1091 1092 1116 1153 1183 1224 1273 
80 179 180 184 206 274 283 293 302 325 339 340 341 360 364 369 385 439 527 544 545 546 572 591 620 647 758 785 793 794 820 824 829 865 872 947 1035 1103 1111 1112 1223 1231 1232 1258 1259 1276 
10 89 284 285 328 351 441 442 474 543 610 633 636 648 650 668 669 676 677 678 752 754 769 799 842 879 890 929 958 961 962 963 992 1016 1020 1027 1031 1068 1117 1161 1208 1213 1239 1244 1251 
28 29 40 98 171 225 239 276 282 291 331 371 396 410 417 471 535 583 592 597 623 649 681 691 743 787 839 880 893 897 910 923 935 968 1050 1063 1067 1072 1073 1101 1187 1197 1227 1228 1255 
258 270 306 336 361 400 414 438 532 654 663 674 694 720 721 737 738 823 827 953 955 970 971 1034 1046 1106 1109 1151 1154 1165 1181 1204 1242 1252 1254 1262 1267 1282 
136 176 213 303 304 310 382 395 401 403 462 521 547 549 587 602 683 705 764 779 782 783 788 838 859 874 875 979 1000 1082 1113 1125 1173 1233 1240 
24 105 106 122 154 255 271 305 324 354 387 426 461 515 576 586 729 741 916 939 1002 1008 1037 1051 1052 1115 1133 1168 1253 1260 1264 1265 1269 
4 8 31 104 192 201 233 235 279 381 454 585 696 733 734 772 982 991 995 1018 1100 1136 1140 1144 1180 1199 1215 1221 1281 
13 18 32 189 190 197 286 444 463 469 479 510 665 730 740 776 898 899 907 908 959 981 1087 1157 1236 1263 1279 
172 208 209 289 290 309 432 498 513 519 629 634 670 695 755 810 835 846 930 931 972 1029 1044 1099 1256 
9 11 14 15 19 23 25 30 33 37 52 162 178 580 598 801 826 900 951 1059 1141 1222 1229 1243 
90 155 182 263 264 433 440 467 486 487 539 643 644 821 840 841 964 1053 1122 1134 1135 1139 1194 1226 
91 115 237 241 320 321 327 389 447 484 675 912 940 960 1013 1064 1108 1172 1174 1175 1182 1283 
329 508 567 735 736 763 775 795 802 813 847 870 915 925 934 1011 1132 1216 1245 1272 
55 125 126 223 256 287 523 534 784 798 849 894 895 1142 1159 1162 1209 1218 
84 85 103 177 196 224 311 366 425 809 855 884 901 954 1026 1176 
211 443 451 457 490 746 853 854 914 980 1028 1078 1088 1206 1207 
470 559 595 850 881 926 1009 1030 1033 1148 1158 1171 1234 
67 301 405 449 704 800 896 966 988 1071 1146 
99 147 220 226 355 437 499 1014 1084 1178 1280 
108 267 268 540 803 993 1060 1104 1120 
191 319 374 391 455 472 946 1057 1193 
316 358 359 657 718 726 766 1217 1257 
135 640 655 688 825 938 1090 1097 
27 246 335 990 1025 1095 1205 
74 525 697 989 1038 1061 1201 
87 428 504 1069 1167 
132 682 888 889 1123 
1003 1004 1191 
