55 56 138 144 146 156 177 190 204 251 262 280 286 375 402 419 530 563 565 609 635 699 702 708 752 771 804 911 985 1016 1023 1080 1093 1166 1236 1251 1256 1263 1268 
101 329 330 370 373 393 427 447 500 503 562 606 612 724 725 730 748 754 759 811 832 896 897 919 966 1019 1086 1123 1211 1245 1272 1283 
115 124 139 163 460 527 542 548 554 577 617 630 637 698 727 764 814 836 845 852 871 887 922 937 972 1012 1047 1051 1052 1082 1164 1225 
0 1 2 4 7 10 12 21 22 23 26 36 37 58 74 147 242 285 294 469 498 596 614 633 657 723 981 1017 1229 
65 130 152 225 231 296 325 585 618 619 621 654 685 808 828 831 1002 1088 1145 1190 1194 1197 1204 1254 1258 1259 1276 
264 282 410 417 497 514 519 529 535 592 623 632 649 650 694 787 839 907 908 923 946 1031 1061 1063 1067 1143 
459 613 680 682 747 749 816 819 846 868 869 903 965 968 975 977 1001 1028 1055 1189 
17 45 50 354 355 390 415 416 454 499 674 729 744 781 823 834 1127 1280 
142 143 298 299 336 350 352 493 509 518 568 599 691 697 772 949 1037 1087 
13 122 297 306 307 377 586 701 756 765 800 891 892 898 899 1235 1284 
48 73 77 78 88 117 119 131 148 160 295 337 507 768 994 
126 248 436 446 664 710 745 931 974 1013 1091 1114 1142 1182 1203 
332 334 357 379 521 590 660 732 736 788 842 843 864 929 1240 
81 196 311 364 372 485 524 872 942 943 1038 1057 1230 1253 
90 91 226 237 293 362 389 433 440 726 792 865 1072 1108 
166 207 324 425 466 665 740 741 916 954 969 1029 1191 1265 
35 129 173 202 220 229 255 365 428 728 957 997 1269 
63 134 135 239 291 333 361 496 583 597 681 910 1115 
94 109 136 188 374 382 404 512 587 651 1020 1208 1286 
11 133 157 604 605 640 641 655 938 1040 1083 1104 
70 391 511 802 803 876 928 984 1010 1024 1122 1130 
113 244 541 629 690 791 835 927 983 1137 1246 1278 
120 192 233 234 313 580 881 967 991 1062 1136 1199 
184 270 271 283 302 360 369 385 572 820 1035 1282 
221 301 388 761 775 776 784 894 1011 1058 1098 1224 
543 620 622 810 838 917 918 970 971 1034 1043 1162 
76 150 327 347 384 429 484 940 1044 1064 1174 
112 164 249 265 273 505 678 717 721 769 1242 
154 228 300 648 812 856 921 1092 1140 1172 1173 
8 18 30 33 52 162 801 900 1059 1141 
16 31 492 677 757 806 807 1032 1128 1270 
83 141 245 363 420 482 616 1004 1007 1022 
102 185 367 450 475 478 483 684 909 1250 
125 172 198 205 232 256 278 287 560 575 
222 386 418 569 624 739 885 1153 1196 1288 
82 86 170 203 308 309 561 924 1273 
110 303 538 639 663 1102 1109 1151 1238 
140 467 473 474 487 841 1046 1053 1175 
159 235 236 279 305 766 920 964 1160 
197 304 323 603 652 955 979 1126 1184 
210 211 318 443 451 457 477 490 980 
28 40 127 145 257 272 331 366 
47 49 95 571 1099 1147 1163 1179 
59 216 316 317 494 516 1100 1192 
92 267 399 424 540 555 1150 1285 
194 195 553 584 631 796 837 996 
212 213 342 343 395 439 591 1223 
471 656 689 793 794 933 1227 1255 
3 6 41 1041 1042 1131 1266 
107 673 813 926 1030 1033 1171 
111 118 288 378 703 1247 1248 
116 149 275 531 642 755 1049 
128 281 414 607 809 1124 1158 
132 227 240 253 353 704 705 
174 186 243 266 356 786 1116 
181 461 854 951 952 1133 1222 
208 250 368 383 488 715 932 
209 392 449 625 634 1132 1221 
380 668 692 783 859 1074 1275 
659 770 895 936 973 993 1183 
798 848 884 1045 1120 1152 1176 
27 217 472 1066 1180 1212 
46 321 345 707 1155 1156 
61 448 602 1079 1097 1202 
114 276 277 880 1021 1185 
137 289 290 432 513 1036 
176 326 348 407 658 687 
214 215 230 405 453 593 
218 246 901 939 1205 1216 
269 406 904 1070 1111 1215 
314 438 510 735 982 1287 
328 351 636 799 879 1161 
340 341 437 525 824 1178 
376 431 579 594 1054 1195 
411 486 574 679 902 1015 
653 779 1005 1006 1077 1095 
751 767 778 986 1081 1233 
763 777 795 915 925 934 
29 98 551 743 1228 
57 238 491 1076 1274 
60 394 853 914 1078 
68 260 480 1188 1237 
71 455 688 762 1056 
75 259 322 570 867 
79 80 96 183 339 
158 349 643 644 817 
180 199 520 905 1117 
182 263 539 595 1226 
268 700 1050 1075 1101 
284 789 790 844 1096 
358 359 718 785 1257 
371 481 611 963 1121 
381 413 711 1018 1119 
506 601 669 686 863 
566 675 676 1027 1198 
722 774 1107 1144 1277 
850 851 874 1113 1125 
906 961 962 1138 1159 
5 20 100 1271 
14 84 161 646 
38 89 97 556 
43 312 893 1085 
53 959 1048 1279 
54 175 444 445 
69 319 857 1177 
72 435 716 877 
99 254 1084 1148 
121 396 523 661 
151 421 987 1157 
167 400 517 582 
168 479 628 855 
178 310 626 782 
200 522 549 706 
206 274 452 1234 
247 731 873 1146 
409 470 536 1118 
458 578 666 1167 
464 515 861 862 
465 544 1103 1249 
476 667 780 976 
495 600 645 695 
501 815 886 1112 
502 713 714 1090 
526 720 1209 1241 
528 576 805 825 
545 552 647 992 
588 858 913 1014 
662 821 1129 1181 
758 953 1165 1252 
882 883 978 1200 
888 889 956 1169 
1201 1213 1239 1244 
19 66 108 
24 335 1025 
25 426 1187 
32 105 773 
34 103 219 
39 171 1071 
42 252 693 
51 598 1243 
62 960 1094 
64 338 1060 
87 430 504 
93 258 1262 
123 344 456 
165 179 615 
201 696 833 
223 534 1218 
292 849 1009 
320 537 797 
387 1210 1264 
397 434 564 
401 463 547 
403 683 875 
412 468 1110 
441 442 1068 
462 847 870 
508 567 1260 
532 760 866 
533 709 941 
546 610 1039 
558 989 1073 
559 912 1065 
573 1214 1267 
670 671 830 
733 734 1281 
737 738 742 
827 1106 1154 
890 958 1026 
1134 1135 1139 
