24 68 100 150 184 260 270 271 274 283 302 327 337 346 347 360 369 380 384 385 386 403 429 479 480 484 569 572 624 645 683 690 820 875 940 1019 1035 1044 1056 1064 1123 1174 1188 1237 1271 1282 1288 
43 282 312 410 417 462 514 529 535 592 623 632 649 650 787 799 839 878 893 908 923 935 946 1008 1031 1061 1063 1067 1072 1085 1105 1143 1168 1186 
20 124 139 140 163 473 527 542 554 577 617 630 764 836 845 852 871 887 903 932 1012 1015 1017 1046 1047 1051 1052 1082 1164 1175 1225 
5 7 22 47 49 82 86 113 142 143 170 203 298 299 308 309 509 571 629 637 791 835 924 983 1029 1095 1137 1147 1246 1273 
56 138 144 146 190 204 251 262 280 286 402 419 497 565 609 635 708 752 771 804 1016 1023 1080 1236 1263 1268 
39 65 130 152 171 225 231 296 619 621 654 685 781 808 828 831 897 1088 1145 1190 1194 1197 1200 1204 1254 
31 32 102 105 128 185 350 352 367 450 475 478 483 684 731 773 809 909 994 1037 1119 1124 1250 
101 373 500 545 546 562 610 612 628 647 759 811 896 966 992 1086 1211 
459 553 613 680 682 747 749 816 819 846 868 965 968 977 1001 1028 1189 
0 1 2 4 10 12 13 21 23 26 37 74 469 898 899 1229 
94 109 136 178 310 374 382 404 460 474 548 587 626 782 1020 1208 
25 95 166 207 324 354 355 425 426 729 916 954 1099 1102 1191 
114 129 134 145 239 272 276 351 583 633 879 880 1161 1185 1187 
137 165 169 179 223 466 467 508 534 557 567 615 969 1218 1260 
332 334 357 379 521 581 590 660 712 732 788 843 864 1210 1240 
336 493 568 570 599 691 694 697 701 772 919 937 949 1022 1087 
154 300 648 812 890 958 1026 1041 1042 1092 1098 1140 1172 1173 
17 45 50 415 416 454 499 674 744 834 1000 1127 1280 
48 73 77 78 88 117 119 131 148 160 295 507 768 
107 187 813 818 850 851 874 926 1030 1033 1113 1125 1171 
175 176 326 348 407 412 501 658 687 710 886 1209 1224 
291 297 306 307 361 377 756 765 800 891 892 1235 1284 
61 448 471 602 656 793 794 1079 1097 1202 1227 1255 
126 248 436 446 745 974 1013 1091 1114 1142 1182 1203 
36 121 216 242 396 596 614 657 723 785 1100 
46 321 345 653 707 779 930 931 1005 1006 1077 
90 91 237 293 362 389 433 539 726 865 1108 
8 18 30 33 52 162 801 900 1059 1141 
70 294 511 792 876 928 984 1010 1024 1130 
120 192 233 313 881 967 991 1062 1136 1199 
189 247 301 873 951 988 989 1058 1146 1222 
197 304 323 603 652 955 979 1121 1126 1184 
208 235 236 279 368 383 488 715 920 1138 
210 211 318 443 451 457 477 490 575 980 
244 530 541 563 566 837 927 985 1198 1278 
285 378 668 692 703 783 859 1045 1074 1275 
428 430 458 504 578 666 667 780 975 1167 
518 526 662 720 721 821 1129 1181 1241 1242 
620 622 810 917 918 970 971 1034 1043 1162 
16 492 677 757 806 807 1032 1128 1270 
58 123 199 344 456 489 822 905 1117 
92 267 390 399 424 540 555 1150 1285 
115 159 305 698 738 742 766 964 1160 
125 164 198 249 253 273 353 505 560 
320 537 797 798 848 884 1120 1152 1176 
365 627 751 767 778 986 987 1081 1233 
35 173 202 220 229 728 957 997 
59 441 442 494 516 1068 1153 1192 
174 186 243 266 356 449 786 1116 
209 392 558 625 634 1073 1132 1221 
393 427 447 606 675 748 832 1283 
532 538 639 663 760 866 1109 1151 
11 157 226 641 1040 1083 1104 
81 364 372 524 869 942 943 
83 141 156 245 363 482 1166 
116 149 275 531 642 755 1049 
167 400 517 582 588 858 913 
281 659 770 815 936 973 993 
289 290 432 513 519 695 1036 
340 341 437 525 824 1178 1183 
465 543 544 838 1103 1249 1265 
736 763 795 915 925 934 1180 
761 775 776 784 894 904 1011 
28 40 127 191 366 1193 
57 238 491 1076 1118 1274 
60 388 394 853 914 1078 
64 371 481 611 963 1060 
76 222 418 739 885 1196 
118 288 814 922 1247 1248 
122 255 586 1002 1071 1269 
133 604 605 640 655 938 
158 349 643 644 817 1021 
196 485 872 1038 1057 1230 
218 246 901 939 1216 1253 
314 438 510 735 982 1287 
376 431 579 594 1054 1195 
387 464 515 861 862 1264 
3 6 41 1131 1266 
27 217 472 1066 1212 
29 98 224 257 331 
34 103 168 219 855 
67 408 409 470 536 
79 80 96 183 339 
87 200 476 522 976 
112 265 678 717 769 
155 439 591 829 1223 
212 213 342 343 395 
264 487 841 1053 1122 
268 700 1050 1075 1101 
269 406 1070 1111 1215 
284 789 790 844 1096 
325 585 1258 1259 1276 
329 330 503 1245 1272 
411 486 574 679 902 
506 601 669 686 863 
722 774 1107 1144 1277 
882 883 978 1155 1156 
19 66 108 338 
38 89 97 556 
53 959 1048 1279 
71 455 688 762 
72 435 716 877 
75 259 322 867 
84 85 177 911 
99 254 1084 1148 
110 111 303 1238 
151 421 1157 1251 
180 315 520 1149 
182 263 595 1226 
188 512 651 1286 
194 195 796 996 
201 696 823 833 
205 232 256 278 
214 215 405 593 
228 856 857 921 
316 317 533 941 
328 636 676 1027 
333 496 910 1115 
358 359 718 1257 
381 413 711 1018 
420 616 1004 1007 
461 580 854 1133 
498 670 671 830 
502 713 714 1090 
528 576 805 825 
573 737 1214 1267 
618 689 727 933 
758 953 1165 1252 
802 803 847 870 
888 889 956 1169 
906 961 962 1159 
1069 1089 1170 1217 
1201 1213 1239 1244 
14 161 646 
42 252 693 
51 598 1243 
54 444 445 
55 287 895 
63 135 397 
69 319 1177 
93 258 1262 
147 981 1014 
153 261 907 
172 972 1256 
181 777 952 
193 672 673 
206 452 1234 
227 704 705 
230 453 1112 
234 550 950 
292 849 1009 
375 702 1093 
391 434 564 
398 440 995 
401 463 547 
549 706 709 
551 743 1228 
559 912 1065 
607 608 746 
638 753 1205 
724 725 730 
733 734 1281 
827 1106 1154 
1134 1135 1139 
