0 36 49 60 61 69 70 73 82 110 111 117 131 134 144 150 151 157 158 159 160 174 182 183 195 210 216 217 227 242 248 294 295 296 313 317 333 345 349 350 352 363 375 379 380 390 399 411 424 446 464 465 475 480 481 485 488 495 500 506 526 530 531 533 541 545 551 561 563 566 569 577 578 589 594 603 621 622 624 625 629 631 637 638 647 652 653 656 661 671 684 687 692 693 698 703 707 711 713 714 725 744 745 747 768 790 792 812 822 837 845 860 866 869 887 913 919 922 927 942 943 974 976 985 1001 1010 1015 1022 1043 1045 1047 1066 1074 1077 1079 1096 1100 1102 1129 1155 1156 1164 1169 1171 1186 1196 1198 1210 1211 1225 1226 1241 1249 1275 1288 
1 2 34 35 38 39 41 42 53 54 71 72 92 97 102 112 124 125 127 130 139 140 163 165 173 181 194 211 218 219 221 230 232 253 254 269 273 292 307 314 315 332 334 344 346 357 373 377 378 393 403 408 420 435 436 443 448 466 492 496 502 528 550 552 553 555 556 557 568 590 607 608 619 632 641 659 662 666 667 683 699 701 723 728 748 756 760 777 805 831 844 859 862 863 864 891 892 944 945 949 952 956 957 969 973 977 979 980 1019 1032 1039 1065 1076 1105 1131 1143 1150 1202 1203 1206 1207 1238 1250 1274 1284 1285 1287 
44 45 46 50 51 57 76 81 93 94 107 116 137 149 186 187 222 223 243 247 259 260 261 266 272 275 297 298 299 312 318 323 356 362 365 370 372 386 413 456 458 493 494 503 509 517 542 554 570 573 574 582 599 604 606 612 614 616 627 628 642 646 651 679 680 706 709 719 731 749 751 773 786 796 811 816 818 819 824 832 834 851 858 868 885 903 906 918 965 975 986 987 1012 1036 1049 1056 1058 1085 1089 1119 1127 1138 1163 1179 1184 1189 
55 56 83 96 100 128 133 138 141 145 148 155 156 167 184 185 193 204 240 241 244 245 262 281 283 287 302 326 327 360 367 369 376 385 398 402 412 419 430 431 450 460 476 478 482 483 484 539 565 572 579 605 609 630 672 673 702 708 742 771 780 804 815 820 840 841 843 873 902 909 911 912 960 1007 1023 1035 1040 1048 1062 1083 1124 1160 1166 1172 1173 1174 1175 1195 1271 1278 
58 113 120 121 123 152 153 164 199 231 236 238 249 280 291 330 368 383 384 394 427 429 459 477 489 497 505 516 548 575 588 596 613 617 618 635 685 689 700 715 716 727 739 759 762 765 808 817 828 836 848 852 861 867 917 920 924 932 933 941 1005 1006 1021 1054 1055 1064 1080 1094 1126 1145 1149 1152 1190 1192 1235 1246 1268 
16 17 20 63 78 161 170 175 192 198 234 257 265 300 348 353 388 397 407 415 416 418 445 452 511 558 560 581 597 658 660 681 710 750 753 767 770 778 781 789 826 830 849 876 904 905 928 950 967 984 1081 1091 1092 1115 1116 1142 1153 1154 1183 1212 1224 1231 1232 1273 
28 29 40 98 171 225 233 239 276 282 331 371 396 410 417 440 454 457 471 508 535 583 592 623 649 691 735 736 743 763 787 795 839 880 893 897 910 915 923 925 934 935 968 991 1050 1061 1063 1067 1072 1073 1101 1136 1144 1180 1187 1197 1199 1227 1228 1255 
86 87 103 109 166 200 206 207 224 274 325 389 404 409 421 439 468 522 524 527 536 544 546 626 758 774 785 793 794 809 829 855 872 884 901 1026 1103 1107 1108 1110 1111 1112 1176 1230 1258 1259 1276 1277 
62 77 79 88 118 129 146 191 228 229 251 288 322 342 347 392 406 434 472 473 514 537 538 564 584 611 615 639 645 722 761 797 814 947 948 1057 1070 1075 1093 1121 1137 1193 1247 1248 
3 5 6 7 10 12 13 21 22 26 43 47 114 147 203 208 308 309 328 337 414 469 479 507 571 600 601 686 712 732 882 883 978 981 983 994 1014 1017 1147 1185 1200 1209 1266 
27 48 91 95 105 106 122 154 214 215 226 246 252 255 305 324 354 387 426 453 461 515 586 593 729 741 916 940 990 1002 1008 1025 1037 1051 1052 1095 1133 1205 1264 1269 
258 306 335 336 361 400 401 438 532 547 654 674 694 705 720 721 737 738 823 827 953 955 970 971 1034 1106 1109 1151 1181 1204 1242 1254 1262 1267 
136 176 212 213 303 304 310 382 395 462 521 549 587 591 602 764 779 782 783 788 838 850 874 875 1000 1030 1033 1082 1113 1125 1223 1233 1240 
18 32 189 190 197 270 286 444 463 510 663 665 724 730 740 807 835 907 908 959 982 1046 1087 1157 1165 1236 1252 1263 1270 1279 1282 
84 85 99 172 177 196 220 311 355 366 425 437 499 670 755 791 810 846 930 931 954 972 1029 1084 1178 1256 1280 
9 11 14 15 19 23 25 30 33 37 52 162 178 209 580 598 801 900 951 1059 1099 1141 1222 1229 1243 
89 284 285 301 351 441 442 498 610 633 648 650 668 677 678 754 769 879 890 1031 1068 1117 1161 
4 8 104 201 235 279 381 585 696 733 734 772 995 996 1018 1215 1221 1281 
68 101 188 202 205 250 277 278 512 529 690 877 878 997 1086 1188 1237 1286 
108 267 268 329 540 567 775 802 803 813 847 870 993 1011 1132 1216 1245 1272 
126 256 523 534 717 784 798 842 894 895 958 1024 1098 1130 1159 1162 1218 
90 263 264 433 467 486 487 643 644 757 806 821 964 1122 1128 
64 65 66 75 132 338 562 664 682 888 889 937 1114 1123 
31 316 358 359 657 718 726 766 1140 1170 1214 1217 1257 
115 320 321 447 675 1013 1053 1134 1135 1139 1182 1194 1283 
119 319 343 374 391 455 491 856 857 921 936 946 1118 
543 636 676 752 799 992 1016 1027 1213 1239 1244 1251 
59 501 833 871 886 961 962 963 1041 1042 1177 
67 405 449 704 800 896 966 988 1071 1146 
80 179 180 237 293 339 364 520 620 865 
451 490 746 853 854 914 1028 1078 1088 
470 559 595 881 926 1009 1148 1158 1234 
24 271 576 939 1168 1253 1260 1265 
74 340 341 525 697 989 1038 1201 
135 640 655 688 825 938 1090 1097 
289 290 432 513 519 634 695 1044 
428 504 776 898 899 1069 1167 
142 143 168 169 518 1261 
474 669 929 1020 1208 
1003 1004 1191 
1060 1104 1120 
