0 60 61 69 70 73 82 131 134 144 150 151 157 158 159 160 174 195 210 248 295 333 345 349 350 352 380 411 421 446 464 475 485 488 500 531 545 551 561 569 577 578 594 603 621 624 629 637 638 647 653 656 661 687 692 693 707 711 724 725 731 747 791 845 860 913 922 974 1001 1045 1047 1066 1074 1077 1079 1138 1186 1225 1241 1275 1288 
44 45 46 50 51 57 72 76 81 93 94 116 137 142 143 149 168 169 261 272 275 297 298 299 318 362 413 427 458 466 493 494 509 517 518 554 574 582 599 604 606 612 616 642 646 679 680 719 749 768 773 796 832 906 918 919 965 969 975 1007 1015 1036 1049 1089 1119 1127 1184 1189 1261 
1 6 34 35 38 39 41 53 54 71 97 102 112 124 127 130 139 140 163 165 211 214 215 218 219 230 252 273 292 332 334 393 453 556 557 568 593 619 632 659 701 723 748 805 831 948 949 973 1131 1143 1238 1250 1266 
86 109 113 152 153 200 231 368 383 384 404 459 489 516 522 524 596 613 617 626 689 700 715 716 739 762 808 816 828 836 848 852 867 868 871 917 932 1005 1006 1152 1177 1190 1192 1230 1246 
5 20 96 100 145 156 188 244 245 262 375 398 402 419 503 530 541 563 565 566 609 631 690 702 771 804 837 843 873 877 878 911 927 983 985 1023 1166 1198 1211 1271 1278 1286 
110 115 183 216 217 227 242 294 313 379 390 399 409 424 465 495 526 536 622 625 652 671 713 714 745 792 807 812 822 866 887 967 1010 1043 1098 1102 1164 1196 1210 1249 1270 
42 92 173 314 315 343 344 377 378 435 436 448 496 550 552 555 590 641 662 712 728 732 856 857 862 863 864 921 956 957 1039 1076 1202 1203 1274 1285 1287 
56 83 128 138 141 148 167 204 240 241 281 326 327 367 412 450 482 483 484 742 780 903 909 1124 1160 1172 1173 1174 1175 
107 186 243 259 260 266 312 323 356 365 370 386 456 542 570 573 651 706 709 786 834 851 986 987 1056 1163 1179 1214 
170 198 265 300 353 388 407 415 416 452 511 558 581 753 770 781 789 790 844 876 928 984 1091 1092 1096 1105 1116 1273 
105 106 122 166 207 255 305 324 354 426 461 515 586 729 741 916 1002 1008 1037 1051 1052 1115 1133 1269 
9 11 14 15 23 25 30 33 37 52 162 801 826 900 951 1059 1141 1222 1229 
181 254 307 373 408 420 492 502 756 757 777 806 891 892 952 1032 1128 1170 1284 
77 79 118 129 146 228 229 251 288 322 347 473 514 615 761 1093 1247 1248 
238 280 394 429 497 635 759 817 861 924 933 941 1021 1080 1126 1145 1149 1268 
64 65 66 75 317 338 346 363 443 480 481 533 589 614 744 1019 1022 
3 184 283 302 337 360 369 385 507 572 820 994 1035 
40 282 371 396 410 535 592 691 787 893 1067 1072 1073 
36 111 296 506 698 703 869 942 943 976 1129 1169 
90 182 263 264 433 440 467 487 539 1053 1194 1226 
175 222 257 348 418 445 658 660 750 885 1153 1183 
18 189 286 444 510 730 835 982 1087 1157 1263 
258 336 414 694 720 721 970 971 1034 1242 1262 
49 392 406 434 560 564 611 1070 1075 1137 
58 120 121 123 164 236 618 727 920 1054 
98 225 239 276 331 583 880 897 1187 1197 
99 220 226 355 437 499 655 1084 1178 1280 
136 304 382 462 549 587 764 788 1000 1240 
325 546 758 793 794 1111 1112 1258 1259 1276 
7 22 114 203 308 686 1024 1130 1185 
89 284 441 442 648 677 678 769 1068 
108 267 268 540 567 803 813 993 1132 
190 463 665 740 907 908 959 1236 1279 
212 213 303 395 591 602 779 838 1223 
62 537 538 584 639 722 797 814 
126 523 717 784 894 895 1159 1162 
192 457 490 795 991 1100 1180 1199 
320 321 447 476 675 1013 1182 1283 
328 543 636 676 752 1016 1027 1251 
4 104 201 381 454 696 1018 
176 310 521 782 783 1082 1233 
270 663 953 1046 1165 1252 1282 
316 358 359 657 718 766 1257 
16 24 27 271 335 1025 
28 29 743 1050 1101 1228 
84 177 311 366 425 954 
85 224 809 884 901 1176 
91 237 389 940 1064 1108 
208 209 309 810 1029 1099 
289 290 432 513 695 1044 
576 939 1168 1253 1260 1265 
47 833 1041 1042 1147 
68 512 529 1188 1237 
87 428 504 1069 1167 
101 250 277 1085 1086 
132 682 888 889 1123 
179 293 364 520 865 
185 478 630 1040 1083 
301 800 988 1071 1146 
329 1012 1216 1245 1272 
372 627 628 811 858 
376 430 431 579 1195 
400 640 738 955 1181 
470 595 1009 1158 1234 
474 669 929 1020 1208 
498 670 846 930 931 
623 839 923 935 1061 
736 763 915 925 934 
775 802 847 870 1011 
8 772 995 1221 
13 776 898 899 
17 63 397 1212 
21 26 43 1017 
67 704 896 966 
80 180 339 620 
119 491 936 1118 
172 755 972 1256 
191 472 1057 1193 
194 553 977 996 
202 205 278 997 
206 274 872 947 
246 990 1095 1205 
253 269 666 667 
341 544 785 1103 
357 607 608 760 
403 683 875 1125 
505 548 575 588 
525 697 989 1201 
562 664 937 1114 
654 674 1204 1254 
733 734 1215 1281 
751 767 778 1081 
850 874 1033 1113 
853 854 1078 1088 
10 351 633 
19 598 1243 
32 196 197 
78 161 830 
103 855 1026 
133 605 708 
135 688 938 
154 387 1264 
155 840 841 
171 417 1063 
187 818 819 
193 672 673 
223 534 1218 
232 1065 1150 
233 1136 1144 
235 279 585 
249 765 1235 
291 468 1110 
306 361 823 
374 455 946 
401 547 705 
438 737 1267 
439 527 829 
469 479 981 
471 1227 1255 
486 821 1122 
532 1109 1151 
571 600 601 
643 644 964 
649 910 968 
650 754 890 
774 1107 1277 
825 1090 1097 
827 1106 1154 
859 979 980 
879 1117 1161 
882 883 978 
961 962 963 
1003 1004 1191 
1060 1104 1120 
1134 1135 1139 
1213 1239 1244 
