0 60 61 64 65 69 70 73 117 131 144 150 151 157 158 159 160 174 195 248 295 317 345 349 350 352 363 380 421 446 464 475 480 481 485 500 531 551 561 577 578 589 594 603 621 624 637 638 653 661 684 687 692 693 698 707 711 724 725 731 744 747 791 845 860 913 919 922 974 1001 1015 1022 1045 1047 1074 1077 1079 1138 1186 1225 1275 
48 49 66 75 82 95 110 134 183 210 216 217 227 242 294 313 333 338 379 390 399 411 424 465 488 495 526 533 569 614 622 625 652 671 713 714 745 790 792 807 812 822 866 887 967 1010 1043 1066 1096 1098 1102 1164 1196 1210 1241 1249 1270 1288 
44 45 46 50 51 57 72 76 81 93 94 116 128 137 142 143 149 168 169 247 272 275 297 298 299 362 413 466 493 494 509 517 518 554 574 582 599 642 646 719 749 768 773 796 832 965 969 1056 1058 1119 1124 1127 1184 1189 1261 
1 2 35 38 39 53 54 97 124 127 139 140 163 165 214 215 218 230 252 332 346 393 453 528 556 593 619 632 659 723 748 805 949 973 1019 1143 1238 
42 71 92 173 232 314 315 343 377 378 435 436 448 496 550 555 590 641 662 712 732 856 857 862 863 864 921 948 956 1065 1076 1150 1202 1203 1274 1285 1287 
109 113 152 153 231 368 404 489 596 617 626 656 689 700 715 716 739 808 816 828 836 852 867 868 871 932 1005 1006 1177 1190 1246 
56 83 138 141 148 167 204 244 245 326 367 412 450 468 482 483 530 541 563 566 609 742 903 909 927 985 1110 1160 1198 1278 
107 186 243 259 260 266 312 323 356 365 370 386 456 542 570 573 627 628 651 751 767 778 811 834 986 987 1012 1081 1085 1214 
16 78 112 161 170 198 265 300 353 388 407 415 416 452 511 558 560 581 717 753 770 781 830 876 928 984 1092 1116 1273 
77 79 118 129 146 202 205 228 229 251 278 288 322 347 473 514 615 728 761 957 997 1093 1247 1248 
105 106 122 255 305 324 354 426 461 515 586 729 741 916 1002 1008 1037 1051 1052 1115 1133 1168 1269 
96 145 156 262 375 398 402 419 565 631 702 771 804 837 873 902 911 1023 1048 1166 1211 
238 280 383 394 429 497 635 759 762 817 848 861 924 933 941 1021 1080 1126 1145 1149 1268 
11 14 15 19 23 25 30 33 37 52 162 598 801 900 951 1059 1141 1222 1229 1243 
40 282 371 396 410 471 535 592 623 691 787 839 893 923 935 1067 1072 1073 1227 1255 
254 307 373 408 409 420 492 502 536 756 757 806 844 891 892 1032 1105 1128 1170 1284 
3 6 34 41 102 130 219 273 292 334 337 507 557 831 994 1131 1250 1266 
18 189 190 286 444 463 510 730 907 908 959 1087 1157 1236 1263 1279 
184 206 274 283 302 341 360 369 385 544 572 820 872 947 1035 1103 
261 427 458 604 606 612 616 679 680 906 918 975 1007 1049 
328 543 636 676 752 879 1016 1027 1117 1161 1213 1239 1244 1251 
91 237 241 327 389 484 940 1064 1108 1172 1174 1175 
175 222 257 348 418 445 658 660 750 885 1153 1183 
325 545 546 647 758 793 794 1111 1112 1258 1259 1276 
36 111 296 506 703 869 942 943 976 1129 1169 
62 537 538 584 639 722 774 797 814 1107 1277 
258 336 414 694 720 721 970 971 1034 1242 1262 
7 22 47 114 203 686 1024 1130 1147 1185 
58 120 121 123 164 236 618 727 920 1054 
86 166 200 207 522 524 706 709 851 1230 
98 225 239 276 331 583 880 897 1187 1197 
136 304 382 462 549 587 764 788 1000 1240 
99 220 226 355 437 499 1084 1178 1280 
89 284 441 442 677 678 769 1068 
176 310 521 782 783 1082 1173 1233 
289 290 432 513 519 634 695 1044 
329 508 567 813 1132 1216 1245 1272 
384 459 516 613 917 1055 1094 1192 
392 406 434 564 611 1070 1075 1137 
4 104 201 381 454 696 1018 
24 271 576 939 1253 1260 1265 
84 177 196 311 366 425 954 
126 523 784 894 895 1159 1162 
188 503 690 877 878 983 1286 
208 209 309 629 810 1029 1099 
316 358 359 657 718 766 1257 
735 736 763 795 915 925 934 
10 285 351 633 648 668 
28 29 743 1050 1101 1228 
59 281 501 815 886 1152 
85 224 809 884 901 1176 
90 433 440 467 487 539 
320 321 447 1013 1182 1283 
403 683 874 875 1113 1125 
27 246 990 1095 1205 
68 512 529 1188 1237 
80 180 339 620 785 
132 682 888 889 1123 
135 640 655 688 938 
172 755 835 972 1256 
185 478 630 1040 1083 
192 991 1100 1180 1199 
211 443 457 490 980 
301 800 988 1071 1146 
303 395 602 779 838 
376 430 431 579 1195 
470 595 1009 1158 1234 
474 669 929 1020 1208 
498 670 846 930 931 
525 697 989 1061 1201 
663 953 1046 1165 1252 
775 802 847 870 1011 
882 883 978 1155 1156 
8 772 995 1221 
13 776 898 899 
17 63 397 1212 
21 26 43 1017 
67 704 896 966 
101 250 277 1086 
108 268 803 993 
119 491 936 1118 
133 240 605 708 
179 293 364 865 
191 472 1057 1193 
194 553 977 996 
213 401 547 705 
253 269 666 667 
308 571 600 601 
357 607 608 760 
438 737 738 1267 
505 548 575 588 
562 664 937 1114 
591 1223 1231 1232 
654 674 1204 1254 
733 734 1215 1281 
850 881 926 1033 
853 854 1078 1088 
31 982 1140 
88 212 342 
100 843 1271 
103 855 1026 
154 387 1264 
155 840 841 
171 417 1063 
181 777 952 
182 263 1226 
187 818 819 
193 672 673 
199 477 520 
233 1136 1144 
235 279 585 
249 765 1235 
256 534 798 
264 1053 1194 
291 597 681 
306 361 823 
318 1036 1089 
319 391 946 
344 552 1039 
400 955 1181 
428 1069 1167 
439 527 829 
469 479 981 
486 821 1122 
532 1109 1151 
643 644 964 
649 910 968 
650 754 890 
786 1163 1179 
825 1090 1097 
827 1106 1154 
833 1041 1042 
961 962 963 
1003 1004 1191 
1060 1104 1120 
1134 1135 1139 
