64 65 66 75 142 316 317 329 330 349 399 446 464 465 480 481 482 483 488 493 494 503 509 518 524 526 531 533 542 554 569 570 574 577 578 582 585 586 588 599 602 603 606 612 613 614 616 618 621 622 624 625 626 629 630 637 638 644 651 652 653 661 674 679 680 682 687 689 690 692 693 698 700 703 706 707 711 716 719 722 723 731 739 743 744 745 747 749 754 759 762 764 773 785 808 816 822 828 832 836 845 846 852 860 861 867 868 869 887 903 905 906 909 916 917 919 922 924 927 932 933 937 950 965 968 972 974 976 977 983 1001 1002 1012 1015 1017 1022 1024 1028 1037 1039 1055 1056 1060 1065 1066 1080 1106 1109 1138 1145 1164 1167 1189 1192 1204 1210 1228 1241 1246 1258 1259 1272 1276 1288 
28 29 40 60 61 62 63 69 70 73 95 98 134 135 150 151 157 158 159 174 210 213 216 217 224 225 242 248 257 258 267 268 294 300 301 331 333 350 379 400 401 411 424 441 442 451 463 473 474 477 495 516 527 540 547 548 551 555 607 608 643 670 712 746 789 817 853 854 857 866 902 921 930 967 1000 1005 1006 1050 1058 1068 1077 1079 1087 1089 1093 1094 1095 1099 1101 1155 1176 1179 1180 1190 1212 1260 1262 1267 
0 1 2 3 4 5 6 7 8 9 10 11 12 13 14 15 18 19 21 22 23 25 26 30 33 37 43 47 52 58 59 74 147 162 214 215 230 252 269 284 285 328 351 358 359 405 421 453 467 469 486 487 498 593 633 657 662 718 800 814 815 821 899 900 935 936 942 943 981 1059 1075 1115 1128 1129 1137 1141 1144 1147 1148 1193 1229 1239 1245 1251 1257 1266 
84 85 107 108 127 139 140 179 180 199 253 254 276 277 282 306 307 308 309 311 314 315 334 357 364 373 420 435 455 456 484 485 492 496 502 520 528 571 573 576 646 659 683 684 701 732 750 751 766 767 778 805 809 810 825 829 849 859 877 878 890 901 944 945 953 958 1021 1026 1032 1057 1081 1098 1150 1170 1183 1205 1214 1216 1238 1250 1253 1286 1287 
90 91 212 226 237 293 342 343 387 388 389 391 392 394 397 406 434 472 532 564 567 591 677 678 695 704 705 717 733 734 735 736 763 769 777 788 795 802 803 812 813 847 884 894 895 915 925 931 934 961 962 973 986 987 993 995 996 1083 1090 1091 1092 1104 1108 1130 1132 1142 1159 1162 1163 1184 1209 1215 1221 1223 1224 1231 1240 1249 1268 
55 56 83 100 101 128 138 141 144 145 146 154 155 156 167 177 182 193 204 244 245 246 247 262 280 281 326 327 375 376 398 402 403 452 475 476 506 530 559 563 565 566 609 699 702 708 752 760 771 786 792 801 804 873 891 892 911 914 985 994 1014 1023 1071 1124 1146 1151 1158 1166 1185 1226 1243 1271 1278 
34 35 38 39 53 54 71 82 89 92 97 120 121 122 123 181 196 197 218 219 251 259 260 312 322 323 332 377 378 386 393 436 448 521 550 556 557 594 615 617 619 660 715 727 831 862 882 883 940 941 948 949 978 1004 1007 1038 1040 1054 1078 1088 1126 1156 1157 1181 1196 1198 1200 1230 1285 
41 42 67 68 72 93 94 109 114 115 129 136 161 170 171 173 178 188 200 201 220 221 228 229 238 239 250 255 304 310 319 325 347 365 372 374 382 383 404 428 512 513 523 549 587 686 696 728 756 844 848 863 864 871 957 1020 1103 1105 1120 1131 1177 1187 1188 1208 1269 1273 1284 
48 49 102 103 112 113 125 126 130 163 164 165 172 198 202 203 205 206 211 232 249 256 265 273 278 287 288 289 352 353 457 460 490 505 511 534 560 575 590 671 721 798 833 856 904 990 991 1036 1044 1046 1063 1064 1100 1114 1149 1153 1154 1165 1168 1169 1174 1175 1232 1242 1252 1256 1282 
79 80 96 99 183 194 195 320 321 339 345 415 416 454 553 558 598 604 605 640 641 655 685 688 713 714 737 738 742 770 775 776 781 784 796 826 830 837 840 841 872 876 896 897 912 918 928 938 947 955 979 980 984 1003 1011 1041 1042 1049 1070 1110 1136 1197 1218 1234 
31 32 263 264 362 363 371 396 410 417 433 440 450 462 471 478 497 514 529 535 539 592 595 623 632 649 650 691 694 726 772 787 799 806 807 839 865 870 881 893 908 923 946 970 971 982 1018 1031 1034 1043 1061 1067 1072 1073 1143 1186 1247 1248 1270 
152 153 208 209 231 235 236 279 290 354 355 390 432 437 449 466 489 515 519 525 600 610 611 634 697 709 724 725 729 730 790 850 851 874 875 907 920 926 939 951 952 960 988 989 1029 1030 1033 1096 1102 1113 1121 1125 1182 1201 1222 1233 1283 
110 111 303 340 341 395 443 543 544 545 546 552 596 601 620 645 647 656 672 673 740 741 753 757 758 779 793 794 838 898 959 992 1019 1045 1069 1123 1160 1171 1206 1207 1213 1217 1227 1244 1255 1265 1279 
77 78 88 104 117 118 119 131 148 160 291 292 295 361 368 412 413 468 499 500 507 541 568 668 669 681 748 765 797 834 910 1008 1009 1084 1117 1178 1235 1280 
184 185 270 271 274 275 283 302 337 338 344 346 360 369 380 381 384 385 414 429 447 479 508 572 589 627 628 761 811 820 827 858 1035 1211 1237 
44 45 46 50 51 57 76 81 116 137 149 222 223 261 272 297 318 335 336 418 427 517 597 642 720 885 1062 1107 1127 1172 1263 
233 234 313 425 426 438 439 461 501 580 581 648 823 879 880 954 963 1085 1086 1112 1119 1122 1133 1140 1152 1161 1264 
86 87 143 166 207 324 430 431 504 522 561 562 664 665 964 997 1053 1134 1135 1139 1191 1194 1195 1199 
132 133 227 240 241 367 635 636 675 676 782 783 1016 1027 1047 1048 1074 1082 1173 1225 1275 
168 169 298 299 408 409 470 491 536 579 768 774 855 886 1010 1118 1203 1236 1261 1277 
186 187 243 266 356 370 666 667 780 824 842 843 888 889 929 956 1111 1116 
175 176 191 192 348 366 407 445 658 710 913 1076 1097 1202 1274 1281 
105 106 124 305 458 459 818 819 969 975 1051 1052 
189 190 286 419 444 510 654 755 791 835 1254 
16 17 20 24 27 36 296 966 1013 1025 
537 538 583 584 631 639 663 
