109 124 139 163 178 209 235 236 279 319 329 330 368 383 404 460 464 488 503 515 527 542 548 554 577 613 617 625 626 630 680 682 715 747 749 764 816 836 845 846 852 861 862 868 869 871 887 903 919 920 932 937 965 968 977 1001 1012 1015 1028 1047 1051 1052 1055 1080 1082 1164 1177 1189 1225 1245 1272 
39 65 130 152 171 225 231 296 325 416 585 586 619 621 654 685 781 808 828 831 897 1002 1088 1145 1190 1194 1197 1200 1204 1254 1258 1259 1276 
90 91 182 226 237 263 264 362 389 410 433 440 450 497 514 535 539 595 649 650 726 792 799 1031 1067 1072 1108 1226 
56 138 144 146 190 204 251 262 280 286 402 419 565 609 708 752 771 804 1023 1236 1251 1263 
112 125 164 172 198 205 232 249 256 265 273 278 505 560 575 678 717 769 798 
142 143 298 299 336 350 493 509 518 568 599 691 694 697 701 772 949 1037 1087 
0 1 2 4 7 10 12 21 22 23 26 37 74 147 469 981 1017 1229 
13 122 291 297 306 307 361 377 756 765 800 888 891 892 956 1071 1235 1284 
47 49 95 135 411 486 571 574 679 814 902 922 983 1099 1147 1179 
120 192 233 234 313 492 580 677 881 967 991 1032 1062 1136 1199 
277 282 529 592 623 632 787 839 907 908 923 946 1021 1061 1143 
48 73 77 78 88 117 119 131 148 160 295 507 768 994 
126 248 436 446 710 745 931 974 1013 1091 1114 1142 1182 1203 
35 129 173 202 220 229 255 365 428 728 957 997 1269 
76 150 327 347 384 429 484 940 1019 1044 1064 1123 1174 
101 370 373 500 562 612 754 759 811 896 966 1086 1211 
184 270 271 283 302 337 360 369 385 572 820 1035 1282 
17 45 50 354 454 499 674 744 823 834 1127 1280 
83 141 156 245 363 420 482 616 1004 1007 1022 1166 
102 185 352 367 475 478 483 684 731 909 1138 1250 
154 228 250 300 648 812 856 1092 1098 1140 1172 1173 
214 215 218 230 246 405 453 593 901 939 1205 1216 
332 334 357 379 521 590 660 732 788 843 864 1240 
70 511 802 803 876 928 984 1010 1024 1122 1130 
175 222 386 418 569 624 739 885 1153 1196 1288 
180 620 622 810 917 918 970 971 1034 1043 1162 
8 18 30 33 52 162 801 900 1059 1141 
36 58 242 294 596 614 657 723 821 1129 
46 94 321 345 707 882 883 978 1155 1156 
137 179 466 467 508 534 567 615 969 1260 
176 326 348 407 526 658 687 720 1209 1241 
393 427 447 606 724 725 730 748 832 1283 
61 303 448 602 838 1079 1097 1202 1238 
114 134 145 239 272 276 583 880 1185 
166 207 324 425 916 954 1029 1191 1265 
197 304 323 603 652 955 979 1126 1184 
210 211 318 443 451 457 477 490 980 
244 530 541 563 584 631 837 927 1278 
285 380 668 692 783 859 1045 1074 1275 
673 850 851 874 1030 1033 1113 1125 1171 
59 216 316 317 494 516 1100 1192 
82 86 170 203 308 637 924 1273 
92 267 399 424 540 555 1150 1285 
128 281 414 607 809 890 1124 1158 
159 305 698 738 742 766 964 1160 
174 186 243 266 356 786 1116 1163 
212 213 342 343 395 439 591 1223 
388 761 775 776 784 894 1011 1224 
589 750 751 767 778 986 1081 1233 
736 763 777 795 915 925 934 1180 
11 157 641 938 1040 1083 1104 
28 40 98 127 257 331 366 
67 136 408 409 470 536 587 
81 364 372 524 942 943 1253 
84 85 177 224 911 972 1026 
110 538 639 663 1102 1109 1151 
111 118 288 378 703 1247 1248 
115 566 675 676 985 1027 1198 
116 149 275 531 642 755 1049 
181 461 854 951 952 1133 1222 
189 247 301 873 988 1058 1146 
310 371 481 611 782 963 1121 
471 656 689 793 794 1227 1255 
506 601 669 686 863 1020 1208 
545 546 552 610 647 992 1039 
659 770 895 936 973 993 1183 
24 27 217 472 1066 1212 
31 757 806 807 1128 1270 
57 238 491 1076 1118 1274 
71 374 455 688 762 1056 
100 113 690 1137 1246 1271 
269 406 904 1070 1111 1215 
314 438 510 735 982 1287 
333 496 597 681 910 1115 
376 431 579 594 1054 1195 
392 558 989 1073 1132 1221 
458 578 666 667 780 1167 
501 815 886 1041 1042 1112 
653 779 1005 1006 1077 1095 
3 6 41 1131 1266 
34 103 168 219 855 
60 394 853 914 1078 
68 260 480 1188 1237 
75 259 322 570 867 
79 80 96 183 339 
133 604 605 640 655 
140 473 474 1046 1175 
158 349 643 644 817 
194 195 553 796 996 
227 253 353 704 705 
268 700 1050 1075 1101 
284 789 790 844 1096 
289 290 432 513 1036 
340 341 437 525 824 
358 359 718 785 1257 
381 413 711 1018 1119 
465 543 544 1103 1249 
722 774 1107 1144 1277 
16 533 709 941 
29 551 743 1228 
38 89 97 556 
42 629 791 835 
43 312 893 1085 
53 959 1048 1279 
72 435 716 877 
99 254 1084 1148 
121 396 523 661 
151 421 987 1157 
167 400 517 582 
169 557 1069 1217 
188 512 651 1286 
196 485 1057 1230 
199 520 905 1117 
200 522 549 706 
206 274 452 1234 
208 309 449 634 
335 721 1025 1242 
351 633 879 1161 
375 702 1093 1256 
391 397 434 564 
412 468 1110 1178 
415 827 1106 1154 
495 600 645 695 
498 670 671 830 
502 713 714 1090 
528 576 805 825 
573 737 1214 1267 
588 858 913 1014 
758 953 1165 1252 
906 961 962 1159 
1201 1213 1239 1244 
5 20 63 
14 161 646 
19 66 108 
25 426 1187 
32 105 773 
51 598 1243 
54 444 445 
62 960 1094 
64 338 1060 
69 857 921 
87 430 504 
93 258 1262 
107 813 926 
123 344 456 
165 1089 1170 
201 696 833 
292 849 1009 
320 537 797 
355 390 729 
382 930 1000 
387 1210 1264 
401 463 547 
403 683 875 
417 519 1063 
441 442 1068 
459 819 975 
462 847 870 
487 841 1053 
532 760 866 
559 912 1065 
618 727 933 
635 1016 1268 
733 734 1281 
842 929 958 
848 1120 1152 
1134 1135 1139 
