39 69 75 109 115 124 139 140 152 163 171 174 178 186 208 209 231 235 236 243 259 266 279 319 322 329 330 356 368 376 383 387 392 404 431 449 459 460 464 473 474 488 503 515 527 542 548 553 554 558 560 577 579 594 613 617 618 625 626 630 634 654 680 682 689 698 715 727 728 747 749 764 786 808 816 819 828 831 836 845 846 852 857 861 862 867 868 871 887 888 889 903 917 919 920 921 932 933 937 956 965 968 977 989 1001 1012 1015 1028 1046 1047 1051 1052 1054 1055 1073 1082 1116 1132 1138 1145 1164 1169 1175 1177 1189 1190 1195 1204 1216 1221 1225 1245 1254 1264 1272 
28 40 56 61 84 85 106 114 122 127 129 134 138 144 145 146 177 188 190 191 193 198 204 239 241 251 255 262 272 276 280 286 332 333 334 351 357 366 379 402 419 445 448 471 496 512 521 565 566 581 583 584 586 590 597 602 609 631 633 635 651 656 660 672 673 676 679 681 708 712 719 732 752 771 788 793 794 842 843 860 864 879 880 910 911 922 929 985 1016 1023 1071 1079 1080 1097 1115 1161 1185 1187 1198 1202 1210 1227 1236 1240 1251 1255 1268 1269 1286 
0 1 2 3 4 5 6 7 10 12 13 21 22 23 26 27 35 37 38 41 47 49 58 62 63 74 82 86 89 95 97 123 135 166 170 173 180 199 202 203 207 216 217 229 268 308 309 324 328 344 391 397 411 425 434 456 469 472 486 489 520 537 556 564 571 574 629 636 637 700 722 740 741 814 822 898 899 902 905 916 924 954 960 983 997 1017 1050 1066 1075 1094 1099 1100 1101 1107 1117 1131 1144 1147 1191 1193 1200 1212 1229 1265 1266 1273 
31 32 83 102 105 128 141 142 143 156 185 218 230 245 246 247 281 292 298 299 336 350 352 363 367 420 450 475 478 482 483 493 509 518 528 568 570 576 599 616 684 691 694 697 701 731 772 773 778 791 805 809 825 835 849 873 901 909 939 949 994 1004 1007 1009 1022 1029 1037 1087 1119 1124 1146 1166 1250 
14 59 76 116 136 149 150 161 175 184 222 270 271 274 275 283 302 316 317 327 337 347 360 369 380 384 385 386 418 429 441 442 479 484 494 516 531 533 569 572 587 624 642 646 739 755 820 885 940 941 1035 1044 1049 1064 1068 1153 1174 1192 1196 1263 1282 1288 
48 73 77 78 88 104 117 119 126 131 148 158 159 160 248 295 305 349 358 359 436 446 458 507 578 643 644 666 667 710 718 738 742 745 766 768 780 817 964 974 975 990 1013 1021 1091 1114 1142 1160 1167 1182 1203 1224 1257 
36 46 81 94 121 196 242 311 321 345 364 372 396 465 485 524 543 544 561 596 614 627 653 657 707 723 751 767 779 785 838 869 872 882 883 942 943 978 1005 1006 1038 1057 1077 1081 1095 1103 1155 1156 1230 1249 1253 
43 282 291 297 306 307 312 361 377 410 417 462 497 514 529 535 592 623 632 649 650 756 765 787 799 800 839 865 878 891 892 893 907 908 923 935 946 1008 1031 1061 1063 1067 1072 1085 1105 1143 1168 1186 1235 1284 
154 189 214 215 221 228 250 269 277 300 301 405 406 453 593 648 699 761 775 776 784 802 803 812 847 856 870 890 894 904 947 948 958 988 1011 1026 1041 1042 1058 1070 1092 1098 1111 1140 1172 1173 1215 
54 68 100 101 113 260 346 370 373 393 403 427 444 447 480 500 562 606 612 628 675 683 690 724 725 730 748 754 759 811 832 875 896 944 945 1019 1027 1086 1123 1137 1188 1211 1237 1246 1271 1283 
8 11 18 19 25 30 33 52 66 71 108 133 157 162 226 374 426 455 573 604 605 640 641 655 688 737 762 801 900 938 1040 1056 1059 1083 1104 1141 1201 1213 1214 1239 1244 1267 
17 45 50 53 118 285 288 354 355 378 381 382 413 454 499 668 674 692 703 711 744 783 823 834 840 859 930 931 959 966 1000 1003 1018 1045 1048 1074 1127 1247 1248 1275 1279 1280 
20 24 65 130 153 225 261 296 325 415 416 468 545 546 552 585 610 619 621 647 664 665 685 781 897 992 1002 1039 1088 1110 1194 1197 1258 1259 1276 
60 110 111 151 197 303 304 323 365 388 394 421 603 638 652 729 753 853 914 955 979 986 987 1078 1102 1121 1126 1157 1184 1205 1238 
42 64 72 252 310 335 338 371 435 481 523 550 611 661 693 716 782 877 906 950 957 961 962 963 1025 1060 1159 1233 
92 107 187 267 390 399 401 424 463 495 540 547 555 600 645 813 818 850 851 874 926 1030 1033 1113 1125 1150 1171 1285 
176 326 348 407 412 501 526 658 659 662 687 720 721 770 815 821 886 895 936 973 993 1112 1129 1181 1183 1209 1241 1242 
9 55 112 125 132 164 205 227 232 240 249 253 256 265 273 278 287 353 505 678 704 705 717 769 826 830 
70 79 80 96 99 183 220 254 294 339 340 341 437 511 525 792 824 876 928 984 1010 1024 1084 1130 1148 1178 
16 120 192 233 234 313 428 430 492 504 580 677 757 806 807 881 967 991 1032 1062 1128 1136 1199 1270 
90 91 182 237 263 264 293 362 389 433 487 539 595 726 841 1053 1108 1122 1134 1135 1139 1226 
314 438 506 510 601 669 686 735 736 763 795 863 915 925 934 982 1020 1180 1208 1287 
137 165 169 179 223 466 467 508 534 557 567 615 969 1069 1089 1170 1217 1218 1260 
67 201 408 409 470 502 536 696 713 714 733 734 774 833 1090 1277 1281 
414 532 538 559 607 608 639 663 746 760 866 912 1065 1109 1151 1158 
87 200 315 398 440 476 522 549 706 709 976 995 1149 1163 1179 
34 103 168 219 620 622 810 855 918 970 971 1034 1043 1162 
51 57 194 195 238 491 598 796 996 1076 1118 1243 1274 
147 167 400 517 551 582 588 743 858 913 981 1014 1228 
15 29 44 93 98 224 257 258 331 589 750 1262 
155 212 213 342 343 395 439 591 829 1223 1231 1232 
210 211 318 443 451 457 477 490 575 980 1206 1207 
244 375 530 541 563 702 804 837 927 1093 1278 
206 452 758 827 953 1106 1154 1165 1234 1252 
181 461 777 854 951 952 1133 1222 
320 797 798 848 884 1120 1152 1176 
289 290 432 513 519 695 1036 
172 498 670 671 972 1256 
284 789 790 844 1096 
