124 139 163 208 209 368 383 449 464 471 488 515 527 542 566 577 617 625 630 634 656 689 715 727 764 793 794 836 845 852 861 862 903 932 933 951 1012 1047 1051 1052 1055 1082 1164 1222 1225 1227 
263 264 282 410 417 433 440 497 514 529 535 592 623 632 636 649 650 694 726 787 799 839 865 908 923 946 1008 1031 1061 1067 1072 1143 1168 
7 48 112 125 126 164 172 198 205 232 249 256 273 278 287 436 505 560 575 671 678 710 717 745 769 974 1013 1091 1182 1203 1236 1256 
142 143 298 299 336 350 352 493 509 553 568 570 599 691 697 747 772 816 846 868 869 919 937 965 968 977 1001 1022 1028 1087 1189 
0 1 2 3 4 9 10 12 21 22 23 26 36 37 74 147 242 294 328 469 596 723 882 883 978 981 1017 1193 1200 1229 
101 248 370 373 427 500 541 562 606 612 631 725 754 759 811 837 866 896 897 927 966 997 1019 1080 1086 1123 1211 
5 41 47 49 58 329 330 411 486 503 574 629 637 679 791 814 835 902 922 983 1015 1131 1147 1148 1245 1272 
13 100 122 291 297 306 307 361 377 586 683 701 756 765 800 888 891 892 956 1071 1107 1235 1271 1284 
94 109 121 136 178 310 325 382 396 404 468 523 524 585 587 626 942 943 1002 1084 1110 
55 56 138 141 146 156 204 245 403 609 699 752 771 804 911 985 1023 1251 
17 45 50 354 355 390 415 416 454 499 729 744 781 823 1000 1127 1280 
76 150 327 347 384 386 429 484 569 624 940 1035 1044 1064 1174 1288 
39 152 171 231 618 654 722 808 828 831 1144 1145 1190 1204 1254 
114 134 145 239 244 272 276 379 539 583 584 732 880 1185 1278 
59 216 316 317 441 442 494 516 718 1068 1100 1153 1192 
83 102 105 185 367 450 475 478 483 684 773 909 1250 
95 324 425 466 916 954 969 1029 1099 1163 1179 1191 1265 
144 190 251 262 280 286 402 419 530 563 565 708 1263 
332 334 357 521 590 660 736 782 788 842 843 864 1240 
20 63 140 473 474 487 548 571 841 929 1046 1175 
176 326 348 374 407 518 526 658 720 936 1209 1241 
221 301 388 761 775 776 784 894 1011 1058 1098 1224 
81 465 544 653 779 1005 1006 1077 1095 1103 1249 
91 106 349 446 664 680 682 719 1037 1114 1138 
120 233 313 492 677 881 967 991 1032 1062 1136 
184 270 283 302 360 369 385 508 572 820 1282 
197 304 323 603 652 955 979 1126 1165 1184 1252 
8 18 30 33 52 162 801 900 1059 1141 
35 82 86 170 173 202 203 229 924 1273 
130 296 619 621 685 1088 1194 1258 1259 1276 
154 250 300 648 812 879 1092 1161 1172 1173 
73 77 78 88 119 131 148 160 295 
115 675 676 698 737 738 742 1027 1160 
210 211 318 443 451 457 477 490 980 
218 230 246 901 939 949 1205 1216 1253 
363 412 420 482 616 661 687 887 1178 
545 546 552 610 647 673 992 1039 1171 
11 157 226 641 938 1040 1083 1104 
31 32 806 807 870 982 1018 1270 
71 455 688 762 947 948 1056 1070 
92 267 399 424 540 555 1150 1285 
110 303 538 639 663 1109 1151 1238 
128 281 414 607 809 890 1124 1158 
167 400 517 582 588 858 913 1014 
225 643 644 757 817 1021 1128 1197 
850 851 874 875 1030 1033 1113 1125 
16 418 533 709 739 941 1196 
29 98 224 257 331 958 1026 
69 228 319 856 857 921 1177 
111 118 288 378 703 1247 1248 
116 149 275 531 642 755 1049 
129 220 255 428 728 957 1269 
227 253 353 704 705 931 1142 
380 668 692 783 859 1074 1275 
391 802 803 1010 1024 1122 1130 
409 470 536 579 774 886 1277 
506 601 669 686 863 1020 1208 
543 620 622 838 917 918 1162 
659 770 815 895 973 993 1183 
798 848 884 1045 1120 1152 1176 
27 217 472 1066 1180 1212 
28 40 127 191 192 366 
46 321 345 707 930 1218 
61 448 602 1079 1097 1202 
168 421 479 628 855 1261 
181 461 580 854 952 1133 
196 485 872 1038 1057 1230 
212 342 343 591 1223 1231 
234 333 496 681 910 1115 
392 558 989 1073 1132 1221 
511 876 928 984 1063 1232 
763 777 795 915 925 934 
53 959 1048 1255 1279 
60 394 853 914 1078 
64 460 554 871 1060 
68 260 480 1188 1237 
75 259 322 749 867 
79 80 96 183 339 
87 166 200 207 522 
133 604 605 640 655 
186 243 266 356 824 
214 215 405 453 593 
268 700 1050 1075 1101 
269 406 904 1111 1215 
284 789 790 844 1096 
314 438 510 735 1287 
346 365 627 751 986 
371 481 611 963 1121 
376 431 594 1054 1195 
6 1041 1042 1266 
38 89 97 556 
42 252 693 1025 
43 312 893 1085 
51 598 796 1243 
54 175 444 445 
62 135 960 1094 
70 99 254 810 
72 435 716 877 
84 85 177 972 
113 690 1137 1246 
155 702 829 1166 
158 174 786 1116 
159 305 766 964 
188 512 651 1286 
206 274 452 1234 
222 223 597 885 
235 236 279 920 
237 293 389 1108 
247 731 873 1146 
277 573 1214 1267 
285 351 498 633 
289 290 432 519 
340 341 437 525 
358 359 785 1257 
381 413 711 1119 
458 578 666 1167 
476 667 780 976 
495 600 645 695 
502 713 714 1090 
528 576 805 825 
589 750 767 1081 
662 821 1129 1181 
906 961 962 1159 
970 971 1034 1043 
1201 1213 1239 1244 
14 161 646 
19 66 108 
24 271 338 
25 426 1187 
34 103 219 
57 1076 1274 
90 362 792 
93 258 1262 
107 813 926 
123 344 456 
137 513 1036 
151 987 1157 
153 261 907 
165 179 615 
169 557 1217 
182 595 1226 
194 195 996 
199 905 1117 
201 696 833 
213 395 439 
238 491 1118 
292 849 1009 
311 561 1199 
320 537 797 
335 721 1242 
337 507 994 
387 1210 1264 
393 748 832 
397 434 564 
401 463 547 
447 1053 1283 
459 819 975 
551 743 1228 
559 912 1065 
635 1016 1268 
665 740 741 
733 734 1281 
827 1106 1154 
898 899 1069 
1089 1140 1170 
1134 1135 1139 
