5 7 22 46 47 49 75 82 113 124 139 142 143 163 170 203 208 209 235 236 259 268 279 298 299 308 309 321 322 329 330 345 368 376 383 388 392 431 459 488 503 509 515 518 527 542 553 554 558 570 571 577 579 594 613 617 625 629 630 634 637 653 680 682 700 707 715 729 747 749 764 791 816 835 836 845 846 852 861 867 868 871 882 883 887 903 919 920 924 930 931 932 937 965 968 977 978 983 1001 1005 1006 1012 1017 1022 1028 1029 1047 1050 1051 1052 1054 1055 1056 1073 1075 1077 1082 1094 1095 1101 1102 1132 1137 1138 1147 1155 1156 1164 1189 1195 1221 1225 1245 1246 1272 1273 
64 67 81 86 87 94 109 136 166 174 178 180 194 196 200 207 310 311 315 324 338 364 371 372 374 382 398 404 408 409 440 449 460 470 476 481 485 520 522 523 524 536 548 549 561 587 611 626 661 706 709 774 782 786 850 851 869 872 874 886 942 943 963 976 995 996 1033 1038 1057 1060 1113 1116 1120 1125 1149 1163 1179 1191 1230 1233 1277 
0 1 2 3 4 6 9 10 12 13 15 21 23 26 37 41 43 44 74 282 291 297 306 307 312 328 361 377 410 417 462 469 497 514 529 535 592 623 632 636 649 650 676 694 701 756 765 787 799 800 839 878 891 892 893 898 899 908 923 935 946 1008 1027 1031 1061 1067 1072 1085 1105 1131 1143 1168 1186 1229 1235 1266 1284 
29 54 68 100 101 147 167 186 187 243 260 266 346 356 370 373 393 400 403 427 444 445 447 480 500 517 545 546 551 552 562 582 588 606 610 612 628 645 647 675 683 690 740 741 743 748 754 759 811 818 819 824 832 858 875 896 913 944 945 966 981 992 1014 1019 1030 1039 1086 1123 1171 1188 1211 1228 1237 1271 1283 
34 38 39 65 72 89 97 103 110 111 130 152 153 168 171 219 225 231 261 296 303 325 412 435 468 501 543 556 585 618 619 620 621 622 654 664 665 685 689 716 727 808 810 828 831 838 855 877 897 907 917 918 933 970 971 1034 1043 1088 1110 1145 1162 1190 1194 1197 1200 1204 1238 1254 1258 1259 1276 
20 28 40 63 85 93 98 114 127 134 135 140 145 146 177 224 239 244 257 258 272 276 331 332 333 334 357 366 379 397 473 474 496 521 530 541 563 566 581 583 584 590 609 631 660 712 732 771 788 837 843 864 880 910 911 927 985 1046 1115 1175 1185 1187 1198 1210 1240 1262 1278 
14 17 25 36 45 50 53 59 84 95 121 161 175 201 216 242 354 355 381 396 413 425 426 441 442 454 494 499 516 533 596 614 646 657 674 696 711 723 744 779 785 823 833 834 840 916 941 954 959 1000 1003 1048 1068 1099 1100 1127 1153 1192 1279 1280 
31 32 83 102 105 128 141 156 185 218 245 246 247 292 336 350 352 363 367 420 450 475 478 482 483 493 568 599 616 684 691 697 731 772 773 809 849 873 901 909 939 949 994 1004 1007 1009 1037 1087 1119 1124 1146 1166 1216 1250 1253 
48 73 77 78 88 104 115 117 119 126 131 148 158 159 160 248 295 305 349 358 359 436 446 458 507 578 643 644 666 667 698 710 718 738 742 745 766 768 780 817 964 974 975 990 1013 1018 1021 1091 1114 1142 1160 1167 1203 1224 1257 
70 79 80 90 91 96 99 182 183 237 254 263 264 293 294 339 362 389 407 415 416 433 487 511 539 595 726 781 792 841 865 876 928 984 1010 1024 1053 1084 1108 1122 1134 1135 1139 1148 1226 
181 189 214 215 221 230 269 301 391 405 406 434 453 461 564 580 593 699 724 725 730 761 775 776 777 784 854 894 904 947 948 951 952 960 988 989 1011 1058 1070 1111 1112 1133 1182 1215 1222 
69 71 129 154 220 228 250 255 277 300 319 365 428 430 455 504 648 688 728 762 812 842 856 857 888 889 890 921 929 956 957 958 1026 1041 1042 1092 1098 1140 1169 1172 1173 1177 1269 
24 58 116 123 149 184 199 270 271 274 275 283 302 337 344 360 369 380 385 456 479 489 531 572 597 642 681 755 820 822 905 906 961 962 1035 1049 1117 1159 1282 
92 107 267 390 399 401 414 424 463 495 532 538 540 547 555 559 600 607 608 639 663 746 760 802 803 813 847 866 870 912 926 1065 1109 1130 1150 1151 1158 1285 
176 195 281 326 348 387 464 465 526 544 658 659 662 687 720 721 770 815 821 862 895 936 973 993 1103 1129 1181 1209 1241 1242 1249 1264 1265 
8 18 30 33 52 76 150 162 222 327 347 384 386 418 429 484 569 624 739 801 885 900 940 1044 1059 1063 1064 1141 1174 1196 1288 
61 62 106 122 241 411 448 471 486 574 586 602 656 679 719 722 793 794 814 860 902 922 1002 1015 1071 1079 1107 1144 1202 1227 1255 
27 35 118 173 188 191 202 217 229 285 288 378 472 512 651 668 692 703 783 859 997 1045 1066 1074 1193 1212 1247 1248 1275 1286 
56 138 144 190 193 204 251 262 280 286 375 402 419 565 635 672 673 702 708 752 804 1016 1023 1080 1093 1236 1251 1263 1268 
55 112 125 164 172 198 205 232 249 256 265 273 278 287 498 505 560 670 671 678 717 769 826 972 1256 
16 120 192 233 234 313 492 550 677 757 806 807 881 950 967 991 1032 1062 1128 1136 1199 1270 
137 165 169 179 223 466 467 508 534 557 567 615 969 1069 1089 1170 1217 1218 1260 
11 133 157 226 604 605 640 641 655 938 1040 1083 1104 1201 1213 1239 1244 
320 537 736 763 795 797 798 848 884 915 925 934 1152 1176 1180 
197 304 323 603 638 652 753 955 979 1121 1126 1184 1205 
314 438 506 510 601 669 686 735 863 982 1020 1208 1287 
155 212 213 342 343 395 439 591 829 1223 1231 1232 
210 211 318 443 451 457 477 490 575 980 1206 1207 
502 528 576 713 714 733 734 805 825 1090 1097 1281 
316 317 589 627 750 751 767 778 986 987 1081 
51 57 238 491 598 796 1076 1118 1243 1274 
206 452 758 827 953 1106 1154 1165 1234 1252 
284 351 633 789 790 844 879 1096 1161 
60 151 394 421 853 914 1078 1157 
132 227 240 253 353 704 705 830 
19 66 108 573 737 1214 1267 
289 290 432 513 519 695 1036 
340 341 437 525 1178 1183 
42 252 335 693 1025 
