0 60 61 69 70 73 115 131 144 150 151 157 158 159 160 174 195 248 295 345 349 350 352 380 446 464 475 481 485 500 531 545 551 577 578 594 603 621 624 637 638 647 656 661 687 692 698 707 711 725 747 845 913 919 922 974 1001 1015 1047 1066 1074 1079 1138 1155 1156 1171 1186 1225 1241 1275 
34 35 38 39 41 53 54 71 97 102 112 124 125 127 130 139 140 163 165 211 218 219 221 230 273 292 332 334 393 466 467 487 556 557 568 619 632 659 701 722 748 805 831 949 969 973 1131 1143 1238 1250 
44 45 46 50 51 57 72 76 81 93 94 116 137 149 272 275 297 298 299 362 413 493 494 503 509 517 554 574 582 599 614 642 646 719 749 773 796 816 832 868 903 906 965 1036 1056 1058 1119 1127 1184 1189 
110 183 216 217 227 242 294 313 317 379 390 399 411 424 465 480 495 526 533 541 566 589 622 625 652 671 696 713 714 745 792 812 822 833 866 887 927 1010 1041 1042 1043 1100 1164 1196 1210 1249 
55 56 83 128 138 141 148 156 167 204 240 241 244 245 281 326 327 367 412 450 482 483 484 579 609 699 742 771 804 815 909 1007 1023 1124 1160 1172 1173 1174 1175 1278 
42 92 173 232 314 315 344 377 378 435 436 448 496 550 552 555 590 641 662 862 863 864 956 964 1039 1065 1076 1150 1202 1203 1274 1285 1287 
176 212 213 303 304 310 382 395 462 521 549 591 602 764 779 782 783 788 838 850 874 875 1000 1030 1033 1082 1113 1125 1223 1233 1240 
77 79 118 146 228 229 251 288 322 347 392 406 434 472 473 514 564 611 615 761 1070 1075 1093 1137 1247 1248 
9 11 13 14 15 19 23 25 30 33 37 52 162 209 598 801 900 951 1059 1099 1141 1222 1229 1243 
105 106 122 252 255 305 324 354 426 461 515 586 729 741 916 1002 1008 1037 1051 1052 1133 1269 
29 40 98 263 282 331 371 396 410 433 440 471 535 592 691 787 1067 1072 1073 1227 1255 
181 236 254 307 373 403 408 420 492 502 683 727 756 777 891 892 920 952 985 1032 1284 
238 280 394 427 429 497 635 759 762 817 852 861 924 941 1021 1080 1126 1145 1268 
86 87 109 136 166 200 207 291 325 404 468 522 524 587 626 758 1110 1230 
5 7 22 47 114 129 203 308 328 414 571 600 601 686 983 1147 1185 
10 89 284 285 351 442 498 633 648 668 677 678 769 879 1117 1161 
18 189 190 444 463 665 724 730 740 907 908 959 1087 1157 1236 1279 
170 265 300 388 407 416 452 753 770 781 826 876 928 984 1092 1273 
6 49 62 82 134 208 210 309 333 375 488 569 629 1266 1288 
36 111 296 506 703 790 869 942 943 976 1096 1102 1129 1169 1198 
96 100 262 398 402 419 530 563 565 702 843 873 911 1271 
184 185 283 302 360 369 385 478 572 630 820 1035 1040 1083 
16 192 198 511 581 597 681 967 1115 1116 1231 1232 
103 224 389 774 809 884 901 1026 1107 1108 1176 1277 
117 182 363 561 653 684 744 768 860 1022 1077 1226 
258 335 336 694 720 721 953 970 971 1034 1242 1262 
101 202 205 250 277 278 287 728 957 997 1086 
113 249 505 548 575 588 765 933 1149 1235 1246 
261 458 604 606 612 616 679 680 918 975 1049 
20 175 257 348 418 445 658 660 1153 1183 
99 220 355 437 499 810 1084 1178 1280 
108 267 268 540 567 803 813 993 1132 
152 153 231 489 808 828 836 932 1190 
439 527 546 793 794 829 1258 1259 1276 
543 636 676 752 799 992 1016 1027 1251 
32 197 663 807 1046 1165 1252 1270 
119 374 409 455 491 536 936 1118 
186 187 243 266 356 818 819 824 
225 239 276 583 880 897 1187 1197 
289 290 432 513 519 634 695 1044 
316 358 359 657 718 766 1214 1257 
353 558 750 767 778 849 1081 1142 
1 2 346 443 528 723 1019 
58 120 121 123 164 618 1054 
84 177 196 311 366 425 954 
107 259 260 312 386 542 1085 
132 664 682 888 889 1114 1123 
319 343 391 856 857 921 946 
320 321 447 675 1013 1182 1283 
323 456 573 627 628 651 811 
368 596 617 700 739 867 917 
384 441 459 516 613 1068 1192 
508 735 736 763 915 925 934 
523 784 894 895 1098 1159 1162 
27 246 990 1025 1095 1205 
142 143 168 169 518 1261 
179 237 293 364 520 865 
206 274 544 785 872 1103 
214 215 421 453 593 855 
330 383 685 848 1045 1152 
537 538 584 639 797 814 
623 839 923 935 989 1061 
4 104 201 381 1018 
8 772 995 996 1221 
12 882 883 978 1200 
28 233 454 1136 1144 
59 501 871 886 1177 
68 512 529 1188 1237 
85 172 755 972 1256 
135 640 655 688 938 
188 690 877 878 1286 
400 547 738 955 1181 
457 795 991 1180 1199 
470 595 1009 1158 1234 
775 802 847 870 1011 
3 337 507 994 
17 63 397 1212 
21 26 43 1017 
64 65 75 338 
67 704 896 966 
80 180 339 620 
90 264 643 644 
91 226 940 1064 
126 717 1024 1130 
145 539 902 1048 
155 840 841 1166 
171 417 893 1063 
253 269 666 667 
256 534 798 1218 
329 1216 1245 1272 
357 607 608 760 
370 570 834 1012 
376 430 431 1195 
654 674 1204 1254 
670 846 930 931 
733 734 1215 1281 
743 1050 1101 1228 
776 898 899 1069 
800 988 1071 1146 
853 854 1078 1088 
48 95 560 
66 562 937 
78 161 830 
133 605 708 
147 1014 1209 
154 387 1264 
191 1057 1193 
193 672 673 
194 553 977 
222 223 885 
235 279 585 
301 610 1031 
306 361 823 
365 986 987 
372 751 858 
428 504 1167 
438 737 1267 
451 490 746 
469 479 981 
486 821 1122 
510 835 982 
525 697 1201 
576 1260 1265 
631 837 1211 
649 910 968 
650 754 890 
669 1020 1208 
689 1005 1006 
693 791 1029 
706 709 851 
715 716 1109 
726 1170 1217 
757 806 1128 
786 1163 1179 
825 1090 1097 
859 979 980 
939 1168 1253 
961 962 963 
1003 1004 1191 
1060 1104 1120 
1134 1135 1139 
1213 1239 1244 
