75 113 124 139 163 208 209 235 236 259 279 322 329 330 368 383 459 488 503 515 527 542 553 554 570 577 613 617 625 629 630 634 653 680 682 715 729 747 749 764 816 836 845 846 852 861 867 868 871 887 903 919 920 932 937 965 968 977 1001 1005 1006 1012 1017 1022 1028 1047 1051 1052 1055 1056 1077 1082 1094 1102 1137 1138 1164 1189 1225 1245 1246 1272 
43 282 312 410 417 462 497 514 529 535 592 623 632 649 650 694 787 799 839 878 893 908 923 935 946 1008 1031 1061 1067 1072 1085 1105 1143 1168 1186 
101 346 373 393 427 447 500 546 562 606 610 612 628 645 675 748 759 811 832 896 966 1019 1039 1086 1123 1211 1283 
31 32 102 105 128 185 247 350 352 367 450 475 478 483 684 731 773 809 873 909 994 1037 1119 1124 1146 1250 
5 7 22 47 49 82 142 143 170 203 298 299 308 309 388 509 518 571 637 924 983 1095 1147 1273 
65 130 225 296 325 412 501 585 619 621 685 897 1088 1194 1197 1258 1259 1276 
154 228 300 648 812 856 857 890 921 958 1026 1041 1042 1092 1098 1140 1172 1173 
0 1 2 4 9 10 12 13 21 23 26 37 74 469 898 899 1229 
24 184 270 271 274 283 302 337 360 369 380 385 479 572 820 1035 1282 
76 150 327 347 384 386 429 484 569 624 940 1044 1063 1064 1174 1288 
90 91 237 264 293 362 389 433 487 539 726 841 865 1053 1108 1122 
56 138 144 190 204 262 286 402 419 565 708 752 1236 1251 1263 
137 165 169 179 223 466 467 508 534 557 567 615 969 1218 1260 
146 177 244 530 541 563 566 609 771 837 911 927 985 1198 1278 
332 334 357 379 521 581 590 660 712 732 788 843 864 1210 1240 
94 109 136 178 310 374 382 404 460 548 587 626 782 1233 
112 125 164 198 249 265 273 505 560 671 678 717 769 826 
291 297 306 307 361 377 701 756 765 800 891 892 1235 1284 
11 133 157 226 604 605 640 641 655 938 1040 1083 1104 
39 152 171 231 654 808 828 831 1145 1190 1200 1204 1254 
48 73 77 78 88 117 119 131 148 160 295 507 768 
81 196 364 372 485 524 869 872 942 943 1038 1057 1230 
110 543 620 622 810 838 917 918 970 971 1034 1043 1162 
115 159 305 358 359 698 718 738 742 766 964 1160 1257 
126 248 436 446 710 745 974 1013 1091 1114 1142 1203 1224 
17 45 50 355 454 499 674 744 834 1000 1127 1280 
35 118 173 202 229 288 378 703 997 1247 1248 
61 448 471 602 656 793 794 1079 1202 1227 1255 
83 141 156 245 363 420 482 616 1004 1007 1166 
186 187 243 266 356 370 754 818 819 824 1030 
549 706 709 850 851 874 1033 1113 1125 1163 1179 
8 18 30 33 52 162 801 900 1059 1141 
36 121 216 242 396 596 723 779 785 1100 
70 99 254 294 511 792 1010 1024 1084 1148 
86 87 166 200 207 324 476 522 976 1191 
100 167 400 517 582 588 690 858 913 1271 
114 134 145 239 272 276 583 880 1185 1187 
120 192 233 313 881 967 991 1062 1136 1199 
197 304 323 603 652 955 979 1121 1126 1184 
210 211 318 443 451 457 477 490 575 980 
526 662 720 721 821 1129 1181 1209 1241 1242 
16 492 677 757 806 807 1032 1128 1270 
58 123 199 344 456 489 822 905 1117 
59 175 441 442 494 516 1068 1153 1192 
129 220 250 255 277 365 728 957 1269 
189 301 951 960 988 989 1058 1182 1222 
336 493 568 599 691 697 772 949 1087 
25 95 354 425 426 916 954 1099 
67 408 409 470 536 774 886 1277 
281 659 770 815 895 936 973 993 
285 668 692 783 859 1045 1074 1275 
320 537 797 798 848 884 1152 1176 
28 40 98 127 257 331 366 
116 149 275 531 642 755 1049 
181 461 580 777 854 952 1133 
214 215 230 405 453 593 1112 
251 280 635 1016 1023 1080 1268 
267 390 399 424 540 555 1150 
289 290 432 513 519 695 1036 
407 415 416 781 876 928 984 
458 578 666 667 780 975 1167 
502 528 576 805 825 1090 1097 
758 827 953 1106 1154 1165 1252 
761 775 776 784 894 904 1011 
20 140 473 474 1046 1175 
46 321 345 707 930 931 
57 238 491 1076 1118 1274 
62 722 814 922 1107 1144 
92 414 607 926 1158 1285 
106 122 586 719 1002 1071 
158 349 643 644 817 1021 
218 246 901 939 1216 1253 
314 438 510 735 982 1287 
376 431 579 594 1054 1195 
411 486 574 679 902 1015 
3 6 41 1131 1266 
27 217 472 1066 1212 
34 103 168 219 855 
60 394 853 914 1078 
68 260 480 1188 1237 
79 80 96 183 339 
155 439 591 829 1223 
176 326 348 658 687 
195 387 464 862 1264 
212 213 342 343 395 
222 418 739 885 1196 
268 700 1050 1075 1101 
269 406 1070 1111 1215 
284 789 790 844 1096 
381 413 533 711 941 
392 558 1073 1132 1221 
465 544 1103 1249 1265 
538 639 663 1109 1151 
545 552 647 992 1171 
713 714 733 734 1281 
736 763 915 925 934 
802 803 847 870 1130 
882 883 978 1155 1156 
14 84 161 646 
29 551 743 1228 
38 89 97 556 
51 598 796 1243 
53 959 1048 1279 
64 338 1060 1120 
71 455 688 762 
72 435 716 877 
174 449 786 1116 
180 315 520 1149 
182 263 595 1226 
188 512 651 1286 
201 696 823 833 
205 232 256 278 
316 317 589 750 
328 636 676 1027 
333 496 910 1115 
340 341 525 1183 
351 633 879 1161 
371 481 611 963 
375 702 804 1093 
506 601 686 863 
573 737 1214 1267 
618 689 727 933 
627 751 986 987 
888 889 956 1169 
906 961 962 1159 
1069 1089 1170 1217 
1201 1213 1239 1244 
19 66 108 
42 252 693 
54 444 445 
63 135 397 
69 319 1177 
93 258 1262 
104 990 1018 
111 303 1238 
147 981 1014 
151 421 1157 
153 261 907 
172 972 1256 
193 672 673 
206 452 1234 
227 704 705 
234 550 950 
253 353 830 
292 849 1009 
391 434 564 
398 440 995 
401 463 547 
403 683 875 
428 430 504 
532 760 866 
559 912 1065 
638 753 1205 
669 1020 1208 
724 725 730 
767 778 1081 
791 835 1029 
1134 1135 1139 
