64 65 66 75 142 329 330 349 399 446 464 465 480 481 482 483 488 493 494 503 509 518 524 526 531 533 542 554 569 570 574 577 578 582 585 586 588 599 602 603 606 612 613 614 616 618 621 622 624 625 626 629 630 637 638 644 651 652 653 661 674 679 680 682 687 689 690 692 693 698 700 703 706 707 711 716 719 722 723 731 739 743 744 745 747 749 754 759 762 764 773 785 808 816 822 828 832 836 845 846 852 860 861 867 868 869 887 903 905 906 909 916 917 919 922 924 927 932 933 937 950 965 968 972 974 976 977 983 1001 1002 1012 1015 1017 1022 1024 1028 1037 1039 1055 1056 1060 1065 1066 1080 1106 1109 1138 1145 1164 1167 1189 1192 1204 1210 1228 1241 1246 1258 1259 1272 1276 1288 
55 56 83 100 101 128 138 141 144 145 146 154 155 156 167 177 182 193 204 244 245 246 247 262 280 281 326 327 375 376 398 402 403 452 475 476 506 530 559 563 565 566 609 699 702 708 752 760 771 786 792 801 804 873 911 914 985 994 1014 1023 1071 1124 1146 1151 1158 1166 1185 1226 1271 1278 
0 1 2 3 4 5 6 7 8 9 10 11 12 13 14 15 18 19 21 22 23 25 26 30 33 37 43 47 52 58 59 74 147 162 269 328 358 467 469 486 487 657 662 814 815 821 899 900 935 936 942 943 981 1059 1075 1115 1128 1129 1137 1141 1144 1147 1148 1193 1229 1239 1245 1257 1266 
263 264 362 363 371 396 410 417 433 440 450 462 471 478 497 514 529 535 539 592 595 623 632 649 650 691 694 726 772 787 799 839 865 881 893 908 923 946 1018 1031 1061 1067 1072 1073 1143 1186 1247 1248 
34 35 38 39 53 54 71 82 89 92 97 120 122 181 218 219 332 393 556 557 594 617 619 715 727 831 940 941 948 949 1004 1007 1038 1040 1054 1078 1088 1157 1196 1198 1200 1285 
48 49 102 103 112 113 125 126 130 163 164 165 172 198 211 249 265 273 352 353 460 505 511 560 575 671 721 904 1036 1063 1064 1114 1149 1153 1154 1168 1232 1242 1256 
41 42 72 114 115 129 171 173 178 220 228 229 238 239 250 255 319 347 365 428 513 686 728 756 844 863 864 871 957 1103 1105 1131 1177 1187 1269 1284 
67 68 93 94 109 136 161 170 188 200 201 221 304 310 325 372 374 382 383 404 512 523 549 587 848 1020 1120 1188 1208 1273 
184 185 270 271 274 275 283 302 337 338 344 346 360 369 380 381 384 385 414 429 447 479 508 572 589 761 820 827 1035 1237 
90 226 343 567 677 678 705 717 769 788 802 803 812 813 847 931 1090 1091 1092 1130 1142 1159 1184 1224 1240 
44 45 46 50 51 57 76 81 137 149 272 297 318 335 336 517 642 720 1062 1107 1127 1172 
84 85 107 108 127 253 254 276 277 282 311 455 456 573 646 766 1021 1098 1205 1214 
60 61 69 70 73 150 151 157 158 159 174 248 350 712 857 921 1079 1093 1155 
233 234 313 425 426 438 439 461 501 580 581 648 823 954 1112 1119 1122 1133 1140 
77 78 88 104 117 118 119 131 148 160 295 499 500 507 541 797 1009 1280 
79 183 320 321 345 713 714 841 872 918 947 979 980 1041 1042 1049 1070 1218 
62 63 95 134 135 210 294 333 411 516 607 1058 1094 1099 1179 1212 
391 392 397 406 434 472 564 733 734 961 962 1132 1162 1209 1215 1221 
306 307 373 420 435 492 502 576 659 683 701 825 859 1032 1170 
202 203 205 206 232 256 278 287 288 590 833 856 1169 1174 
169 408 409 470 491 536 579 774 855 886 1010 1118 1277 
186 187 243 266 356 370 666 667 780 824 842 1111 1116 
415 416 454 558 685 770 775 781 826 830 876 928 984 
175 176 348 407 658 710 913 1076 1097 1202 1274 1281 
179 199 314 315 334 357 364 496 520 732 1250 1287 
31 32 806 807 870 970 971 982 1034 1043 1270 
208 209 290 432 437 449 466 519 600 634 1029 
354 355 390 489 515 729 790 939 1096 1102 1283 
395 543 544 596 620 779 838 959 1255 1265 1279 
545 546 552 647 656 793 794 898 992 1069 1217 
16 17 20 24 27 36 296 966 1013 1025 
139 140 528 571 805 829 849 953 1238 1286 
214 215 230 252 405 421 453 593 800 1251 
291 292 361 368 468 681 765 910 1084 1235 
377 378 436 448 521 550 660 862 1181 1230 
850 874 875 926 1030 1033 1113 1125 1171 1233 
116 222 223 261 418 427 597 885 1263 
121 123 259 260 312 322 323 386 1126 
180 809 810 890 901 958 1026 1216 1253 
212 342 387 388 394 532 591 1223 1231 
457 990 991 1046 1100 1165 1175 1252 1282 
28 98 217 242 527 866 1077 1180 
105 106 124 305 818 819 1051 1052 
216 379 643 789 817 967 1190 1260 
730 951 952 960 988 989 1182 1222 
86 87 166 207 324 522 1191 
213 316 317 359 401 718 1089 
224 225 257 258 331 1176 1262 
537 538 583 584 631 639 663 
736 763 777 795 915 925 934 
132 133 227 240 241 367 
143 561 562 964 997 1199 
231 610 611 709 851 1121 
412 413 568 834 1117 1178 
443 601 645 1019 1045 1160 
510 654 755 791 835 1254 
635 636 675 676 1016 1027 
640 737 738 742 955 1136 
29 40 551 1050 1101 
80 96 99 339 655 
168 298 299 768 1261 
189 190 286 419 444 
194 195 553 796 837 
237 293 389 884 1108 
267 268 495 540 555 
284 285 351 498 633 
473 474 477 548 902 
627 628 811 858 1211 
641 776 784 938 1011 
750 751 767 778 1081 
782 783 1074 1173 1275 
843 888 889 929 956 
110 111 303 753 
191 192 366 445 
196 197 251 615 
235 236 279 920 
430 431 504 1195 
451 490 608 746 
458 459 969 975 
484 485 684 1057 
525 1201 1213 1244 
664 665 1053 1194 
668 669 748 1008 
695 894 895 973 
879 880 963 1161 
882 883 978 1156 
1005 1006 1087 1095 
1047 1048 1082 1225 
152 153 907 
340 341 1183 
400 463 547 
441 442 1068 
604 605 688 
670 930 1000 
704 986 987 
740 741 1123 
757 758 1227 
877 878 1150 
891 892 1243 
896 897 1234 
993 1083 1104 
995 996 1249 
1134 1135 1139 
