0 60 61 69 70 73 77 117 131 150 151 157 158 159 160 174 183 195 217 248 295 345 349 350 352 363 411 421 446 464 475 485 500 531 551 561 577 578 594 603 621 624 637 638 653 661 684 687 698 707 711 725 731 744 747 768 845 860 922 974 987 1001 1005 1006 1047 1066 1077 1079 1138 1155 1156 1186 1225 
44 45 46 50 51 57 76 81 93 94 116 128 137 142 143 149 168 222 247 261 272 275 298 299 318 413 427 493 494 509 517 518 554 568 574 582 599 604 606 612 642 679 701 719 749 773 796 816 832 868 885 906 918 919 965 1015 1049 1056 1058 1119 1124 1127 1184 1189 1261 
58 109 120 121 123 152 153 164 231 236 330 368 383 384 404 459 489 516 596 613 617 618 626 656 685 689 700 715 716 727 739 759 808 828 836 852 861 867 871 917 920 932 933 941 1012 1054 1055 1094 1126 1149 1177 1190 1192 
3 6 34 35 38 39 41 53 54 97 102 124 127 130 139 140 163 165 169 181 211 218 219 221 230 273 292 393 556 557 619 632 699 748 777 805 831 949 952 1036 1131 1143 1238 1250 1266 
56 96 101 115 138 141 145 156 204 244 245 262 375 398 402 419 530 541 563 565 566 609 675 702 708 771 804 873 911 927 985 1023 1086 1166 1198 1278 
42 71 92 173 253 269 314 315 332 334 357 378 435 436 448 496 510 550 555 590 607 641 662 666 732 735 760 862 863 864 948 1202 1285 1287 
80 82 110 134 180 208 209 252 294 309 333 424 488 569 620 622 625 629 634 693 790 791 792 810 835 887 913 1029 1043 1096 1099 1102 1288 
8 9 11 14 15 18 19 23 25 30 33 37 52 162 598 772 801 826 900 951 995 1059 1087 1141 1221 1222 1229 1243 
16 78 161 170 198 300 353 415 416 511 558 560 581 753 770 781 830 876 928 984 1037 1092 1142 1273 
282 371 396 410 525 592 623 649 691 697 787 839 893 923 935 989 1061 1067 1072 1073 1182 1201 
79 118 129 146 228 229 251 288 322 339 347 473 514 535 615 728 761 957 1093 1247 1248 
28 98 216 242 313 379 390 399 480 526 652 671 745 785 822 967 1164 1196 1210 1241 
99 254 306 307 361 373 408 420 492 502 756 823 844 891 892 1032 1084 1284 
212 213 325 395 439 527 546 591 758 779 829 1111 1223 1231 1232 1258 1259 1276 
90 155 182 263 297 362 433 440 467 487 539 646 726 840 841 1217 1226 
176 303 310 382 462 521 549 602 764 782 783 788 838 1000 1082 1233 1240 
7 22 47 48 49 95 114 188 203 503 686 690 983 1147 1185 1286 
105 106 305 324 354 426 461 515 729 740 741 916 1008 1051 1052 1133 
89 284 351 441 442 633 648 677 678 769 879 1068 1117 1161 
258 335 336 400 694 720 721 970 971 1025 1034 1181 1242 1262 
91 241 327 429 484 924 940 1064 1145 1172 1174 1175 
238 280 374 394 455 497 635 762 817 1021 1080 1268 
304 608 746 853 854 859 914 955 979 1028 1078 1088 
31 32 104 197 381 454 807 982 1018 1140 1270 
36 111 296 506 703 869 942 943 976 1129 1169 
107 259 260 312 323 370 386 542 570 834 1085 
189 190 444 463 665 907 908 959 1157 1236 1279 
64 65 75 316 317 481 533 589 614 1022 
83 167 281 412 482 483 742 903 1136 1160 
84 85 177 196 311 366 425 524 954 1230 
122 255 586 722 774 814 1002 1107 1269 1277 
40 225 239 276 331 583 880 897 1197 
66 227 465 495 812 866 1098 1173 1249 
148 185 326 367 450 478 630 909 1040 
184 283 302 360 369 385 572 820 1035 
392 406 434 564 611 645 1075 1121 1137 
1 2 346 443 528 723 980 1019 
108 268 508 567 802 803 813 1132 
144 380 692 713 714 1045 1074 1275 
175 257 418 445 660 750 1153 1183 
192 233 457 991 1100 1144 1180 1199 
388 523 784 894 895 1159 1162 1224 
68 136 512 529 587 1188 1237 
319 343 391 856 857 921 946 
328 636 676 799 992 1016 1027 
428 458 504 680 975 1069 1167 
4 201 696 833 1041 1042 
5 20 308 571 600 601 
72 232 377 956 1065 1150 
86 87 166 200 207 522 
103 224 809 855 901 1026 
112 126 717 1010 1024 1130 
113 505 548 575 588 1246 
358 359 657 718 766 1257 
376 430 431 579 1195 1203 
409 491 536 1076 1118 1274 
414 470 595 1009 1158 1234 
736 763 795 915 925 934 
10 21 26 43 1017 
27 246 990 1095 1205 
29 743 1050 1101 1228 
59 501 815 886 1112 
119 659 695 936 973 
132 682 888 889 1123 
179 293 364 520 865 
206 274 872 947 1070 
289 290 432 519 1044 
291 681 910 968 1115 
301 800 988 1071 1146 
320 321 447 1013 1283 
365 751 767 986 1081 
498 670 846 930 931 
537 538 584 639 797 
562 650 754 890 937 
576 939 1253 1260 1265 
13 776 898 899 
17 63 397 1212 
67 704 896 966 
172 755 972 1256 
186 243 266 356 
191 472 1057 1193 
194 553 977 996 
214 215 453 593 
226 355 499 1280 
329 1216 1245 1272 
372 627 811 858 
403 683 875 1125 
438 737 738 1267 
456 573 651 1214 
469 479 628 981 
532 663 1109 1151 
654 674 1204 1254 
733 734 1215 1281 
775 847 870 1011 
827 953 1106 1154 
850 874 1033 1113 
993 1060 1083 1104 
24 271 338 
62 912 960 
100 843 1271 
133 240 605 
135 688 1090 
154 387 1264 
171 417 1063 
187 818 819 
193 672 673 
210 451 490 
220 437 1178 
223 534 1218 
235 279 585 
237 389 1108 
249 765 1235 
250 277 513 
264 1053 1194 
337 507 994 
340 341 824 
344 552 1039 
348 407 658 
401 547 705 
405 449 1116 
471 1227 1255 
476 667 780 
486 821 1122 
543 752 1251 
616 1004 1007 
631 837 1211 
640 655 938 
643 644 964 
669 1020 1208 
706 709 851 
710 789 1091 
712 1089 1170 
757 806 1128 
786 1163 1179 
848 1120 1152 
877 878 1105 
882 883 978 
904 905 1168 
961 962 963 
1046 1165 1252 
1134 1135 1139 
1213 1239 1244 
