142 143 298 299 336 350 459 493 509 518 553 568 570 599 613 680 682 691 697 701 747 749 772 816 846 868 903 919 937 949 965 968 977 1001 1022 1028 1037 1056 1087 1189 
43 282 312 410 417 462 514 529 535 592 623 632 649 650 694 787 799 839 878 893 908 923 935 946 1008 1031 1061 1063 1067 1072 1085 1105 1143 1168 1186 
20 124 139 140 163 198 460 473 474 527 542 548 554 560 577 617 630 764 836 845 852 871 887 1012 1017 1046 1047 1051 1052 1082 1164 1175 1225 
39 65 130 152 171 225 231 296 325 330 585 619 621 654 685 808 828 831 897 1088 1145 1190 1194 1197 1200 1204 1254 
68 76 100 150 260 327 346 347 384 429 480 484 645 690 940 1019 1044 1064 1123 1174 1188 1196 1237 1271 
56 83 138 141 146 156 177 245 363 420 482 609 616 752 771 911 985 994 1004 1007 1023 1166 1251 
5 7 22 47 49 82 86 113 170 203 308 309 571 629 637 924 983 1095 1137 1147 1246 1273 
31 32 102 105 128 185 352 367 450 475 478 483 684 731 773 809 909 1119 1124 1250 
101 373 500 546 562 610 612 628 759 811 896 966 1039 1086 1211 1258 1259 1276 
120 192 233 313 492 677 757 806 807 881 967 991 1032 1062 1128 1136 1199 1270 
154 228 300 648 812 856 857 890 921 958 1026 1041 1042 1092 1098 1140 1172 1173 
24 184 270 271 274 283 302 337 360 369 380 385 479 572 820 1035 1282 
114 129 134 145 220 239 272 276 351 583 633 728 879 880 1161 1185 1187 
0 1 2 4 10 12 13 21 23 26 37 74 469 898 899 1229 
137 165 169 179 223 466 467 508 534 557 567 615 969 1218 1260 
144 190 204 262 286 375 402 419 565 702 708 804 1093 1236 1263 
332 334 357 379 521 581 590 660 712 732 788 843 864 1210 1240 
112 125 164 205 232 249 256 265 273 278 505 678 717 769 
11 133 157 226 604 605 640 641 655 938 1040 1083 1104 
36 59 121 216 242 396 494 516 596 723 785 1100 1192 
81 196 364 372 485 524 869 872 942 943 1038 1057 1230 
115 159 305 358 359 698 718 738 742 766 964 1160 1257 
291 297 306 307 361 377 756 765 800 891 892 1235 1284 
90 91 237 264 293 362 389 433 539 726 865 1108 
209 392 558 625 634 951 960 989 1073 1132 1221 1222 
428 430 458 504 578 666 667 780 818 819 975 1167 
17 45 50 355 499 674 744 834 1000 1127 1280 
46 321 345 653 707 779 930 931 1005 1006 1077 
61 448 471 602 656 793 794 1079 1202 1227 1255 
94 109 136 178 310 374 382 404 587 626 782 
110 620 622 810 917 918 970 971 1034 1043 1162 
208 235 236 279 368 383 488 715 920 932 1138 
8 18 30 33 52 162 801 900 1059 1141 
62 118 288 378 454 703 814 922 1247 1248 
77 88 117 119 131 148 160 295 507 768 
175 222 386 418 569 624 739 885 1153 1288 
186 187 243 266 356 370 754 824 1030 1171 
197 304 323 603 652 955 979 1121 1126 1184 
210 211 318 443 451 457 477 490 575 980 
58 123 199 344 456 489 822 905 1117 
195 387 464 515 729 861 862 1102 1264 
244 530 541 563 566 837 927 1198 1278 
25 95 354 425 426 916 954 1099 
67 408 409 470 536 774 886 1277 
106 122 255 586 719 1002 1071 1269 
176 326 348 412 501 658 687 1209 
181 736 763 777 915 925 934 952 
285 668 692 783 859 1045 1074 1275 
320 537 797 798 848 884 1152 1176 
393 427 447 606 675 748 832 1283 
28 40 98 127 257 331 366 
92 107 414 813 926 1158 1285 
116 149 275 531 642 755 1049 
126 710 1013 1091 1142 1182 1224 
189 247 301 873 988 1058 1146 
214 215 230 405 453 593 1112 
248 436 446 745 974 1114 1203 
251 280 497 635 1016 1080 1268 
267 390 399 424 540 555 1150 
281 659 770 815 936 973 993 
289 290 432 513 519 695 1036 
465 543 544 838 1103 1249 1265 
506 601 669 686 863 1020 1208 
526 662 720 721 1181 1241 1242 
532 538 639 663 760 866 1151 
761 775 776 784 894 904 1011 
57 238 491 1076 1118 1274 
60 388 394 853 914 1078 
70 294 511 792 1010 1024 
158 349 643 644 817 1021 
218 246 901 939 1216 1253 
227 253 353 704 705 830 
314 438 510 735 982 1287 
376 431 579 594 1054 1195 
411 486 574 679 902 1015 
487 821 841 1053 1122 1129 
3 6 41 1131 1266 
27 217 472 1066 1212 
34 103 168 219 855 
35 173 202 229 997 
64 371 481 611 963 
72 435 716 877 1109 
79 80 96 183 339 
87 200 476 522 976 
155 439 591 829 1223 
212 213 342 343 395 
268 700 1050 1075 1101 
269 406 1070 1111 1215 
284 789 790 844 1096 
713 714 733 734 1281 
802 803 847 870 1130 
882 883 978 1155 1156 
14 84 161 646 
19 66 108 338 
29 551 743 1228 
38 89 97 556 
42 252 693 957 
51 598 796 1243 
53 959 1048 1279 
71 455 688 762 
75 259 322 867 
99 254 1084 1148 
166 207 324 1191 
167 400 517 582 
174 449 786 1116 
180 315 520 1149 
182 263 595 1226 
188 512 651 1286 
201 696 823 833 
316 317 589 750 
328 636 676 1027 
329 503 1245 1272 
333 496 910 1115 
340 341 525 1183 
381 413 711 1018 
403 683 875 1125 
415 416 781 876 
461 580 854 1133 
528 576 805 825 
545 552 647 992 
549 706 709 851 
573 737 1214 1267 
618 689 727 933 
627 751 767 1081 
758 953 1165 1252 
850 874 1033 1113 
888 889 956 1169 
906 961 962 1159 
1069 1089 1170 1217 
1201 1213 1239 1244 
16 533 941 
48 73 78 
54 444 445 
55 287 895 
63 135 397 
69 319 1177 
93 258 1262 
111 303 1238 
147 981 1014 
151 421 1157 
153 261 907 
172 972 1256 
193 672 673 
206 452 1234 
234 550 950 
292 849 1009 
365 986 987 
391 434 564 
398 440 995 
401 463 547 
407 928 984 
441 442 1068 
498 670 671 
502 1090 1097 
559 912 1065 
588 858 913 
607 608 746 
638 753 1205 
722 1107 1144 
724 725 730 
791 835 1029 
827 1106 1154 
1134 1135 1139 
