0 36 49 60 61 69 70 73 82 110 111 115 117 131 134 144 150 151 157 158 159 160 174 183 195 210 216 217 227 242 248 294 295 296 303 313 317 333 345 349 350 352 363 379 380 390 399 409 411 421 424 446 464 465 475 480 481 485 488 495 500 506 526 531 533 536 545 551 561 569 577 578 589 594 603 614 621 622 624 625 629 637 638 647 652 653 656 661 671 684 687 692 693 698 703 707 711 713 714 725 731 744 745 747 768 790 791 792 807 812 822 845 860 866 869 887 913 922 939 942 943 967 974 976 1001 1010 1022 1043 1045 1047 1066 1074 1077 1079 1096 1098 1102 1129 1138 1155 1156 1164 1169 1171 1186 1196 1210 1225 1241 1249 1270 1275 1288 
1 2 6 17 34 35 38 39 41 42 53 54 63 71 72 92 97 102 112 124 127 130 139 140 163 165 173 181 194 211 214 215 218 219 221 230 232 253 254 269 273 292 307 314 315 332 334 343 344 357 373 377 378 393 397 403 408 420 435 436 448 453 492 496 502 528 550 552 553 555 556 557 568 590 607 608 619 632 641 659 662 666 667 683 699 701 712 723 732 748 756 757 760 777 805 806 831 844 856 857 859 862 863 864 891 892 921 944 945 949 952 956 973 977 979 980 996 1007 1032 1039 1065 1076 1105 1128 1131 1143 1150 1202 1203 1212 1238 1250 1266 1274 1284 1285 1287 
44 45 46 50 51 57 76 81 93 94 107 116 137 142 143 149 168 169 186 187 234 243 247 259 260 261 266 272 275 297 298 299 312 318 323 356 362 365 370 372 386 413 456 458 466 493 494 509 517 518 542 554 570 573 574 582 599 604 606 612 616 627 628 642 646 651 679 680 706 709 719 749 751 767 773 786 796 811 816 818 819 824 832 834 851 858 868 903 906 918 919 950 965 969 975 986 987 1012 1015 1036 1049 1056 1058 1081 1085 1089 1119 1127 1163 1179 1184 1189 1214 1261 
3 5 7 10 12 13 21 22 26 43 47 96 100 114 129 133 145 184 188 203 262 270 283 302 308 320 321 328 337 339 360 369 375 385 398 402 414 419 447 469 476 479 503 507 530 541 563 565 566 571 572 600 601 605 631 675 686 690 702 708 820 833 837 843 877 878 882 883 902 911 927 978 981 983 985 994 1013 1017 1024 1035 1041 1042 1048 1130 1147 1166 1182 1185 1198 1200 1211 1271 1282 1283 1286 
58 86 87 109 113 120 121 123 152 153 164 199 200 231 236 238 249 280 330 368 383 384 394 404 427 429 441 459 477 489 497 505 516 522 524 548 575 588 596 613 617 618 626 635 685 689 700 715 716 727 739 759 762 765 808 817 828 836 848 852 861 867 917 920 924 932 933 941 1005 1006 1021 1054 1055 1068 1080 1094 1126 1145 1149 1152 1190 1192 1235 1246 1268 
55 56 83 128 138 141 148 155 156 167 185 193 204 240 241 244 245 281 287 326 327 367 376 412 430 431 450 460 478 482 483 484 579 609 630 672 673 771 780 804 873 909 912 960 1023 1040 1062 1083 1124 1160 1172 1173 1174 1175 1195 1278 
62 77 79 88 118 146 191 228 229 251 288 322 342 347 392 406 434 472 473 514 537 538 559 564 584 611 615 639 645 663 722 761 774 797 814 947 948 1046 1057 1070 1075 1093 1107 1121 1137 1148 1165 1193 1247 1248 1252 1277 
9 20 78 161 170 175 198 222 257 265 300 348 353 388 407 415 416 418 445 452 511 558 581 658 660 710 750 753 770 778 781 789 826 830 849 876 885 904 905 928 984 1091 1092 1116 1142 1153 1183 1224 1231 1232 1273 
28 29 40 74 98 171 225 239 276 282 331 371 396 410 417 440 471 525 535 583 592 623 691 697 743 787 839 880 893 897 923 935 989 1038 1050 1061 1063 1067 1072 1073 1101 1187 1197 1201 1227 1228 1255 
91 105 106 122 154 166 207 237 252 255 305 324 354 387 389 426 461 515 586 593 597 649 681 729 741 910 916 940 968 1002 1008 1037 1051 1052 1064 1108 1115 1133 1264 1269 
258 306 336 361 400 401 532 547 640 654 674 694 705 720 721 737 738 742 823 827 953 955 970 971 1034 1106 1109 1151 1154 1181 1204 1242 1254 1262 
136 176 212 213 304 310 382 395 462 521 549 587 591 602 764 779 782 783 788 838 850 874 875 1000 1030 1033 1082 1113 1125 1223 1233 1240 
80 179 180 206 274 293 340 341 364 520 543 544 620 636 676 752 785 799 865 872 992 1016 1027 1103 1213 1239 1244 1251 
90 182 263 264 346 433 443 467 486 487 490 539 643 644 821 840 841 964 1019 1053 1122 1134 1135 1139 1194 1206 1207 1226 
108 132 267 268 329 540 562 567 664 682 775 802 803 813 847 870 888 889 937 993 1011 1114 1123 1132 1216 1245 1272 
11 14 15 19 23 25 30 33 37 52 162 178 209 580 598 801 900 951 1059 1099 1141 1222 1229 1243 
18 32 189 190 197 286 444 463 510 665 724 730 740 835 907 908 959 982 1087 1157 1236 1263 1279 
89 284 285 351 442 610 633 648 650 668 677 678 754 769 879 890 961 962 963 1031 1117 1161 
84 85 172 177 196 311 366 425 498 670 755 846 930 931 954 972 1230 1256 
291 325 438 439 468 527 546 758 793 794 829 1110 1111 1112 1258 1259 1267 1276 
4 8 104 201 233 235 279 381 454 585 696 772 995 1018 1136 1144 1221 
48 95 135 470 560 595 688 825 881 926 938 1009 1090 1097 1158 1234 
99 147 208 220 226 309 355 437 499 655 810 1014 1029 1084 1178 1280 
68 101 202 205 250 277 278 512 529 728 957 997 1086 1188 1237 
192 457 508 735 736 763 795 915 925 934 991 1100 1180 1199 
31 316 358 359 657 718 726 766 1140 1170 1217 1257 
67 301 405 449 704 800 896 966 988 1071 1146 
125 126 523 717 784 894 895 1159 1162 1209 
119 319 374 391 455 491 936 946 1118 
223 256 534 733 734 798 1215 1218 1281 
16 27 246 335 990 1025 1095 1205 
103 224 809 855 884 901 1026 1176 
289 290 432 513 519 634 695 1044 
451 746 853 854 914 1028 1078 1088 
24 271 576 1168 1253 1260 1265 
428 504 776 898 899 1069 1167 
474 669 842 929 958 1020 1208 
59 501 815 871 886 1177 
64 65 66 75 338 
1003 1004 1191 
1060 1104 1120 
