101 188 248 329 330 373 393 404 427 447 475 482 500 503 541 562 566 604 606 612 626 628 724 725 745 747 759 811 816 832 846 861 868 869 887 896 897 903 919 927 937 965 966 968 977 1001 1028 1085 1086 1189 1211 1245 1272 1283 1286 
55 56 83 138 141 146 156 167 177 193 204 244 245 281 327 376 402 403 452 483 530 563 565 609 699 742 752 771 804 911 985 1023 1136 1160 1278 
39 53 124 139 140 163 312 473 487 542 576 577 617 630 645 698 723 727 764 805 836 852 871 933 983 1012 1019 1046 1175 
282 410 417 433 440 514 529 535 592 623 632 649 650 772 787 799 839 865 893 907 908 923 946 1008 1031 1061 1067 1072 1143 
285 314 332 334 357 438 448 506 510 521 590 660 668 669 686 735 736 748 763 788 843 863 864 925 934 982 1240 1287 
0 1 4 10 12 13 21 22 23 26 37 43 74 147 269 453 469 981 1017 1200 1229 
62 134 135 208 294 333 387 424 464 465 488 680 743 845 862 1138 1210 1228 1249 1264 
65 130 152 171 221 231 296 618 619 621 654 722 808 828 831 1145 1190 1194 1204 1254 
184 185 270 271 274 283 302 337 346 360 369 380 385 479 508 572 820 1035 1282 
35 118 129 173 202 220 229 250 255 277 288 378 728 957 997 1247 1248 1269 
61 381 413 471 545 552 602 647 656 711 992 1015 1039 1079 1171 1227 1255 
81 121 196 311 372 396 485 523 524 561 661 709 749 942 943 1057 1230 
79 80 96 183 320 321 339 345 713 714 841 872 918 947 1038 1218 
153 261 325 546 585 610 758 793 794 1002 1111 1112 1116 1258 1259 1276 
168 238 408 409 470 491 536 579 774 855 886 1118 1261 1277 
206 340 341 437 525 544 824 1103 1183 1201 1213 1234 1244 1265 
17 45 50 382 499 674 744 834 1000 1020 1127 1208 1280 
51 176 326 518 526 599 696 697 720 1004 1007 1209 1241 
59 384 494 517 551 569 582 588 858 913 1014 1022 1288 
68 259 260 316 317 323 480 589 603 718 1126 1188 1237 
120 158 233 349 350 446 664 817 967 1021 1050 1101 1114 
6 76 150 347 375 429 940 1063 1064 1093 1184 1266 
543 620 622 810 838 917 959 971 1034 1043 1162 1279 
18 30 33 52 162 178 580 801 900 1059 1141 
28 40 127 145 191 192 272 276 366 902 1193 
46 93 213 368 395 439 653 707 779 930 1077 
210 211 318 443 451 457 474 477 490 548 575 
42 142 143 509 600 629 693 791 1025 1029 
60 304 388 394 746 853 854 914 1078 1088 
112 125 164 265 273 505 671 678 717 769 
25 216 252 425 426 515 916 954 1187 
27 90 237 293 362 389 391 539 1108 
67 94 109 136 200 374 549 587 706 
116 149 275 484 531 642 684 1049 1164 
144 189 190 262 286 419 708 730 1263 
218 230 246 466 901 939 969 1205 1216 
441 442 459 516 596 613 975 1068 1192 
47 306 361 823 833 1041 1042 1147 
70 99 254 792 1010 1024 1058 1130 
77 88 117 119 131 148 295 507 
92 267 399 463 540 547 555 1285 
175 348 407 658 710 733 734 1281 
228 648 812 856 857 921 1140 1172 
241 386 411 533 624 679 687 941 
297 307 420 683 701 756 1107 1284 
335 336 691 694 721 970 1087 1242 
761 784 894 895 973 993 1098 1224 
800 951 988 989 1071 1146 1182 1222 
850 851 874 875 1030 1033 1113 1125 
29 98 224 242 257 331 527 
58 123 344 456 489 822 932 
100 113 690 715 1137 1246 1271 
128 367 450 809 909 1124 1158 
160 291 292 681 849 910 1009 
186 187 243 266 356 818 819 
194 195 553 631 796 837 996 
198 352 560 991 1062 1100 1199 
212 342 343 591 1223 1231 1232 
251 280 497 635 1016 1080 1268 
289 290 432 513 519 695 1044 
310 371 481 611 963 1121 1233 
412 468 780 1084 1110 1117 1178 
5 20 41 63 571 1131 
8 154 418 739 1092 1196 
71 455 688 762 948 1056 
86 87 166 207 324 522 
132 682 888 889 956 1123 
180 199 364 520 1253 1260 
328 636 676 879 1027 1161 
392 495 625 638 753 1221 
406 904 905 1070 1168 1215 
415 416 781 876 928 984 
492 677 757 806 1032 1128 
797 798 814 884 922 1176 
7 126 436 974 1256 
11 157 226 641 1239 
31 454 807 1018 1270 
38 82 89 97 556 
91 106 122 586 719 
114 203 880 924 1185 
181 461 777 952 1133 
201 235 236 279 920 
217 472 795 1180 1212 
225 685 912 960 1197 
258 400 662 1181 1262 
268 700 802 803 1075 
377 414 607 608 1065 
502 825 1090 1097 1202 
537 538 584 639 663 
692 859 1045 1074 1275 
750 751 767 778 1081 
882 883 978 1155 1156 
14 84 161 646 
32 105 773 1119 
72 435 716 877 
102 478 1153 1250 
107 813 926 1132 
155 702 829 1166 
159 643 644 964 
170 1091 1095 1273 
174 786 1163 1179 
182 263 595 1226 
197 652 1102 1198 
205 256 278 287 
209 449 634 1099 
214 215 405 593 
222 223 597 885 
227 401 704 705 
239 379 583 732 
253 353 931 1142 
284 789 790 1096 
305 573 766 1214 
358 359 785 1257 
365 570 986 987 
370 754 890 1026 
383 848 915 1152 
430 431 504 1195 
458 578 666 667 
486 821 1122 1129 
496 501 815 1115 
558 775 1011 1073 
594 637 1054 1066 
726 1069 1170 1217 
782 783 1082 1173 
906 961 962 1159 
9 826 1144 
16 24 511 
19 108 598 
34 103 219 
48 73 78 
49 95 574 
54 444 445 
57 1076 1274 
64 66 338 
69 319 1177 
75 322 867 
110 1109 1151 
111 303 1238 
133 240 605 
165 179 615 
172 755 835 
232 1150 1174 
234 550 950 
247 731 873 
249 765 1235 
298 299 768 
351 498 633 
355 390 729 
397 434 564 
460 554 1089 
462 847 870 
467 534 567 
493 568 949 
512 627 651 
532 760 866 
640 655 938 
659 770 936 
665 740 741 
689 1005 1006 
737 738 1267 
776 898 899 
827 1106 1154 
840 1003 1191 
842 929 958 
878 935 1186 
891 892 1243 
953 1165 1252 
955 979 980 
1047 1048 1225 
1060 1104 1120 
1134 1135 1139 
