6 20 35 38 43 53 61 82 86 89 97 100 113 115 124 129 139 140 163 170 195 203 259 303 305 312 332 368 375 383 392 424 446 464 465 471 473 487 488 515 542 545 556 566 577 594 602 617 625 629 630 637 647 656 664 675 689 690 715 764 791 836 838 841 845 846 852 861 862 887 903 924 932 933 937 983 992 1000 1005 1006 1015 1019 1046 1047 1051 1052 1054 1079 1080 1082 1093 1095 1114 1137 1164 1175 1221 1225 1227 1238 1246 1249 1255 1266 1271 1273 
28 29 40 55 56 83 98 114 127 134 138 141 144 145 146 156 177 186 190 191 192 193 204 224 239 243 244 245 251 257 258 262 266 272 276 277 280 286 327 331 356 366 370 376 402 403 419 431 452 476 510 530 563 565 583 609 672 699 708 752 754 771 804 824 835 842 875 880 890 911 958 982 985 1014 1021 1023 1026 1185 1195 1236 1251 1262 1263 1278 
0 1 2 3 4 5 10 12 15 18 21 22 23 26 30 33 37 41 44 52 74 91 106 122 147 162 226 238 241 255 269 328 351 365 469 491 498 521 571 580 586 601 633 635 636 645 670 676 728 783 799 801 860 882 883 900 957 978 981 986 1016 1017 1027 1059 1118 1131 1141 1193 1200 1229 1233 1268 1269 
9 13 39 79 102 130 152 171 183 221 231 235 236 249 267 279 296 297 306 307 316 339 435 540 555 614 618 621 622 657 683 698 701 716 718 722 727 756 765 800 808 810 828 831 877 891 892 917 918 920 941 971 988 1034 1043 1071 1105 1107 1144 1145 1146 1162 1190 1194 1235 1250 1258 1259 1276 1284 
19 66 101 108 153 159 222 261 300 301 325 373 500 537 538 546 562 570 573 584 585 597 598 604 610 612 639 665 724 725 730 740 743 758 759 766 782 793 794 797 885 896 897 907 919 944 945 964 966 1002 1012 1031 1085 1086 1111 1112 1173 1211 1214 1228 
14 17 24 36 58 59 84 95 121 123 161 166 207 216 242 252 294 317 324 344 371 396 425 441 442 456 466 481 489 494 516 527 596 611 646 648 671 723 822 879 916 954 961 962 963 969 976 1029 1068 1121 1153 1154 1161 1192 1265 
27 47 92 107 217 248 335 390 399 408 409 412 428 468 470 472 501 532 536 541 551 552 579 680 721 760 774 780 795 813 866 886 898 926 927 980 1039 1041 1042 1066 1069 1084 1110 1132 1147 1167 1178 1180 1212 1242 1277 1285 
54 72 194 247 358 359 393 418 427 444 445 447 517 533 553 582 588 606 674 709 726 731 739 747 748 785 816 832 850 851 858 868 869 873 874 906 913 965 968 977 996 1001 1028 1033 1113 1125 1159 1163 1179 1189 1257 1283 
34 80 103 112 125 164 165 172 179 180 181 205 206 219 232 253 273 274 278 287 340 341 353 364 437 461 505 520 525 543 544 560 615 620 777 854 952 1103 1133 1142 1150 1174 1201 1213 1234 
32 51 105 128 142 143 234 298 299 349 350 475 478 482 496 502 509 558 599 682 684 697 719 773 775 809 817 830 889 909 950 989 1011 1037 1073 1090 1115 1124 1138 1158 
16 90 120 233 237 263 264 293 389 430 433 462 492 504 539 643 644 677 678 717 757 769 806 847 865 870 967 1032 1050 1053 1101 1108 1128 1134 1135 1139 1140 1170 
57 65 314 334 357 438 486 508 550 590 613 619 659 660 669 735 736 763 788 796 815 843 863 864 925 934 973 993 1020 1060 1076 1088 1104 1183 1208 1240 1274 1287 
42 46 81 93 196 311 320 321 345 372 485 523 524 561 653 661 693 707 713 714 733 734 779 872 930 931 942 943 947 1025 1038 1057 1077 1155 1156 1230 1281 
76 116 149 150 184 185 270 271 275 283 302 338 347 360 369 384 385 386 429 479 484 531 569 572 624 642 755 820 940 1035 1049 1055 1064 1094 1196 1282 1288 
49 62 63 64 135 173 199 329 330 333 411 448 460 493 503 554 568 574 581 679 712 814 871 904 905 922 949 1022 1089 1117 1148 1168 1202 1216 1245 1272 
25 132 133 189 227 228 240 268 367 379 387 400 401 426 463 547 662 700 704 705 732 761 784 821 856 894 895 1075 1098 1129 1181 1187 1210 1224 1264 
45 50 336 354 381 413 528 576 691 694 696 711 737 744 805 823 825 827 833 834 953 959 970 1087 1097 1106 1119 1127 1165 1252 1267 1279 
67 87 94 109 136 158 174 178 188 198 200 201 310 315 346 382 404 512 522 549 587 626 627 628 651 706 751 786 811 1116 1149 1286 
69 155 212 213 319 342 343 391 395 397 406 434 439 455 564 591 654 688 702 829 857 921 1070 1166 1177 1204 1215 1223 1231 1254 
96 282 398 410 440 450 497 529 535 592 623 632 649 650 772 787 839 878 893 908 923 935 946 995 1008 1061 1067 1072 1143 1186 
60 68 75 197 260 304 322 323 388 394 480 603 638 652 738 749 753 853 867 914 955 979 1078 1126 1184 1188 1237 
7 85 126 151 187 362 436 458 459 578 666 667 745 792 818 819 972 974 975 987 1013 1091 1157 1182 1203 1256 
182 218 230 246 291 292 361 363 420 589 595 616 681 750 767 778 849 901 910 939 1009 1081 1205 1226 1253 
167 175 176 281 326 348 374 407 483 518 526 658 687 710 720 742 936 1004 1007 1136 1160 1209 1241 1243 
111 118 202 229 250 285 288 378 380 506 514 668 686 692 703 859 997 1074 1169 1247 1248 1275 
48 73 77 78 88 104 117 119 131 148 160 295 337 417 507 511 768 990 994 1063 1232 
168 169 223 256 467 534 557 567 798 848 884 915 1045 1120 1152 1176 1217 1218 1260 1261 
31 265 415 416 454 631 770 781 807 826 837 840 876 928 984 1003 1018 1191 1270 
137 210 211 318 443 451 457 474 477 490 548 575 902 929 1048 1206 1207 
70 99 220 254 355 499 729 802 803 1010 1024 1058 1122 1130 1280 
225 377 414 559 607 608 685 746 888 912 956 1065 1197 
11 157 605 640 641 655 776 899 938 1040 1083 1239 
8 71 154 495 600 762 812 948 1056 1092 1172 
110 284 663 789 790 844 1096 1102 1109 1151 1198 
208 209 308 309 449 634 951 960 1099 1222 
289 290 432 513 519 695 1036 1044 
214 215 405 421 453 593 855 
313 352 881 991 1062 1100 1199 
673 1030 1171 
