35 38 39 53 65 67 69 82 86 89 94 97 109 112 114 115 124 125 136 139 140 163 164 170 172 178 201 203 205 235 236 249 256 265 273 278 279 287 308 312 319 329 330 332 382 383 388 404 452 460 473 474 487 503 505 542 554 556 560 576 577 587 594 617 619 626 630 637 671 675 698 723 727 764 797 814 836 841 845 852 857 871 920 921 922 924 932 933 983 1012 1015 1019 1020 1046 1047 1048 1054 1066 1088 1095 1148 1175 1177 1185 1208 1225 1245 1272 1273 
6 8 19 32 61 66 72 76 102 105 108 150 185 197 227 240 248 327 347 367 375 384 386 392 401 418 429 448 450 465 471 475 478 482 484 517 541 545 551 552 566 569 582 588 598 602 625 647 652 656 684 704 705 739 745 773 858 861 903 909 913 927 940 992 1014 1039 1064 1079 1091 1092 1093 1102 1163 1171 1184 1196 1198 1202 1221 1227 1249 1250 1266 1288 
54 101 132 143 153 186 187 243 247 261 266 325 356 370 373 393 427 444 445 447 500 546 562 585 604 606 610 612 665 682 724 725 730 731 740 741 747 748 749 754 758 759 793 794 816 824 832 846 868 869 888 889 890 896 897 907 919 937 944 945 958 965 966 968 977 1001 1002 1026 1028 1030 1055 1085 1086 1094 1111 1116 1123 1189 1211 1258 1259 1276 1283 
51 55 56 83 138 141 146 156 167 175 176 177 193 204 244 245 258 281 326 348 374 376 400 407 430 431 483 496 504 518 526 558 599 609 658 659 662 672 687 696 697 699 710 720 742 752 770 771 775 804 830 840 911 936 985 1003 1004 1007 1011 1023 1037 1073 1115 1136 1160 1181 1191 1195 1209 1241 1243 1251 1262 1278 
49 62 63 79 80 95 135 151 173 183 268 294 333 339 381 411 413 424 458 464 488 495 533 574 578 600 620 622 624 638 666 667 679 680 688 700 709 711 743 753 802 803 810 851 862 887 917 918 941 971 975 987 1034 1043 1075 1119 1138 1157 1162 1179 1205 1228 
34 46 93 103 155 206 212 213 219 274 285 340 341 342 343 358 359 368 395 437 439 498 525 543 544 591 633 653 670 673 689 707 779 785 829 838 930 959 1005 1006 1077 1103 1155 1156 1166 1178 1183 1201 1213 1223 1231 1232 1234 1239 1244 1255 1257 1265 1279 
20 57 100 133 144 190 234 251 262 280 286 314 334 357 402 419 438 476 497 510 521 530 550 563 565 590 605 635 660 669 708 735 736 763 788 835 842 843 863 864 873 925 929 934 950 982 994 1016 1076 1080 1236 1240 1263 1268 1271 1274 1287 
7 16 48 73 78 120 126 158 159 174 233 305 349 350 436 446 492 511 573 643 644 664 677 737 738 757 766 786 806 817 818 964 967 974 984 1013 1032 1050 1051 1052 1063 1101 1114 1128 1182 1203 1214 1267 
0 1 2 4 10 12 15 18 21 22 23 26 30 33 37 43 44 52 74 147 162 253 269 328 353 469 528 580 636 676 801 882 883 900 931 978 981 1017 1027 1059 1141 1142 1200 1229 
27 70 90 99 182 237 254 263 264 293 300 301 362 389 391 397 434 486 539 564 595 654 678 717 769 792 815 821 1010 1024 1053 1058 1067 1108 1122 1129 1130 1134 1135 1139 1204 1226 1254 
25 28 29 40 98 127 134 145 191 192 224 239 257 272 276 277 331 351 366 379 387 426 583 732 761 784 879 880 894 895 902 973 993 1021 1098 1104 1161 1187 1193 1210 1224 1264 
13 17 45 50 284 297 306 307 354 355 361 403 499 674 683 729 744 756 765 789 790 823 833 834 844 874 875 891 892 1000 1096 1105 1107 1113 1125 1127 1233 1235 1280 1284 
14 59 64 81 84 121 161 242 310 316 317 338 371 372 396 441 442 459 481 494 516 523 524 527 596 611 613 646 661 718 942 943 963 1060 1068 1121 1153 1192 
24 36 92 218 230 246 267 291 292 363 390 399 420 463 468 540 547 555 616 681 750 751 767 778 849 901 910 939 976 1009 1022 1081 1084 1110 1216 1285 
96 282 398 410 417 433 440 462 529 535 592 623 632 649 650 772 787 799 839 847 865 870 878 893 908 923 935 946 995 1008 1031 1061 1072 1143 1186 
58 116 123 149 184 270 271 275 283 302 337 344 360 369 385 456 479 489 508 531 572 589 642 755 820 822 906 961 962 1035 1049 1159 1164 1282 
107 128 225 232 377 414 502 559 607 608 685 746 809 813 825 850 912 926 956 1033 1065 1090 1097 1124 1132 1150 1158 1174 1197 
42 142 208 209 216 252 298 299 309 405 425 449 466 509 515 629 634 693 791 916 951 954 960 969 1025 1029 1099 1222 
129 188 202 217 220 229 250 255 346 472 512 627 628 651 728 782 783 795 811 957 997 1082 1173 1180 1212 1269 1286 
111 118 288 378 380 506 514 668 686 692 702 703 798 848 859 884 915 1045 1074 1120 1152 1169 1176 1247 1248 1275 
130 152 171 221 231 296 428 435 618 621 716 722 800 808 828 831 877 988 989 1071 1145 1146 1167 1190 1194 
60 68 75 259 260 304 322 323 365 394 480 570 603 853 854 867 914 955 979 986 1078 1126 1188 1237 
168 214 215 238 408 409 421 453 470 491 536 579 593 774 855 886 1118 1261 1277 
196 311 320 321 345 485 561 713 714 733 734 872 947 1038 1057 1199 1230 1281 
335 336 532 691 694 721 760 805 827 866 953 970 1087 1106 1154 1165 1242 1252 
165 179 180 181 199 364 461 520 581 615 712 777 952 1089 1133 1253 
9 31 415 416 454 614 657 807 826 876 928 1018 1144 1270 
71 154 189 228 455 648 762 812 856 948 1056 1172 
77 88 104 117 119 131 148 160 295 507 768 990 
210 211 318 443 451 457 477 490 548 575 1206 1207 
11 157 226 640 641 655 776 899 938 1040 1083 
47 412 501 780 980 1041 1042 1112 1117 1147 
87 166 200 207 315 324 522 549 706 1149 
110 303 537 538 584 639 663 1109 1151 1238 
113 493 568 690 701 715 949 1137 1246 
137 289 290 432 513 519 695 1036 1044 
222 223 467 534 567 597 885 1218 1260 
91 106 122 241 586 719 819 860 
169 557 726 898 1069 1140 1170 1217 
194 195 553 631 781 796 837 996 
3 5 41 571 601 645 1131 
198 313 352 881 991 1062 1100 
406 904 905 1070 1168 1215 
85 972 1256 
