216 217 242 329 330 349 350 379 399 424 446 464 465 480 481 483 488 493 494 503 509 524 526 531 533 542 554 569 570 574 577 578 582 585 586 588 599 602 603 606 612 613 614 616 618 621 622 624 625 626 629 630 637 638 644 651 652 653 661 674 679 680 682 687 689 690 692 693 698 700 703 706 707 711 716 719 722 723 731 739 744 745 747 749 754 759 762 764 773 785 808 816 822 828 832 836 845 846 852 860 861 866 867 868 869 887 903 905 906 909 916 917 919 922 924 927 932 933 937 950 965 968 972 974 976 977 983 1001 1002 1012 1015 1017 1022 1024 1028 1037 1039 1055 1056 1065 1066 1080 1100 1106 1109 1138 1145 1164 1189 1192 1204 1210 1212 1241 1246 1267 1272 1288 
55 56 83 100 101 128 138 141 144 145 146 154 155 156 167 177 182 193 204 244 245 246 247 262 280 281 326 327 375 376 398 402 403 452 475 476 482 506 530 559 563 565 566 609 699 702 708 752 760 771 786 792 801 804 873 911 914 985 994 1014 1023 1071 1124 1146 1151 1166 1185 1226 1271 1278 
263 264 362 363 371 396 410 417 433 440 450 462 471 478 497 514 529 535 539 592 595 623 632 649 650 691 694 726 772 787 799 839 865 881 893 907 908 923 946 1018 1031 1061 1067 1072 1073 1143 1186 1247 1248 
0 1 2 3 4 5 6 7 8 9 10 11 12 13 14 15 18 19 21 22 23 25 26 30 37 43 47 52 58 59 74 147 162 269 328 469 487 900 981 1053 1147 1193 1209 1229 1239 1245 1266 
34 35 38 39 53 54 71 82 89 92 97 120 122 181 218 219 332 393 556 594 617 619 715 727 831 949 1007 1038 1040 1054 1078 1088 1157 1158 1196 1198 1200 1285 
41 42 72 114 115 129 171 173 178 220 228 229 238 239 250 255 319 347 365 428 686 728 756 863 864 871 957 1103 1131 1177 1187 1269 1284 
67 68 93 94 109 136 161 170 188 200 201 221 304 310 325 372 374 382 383 404 512 523 549 587 696 697 833 1020 1188 1208 1273 
184 185 270 271 274 275 283 302 337 344 346 360 369 380 381 384 385 414 429 447 479 508 572 589 761 820 827 1035 1237 
48 49 125 126 163 172 198 202 203 205 206 232 256 265 278 287 288 352 460 511 560 575 590 856 857 921 1168 1169 
139 140 314 315 334 357 435 496 520 528 571 576 659 732 805 825 829 849 953 973 993 1238 1250 1286 1287 
320 321 345 415 416 454 558 685 713 714 770 781 826 830 876 897 928 984 1090 1097 1110 1197 1218 1281 
233 234 313 425 426 438 439 461 501 580 581 648 823 954 1119 1122 1133 1136 1140 1152 1264 
300 343 677 678 717 769 802 803 812 813 847 931 1091 1092 1130 1132 1142 1159 1184 1224 
44 45 46 50 51 57 76 81 137 149 272 297 336 517 642 1058 1062 1107 1127 
60 61 69 70 73 150 151 157 158 159 174 248 712 853 854 1079 1093 1155 1256 
28 29 40 98 224 225 257 258 331 527 551 743 1050 1077 1101 1176 1228 1262 
85 107 108 127 253 254 276 277 282 311 455 456 573 646 1021 1148 1205 
102 103 112 113 130 164 165 249 273 353 505 670 671 721 1114 1149 1242 
62 63 95 134 135 210 294 333 411 607 960 1094 1099 1179 
77 78 88 104 117 118 119 131 148 160 295 500 507 1009 
408 409 470 491 536 579 774 886 1010 1076 1118 1274 1277 
545 546 552 647 656 793 794 992 1171 1217 1258 1259 1276 
358 359 543 544 596 620 779 838 959 1255 1257 1279 
391 392 397 406 434 472 564 961 962 1075 1137 1221 
121 123 259 260 312 322 323 386 940 941 1126 
214 215 230 252 405 421 453 593 800 1112 1251 
291 292 361 368 468 681 765 910 1084 1115 1235 
377 378 436 448 521 550 660 862 1181 1203 1230 
16 17 20 24 27 36 296 966 1013 1025 
33 486 657 662 821 942 943 1059 1129 1141 
301 388 775 776 784 894 895 904 1011 1162 
306 307 373 420 492 502 683 701 859 1032 
736 763 777 788 795 915 925 934 1180 1240 
850 851 874 875 926 1030 1033 1113 1125 1233 
116 222 223 261 418 427 597 885 1263 
561 562 766 811 964 997 1199 1211 1214 
79 80 96 99 183 339 598 912 
175 176 348 407 658 710 913 1202 
316 317 318 477 718 1036 1089 1170 
809 810 890 901 958 1026 1098 1216 
990 991 1046 1165 1174 1175 1252 1282 
31 32 806 807 870 982 1270 
64 65 66 75 338 1060 1120 
86 87 166 207 324 522 1191 
142 143 168 169 518 855 1261 
186 187 243 266 356 370 824 
289 290 432 513 519 634 695 
354 355 390 489 515 939 1283 
458 459 818 819 969 975 1167 
537 538 583 584 631 639 663 
604 605 640 641 655 688 938 
90 91 226 237 293 1163 
105 106 124 305 1051 1052 
132 133 227 240 241 367 
189 190 286 419 444 1236 
212 213 342 395 591 1223 
236 279 645 920 1019 1160 
389 797 798 848 884 1108 
412 413 568 834 1117 1178 
466 467 534 557 567 615 
510 654 755 791 835 1254 
635 636 675 676 1016 1027 
733 734 995 996 1215 1249 
814 815 935 936 1128 1144 
951 952 988 989 1182 1222 
84 484 485 684 1057 
179 180 199 364 1253 
194 195 553 796 837 
284 285 351 498 633 
340 341 437 525 1183 
643 817 967 1190 1260 
737 738 742 955 1121 
750 751 767 778 1081 
872 918 1041 1042 1049 
110 111 303 753 
191 192 366 445 
208 209 235 1029 
211 451 457 490 
231 610 611 709 
387 394 532 705 
400 401 463 547 
430 431 504 1195 
441 442 516 1068 
473 474 548 902 
666 667 780 1111 
668 669 748 1008 
782 783 1074 1275 
789 790 844 1096 
877 878 1105 1150 
879 880 963 1161 
882 883 978 1156 
970 971 1034 1043 
1005 1006 1087 1095 
1047 1048 1082 1225 
196 197 251 
268 540 555 
298 299 768 
443 979 980 
499 541 1280 
600 601 1045 
627 628 858 
672 673 1265 
704 896 1234 
724 725 730 
757 758 1227 
842 843 929 
888 889 956 
891 892 1243 
898 899 1069 
947 948 1070 
1044 1063 1064 
1134 1135 1139 
1201 1213 1244 
