46 57 72 76 81 94 107 116 128 142 143 149 167 168 169 260 261 272 275 277 298 299 321 323 336 370 386 400 456 494 503 509 517 518 542 554 570 573 582 599 604 606 612 614 616 640 642 651 652 679 680 694 706 709 737 743 749 768 773 785 816 822 823 832 834 846 868 869 903 906 918 942 943 950 961 962 965 970 971 1007 1015 1022 1034 1049 1056 1124 1129 1138 1167 1184 1189 1214 1228 1261 
91 113 115 134 152 153 208 209 231 236 237 250 368 383 389 488 489 515 617 625 629 656 689 700 715 716 727 729 739 759 762 793 794 808 828 836 845 852 861 867 887 917 920 932 940 941 1012 1050 1055 1094 1101 1108 1109 1126 1137 1190 1227 1246 
0 60 61 69 70 73 131 144 150 151 157 158 159 160 174 195 227 248 295 345 349 350 363 421 446 458 464 465 526 531 551 577 578 621 637 638 687 692 707 974 1047 1074 1079 1196 1225 1241 1249 1258 1259 1275 1276 
20 34 35 38 39 54 97 102 127 130 139 140 163 165 181 194 211 218 219 230 273 292 334 393 420 528 553 556 557 568 576 619 632 748 805 825 831 949 952 977 1088 1097 1143 1238 1250 
117 348 352 454 475 480 481 485 500 544 561 603 622 624 653 658 661 684 698 713 714 731 744 747 754 860 913 919 922 1001 1005 1006 1019 1043 1076 1077 1103 1123 1186 1211 1274 
3 6 41 42 71 92 253 269 314 315 332 377 378 435 436 496 550 590 601 641 662 666 728 732 745 862 863 864 888 889 956 957 1041 1042 1131 1150 1164 1266 1285 1287 
27 28 98 183 210 216 217 242 294 313 333 379 390 399 409 411 424 495 536 671 774 789 792 812 866 967 1010 1098 1173 1212 1277 
8 9 11 14 15 19 23 25 30 33 37 52 162 772 801 900 951 995 996 1059 1141 1221 1222 1229 
56 101 138 141 156 182 204 244 245 375 506 530 541 563 609 771 804 837 911 927 1023 1086 1226 1278 
77 79 118 119 129 146 228 251 288 322 347 473 514 538 615 639 663 761 1046 1093 1247 1248 
29 40 282 371 396 410 471 535 592 623 691 787 839 923 935 1067 1072 1073 1255 
198 405 407 416 449 457 511 560 581 770 781 876 928 984 991 1100 1116 1199 1232 
175 192 222 257 340 341 418 445 569 589 660 750 824 885 1153 1183 1288 
13 122 254 255 306 307 373 492 586 701 756 1002 1032 1170 1269 1284 
5 7 22 26 47 49 203 229 571 600 686 983 1017 1024 1147 
10 89 284 285 351 442 633 648 650 668 677 879 890 963 1161 
105 106 124 305 324 354 741 819 916 1008 1029 1051 1052 1168 1191 
184 206 274 283 302 360 369 380 385 452 572 820 872 1035 
83 148 326 367 412 450 482 483 742 909 1136 1160 1178 
108 267 268 540 567 802 803 813 847 870 993 1130 
103 224 469 479 809 855 884 901 981 1026 1176 
126 319 391 849 946 1090 1091 1142 1159 1162 1224 
212 395 439 527 545 546 591 647 829 1223 1231 
225 239 276 331 583 584 631 880 897 1187 1197 
850 851 874 875 881 926 1030 1033 1113 1125 1171 
96 262 339 398 402 419 565 702 708 1166 
136 304 382 462 549 587 764 788 1000 1240 
414 491 720 721 738 936 955 1118 1181 1242 
45 50 51 413 493 598 719 796 1127 
53 190 197 463 907 908 959 1048 1279 
86 170 202 300 388 753 833 1092 1273 
87 166 200 296 476 522 667 780 976 
99 220 226 355 415 437 499 810 1280 
109 178 325 404 468 580 626 1084 1110 
238 280 394 497 635 817 1021 1080 1268 
376 431 594 711 791 835 1066 1119 1195 
4 32 104 201 381 1018 1165 1252 
114 566 675 676 985 1027 1185 1198 
241 327 484 912 1065 1172 1174 1175 
316 358 359 657 718 766 821 1257 
736 763 777 795 915 925 934 1180 
36 110 111 703 790 1096 1102 
44 93 258 297 362 646 1262 
58 328 559 722 814 1107 1148 
84 85 177 311 366 425 954 
120 121 123 164 596 618 1054 
176 310 521 778 782 1082 1233 
249 505 575 588 894 933 1149 
346 627 628 751 767 811 1081 
78 161 710 765 830 1235 
90 263 264 433 440 726 
155 467 487 840 841 1122 
171 417 519 634 1063 1064 
189 286 444 510 982 1263 
213 401 547 712 1036 1089 
214 215 252 453 593 693 
232 343 856 857 921 1169 
246 873 990 1095 1146 1205 
281 470 595 1009 1158 1234 
317 441 516 533 1068 1192 
498 670 930 931 972 1256 
786 891 892 1163 1179 1243 
12 882 883 978 1200 
43 259 312 893 1085 
59 501 871 1112 1177 
66 562 937 964 997 
67 800 896 966 1071 
68 512 529 1188 1237 
82 427 429 924 1145 
100 403 683 843 1271 
154 387 426 1210 1264 
185 478 630 1040 1083 
188 690 877 878 1286 
233 234 1037 1115 1144 
289 290 432 513 1044 
365 472 704 986 987 
636 783 799 992 1016 
757 806 807 1128 1270 
758 827 953 1106 1154 
1 2 659 723 
16 428 430 504 
64 65 75 338 
112 265 717 826 
125 205 278 1209 
132 240 682 1114 
137 318 466 969 
179 293 520 865 
186 243 266 356 
196 523 524 1230 
199 477 905 1117 
303 602 779 838 
320 447 1013 1283 
329 1216 1245 1272 
344 552 555 1039 
357 607 608 760 
384 459 613 975 
392 434 564 1132 
451 746 853 1078 
486 574 902 1217 
525 696 697 1201 
654 674 1204 1254 
733 734 1215 1281 
775 776 784 1011 
17 63 397 
21 611 1075 
24 271 1260 
55 287 895 
80 180 620 
133 605 655 
135 688 938 
173 448 1202 
191 1057 1193 
207 1053 1194 
223 534 1218 
235 279 585 
247 1058 1099 
337 507 994 
353 558 904 
364 372 858 
443 490 980 
460 548 1062 
461 854 1133 
532 705 1151 
543 752 1251 
579 1203 1236 
649 910 968 
664 665 740 
669 1020 1208 
724 725 730 
848 1045 1152 
898 899 1069 
914 1028 1157 
947 948 1070 
989 1061 1182 
1060 1104 1120 
1134 1135 1139 
1213 1239 1244 
