39 53 67 94 109 124 136 139 140 163 178 201 312 319 382 383 404 460 487 542 554 560 576 577 587 594 617 626 630 698 723 727 764 836 841 845 852 871 932 933 983 1012 1015 1019 1020 1054 1066 1177 1208 
101 132 143 373 393 427 447 500 562 604 606 612 682 724 725 730 747 748 749 759 816 832 846 868 869 888 889 896 897 919 937 965 966 968 977 1001 1028 1085 1086 1123 1189 1211 1283 
55 56 83 138 141 146 156 167 176 177 204 244 245 281 326 376 483 609 687 699 742 752 771 804 840 911 985 1003 1004 1007 1023 1136 1160 1191 1251 1278 
62 63 135 294 333 424 458 464 488 578 620 622 666 667 680 688 743 810 862 887 971 975 1034 1043 1138 1228 
282 410 417 433 440 529 535 592 623 632 649 650 772 787 799 839 865 893 908 923 946 1008 1031 1061 1072 1143 
86 112 114 125 164 170 172 203 205 249 256 265 273 278 287 308 388 452 505 637 671 924 1095 1185 1273 
32 102 105 185 197 248 367 450 475 478 482 541 652 684 745 773 903 909 927 1102 1198 1250 
118 288 378 380 514 668 692 798 848 859 884 915 1045 1074 1120 1152 1176 1247 1248 1275 
168 214 215 238 408 409 421 453 470 491 536 579 593 774 855 886 1118 1261 1277 
20 100 144 190 262 286 402 419 476 530 563 565 708 873 994 1236 1263 1271 
206 274 368 395 543 544 653 779 838 959 1077 1103 1213 1234 1239 1244 1255 1279 
72 384 386 392 517 566 569 582 588 625 858 861 913 1014 1163 1221 1288 
153 261 325 546 585 610 665 758 793 794 907 1002 1111 1116 1258 1259 1276 
184 270 271 283 302 337 360 369 385 479 508 572 589 820 1035 1282 
0 1 4 10 12 21 22 26 43 74 147 269 469 981 1017 
130 152 171 221 231 296 618 621 722 808 828 831 1145 1190 1194 
334 357 521 590 660 736 763 788 842 843 864 925 929 934 1240 
6 76 150 327 347 375 429 484 940 1064 1093 1184 1266 
13 297 307 683 756 765 844 891 892 1105 1107 1235 1284 
17 45 50 354 355 499 674 729 744 834 1000 1127 1280 
18 23 30 33 37 52 162 580 801 900 1059 1141 1229 
60 304 323 394 603 853 854 914 955 979 986 1078 1126 
61 448 545 552 602 647 656 992 1039 1079 1171 1202 
134 145 239 272 351 379 583 732 879 880 902 1161 
186 187 243 266 356 370 754 824 890 958 1026 1030 
42 142 298 299 466 509 629 791 969 1025 1029 
59 316 317 459 494 516 596 613 718 1153 1192 
27 90 264 362 391 539 654 1053 1204 1254 
46 93 285 498 633 670 707 930 1155 1156 
51 518 526 599 696 697 720 1209 1241 1243 
129 202 220 229 250 255 728 957 997 1269 
158 349 350 446 664 817 967 1050 1101 1114 
210 211 318 443 451 457 477 490 548 575 
11 157 226 640 641 655 938 1040 1083 
64 310 338 371 481 611 963 1060 1121 
70 678 717 769 792 1010 1024 1058 1130 
92 267 390 399 463 540 547 555 1285 
137 289 290 432 513 519 695 1036 1044 
212 213 342 343 439 591 1223 1231 1232 
761 784 894 895 973 993 1098 1104 1224 
77 88 119 131 148 160 295 507 
116 149 275 531 642 755 1049 1164 
335 336 691 694 721 970 1087 1242 
7 126 436 974 1013 1182 1203 
28 40 127 276 277 366 1021 
35 38 82 89 97 332 556 
65 619 797 814 922 1088 1148 
154 189 228 648 812 856 1172 
159 643 644 757 806 964 1128 
196 485 872 947 1038 1057 1230 
222 223 467 534 597 885 1218 
251 280 497 635 1016 1080 1268 
314 438 510 735 835 982 1287 
340 341 437 525 1178 1183 1201 
8 418 739 1091 1092 1196 
25 387 426 1187 1210 1264 
58 123 344 456 489 822 
66 227 240 465 551 1249 
91 106 122 586 719 819 
107 813 850 926 1033 1132 
110 303 663 1109 1151 1238 
111 506 686 702 703 1169 
128 414 607 809 1124 1158 
218 230 246 901 939 1216 
291 468 681 910 1084 1110 
403 874 875 1113 1125 1233 
29 98 224 257 331 
31 454 807 1018 1270 
47 980 1041 1042 1147 
68 260 480 1188 1237 
71 455 762 948 1056 
79 80 183 339 918 
81 372 524 942 943 
87 166 207 324 522 
113 690 715 1137 1246 
120 233 492 677 1032 
175 348 407 658 710 
180 199 364 520 1253 
181 461 777 952 1133 
182 263 595 1067 1226 
194 195 553 796 996 
198 352 991 1062 1100 
216 425 515 916 954 
217 472 795 1180 1212 
258 400 662 1181 1262 
268 700 802 803 1075 
305 573 766 818 1214 
320 321 345 713 714 
329 330 503 1245 1272 
377 559 956 1065 1150 
412 501 780 1112 1117 
486 815 821 1122 1129 
495 600 638 753 1205 
533 709 851 941 1179 
800 988 989 1071 1146 
3 5 41 1131 
14 84 161 646 
16 511 984 1063 
75 259 322 867 
121 242 396 527 
173 411 624 679 
188 512 651 1286 
225 685 912 1197 
235 236 279 920 
237 293 389 1108 
253 353 931 1142 
284 789 790 1096 
292 750 849 1009 
306 361 823 833 
328 636 676 1027 
346 627 628 811 
358 359 785 1257 
363 420 616 1022 
374 659 770 936 
381 413 711 1119 
415 416 876 928 
430 431 504 1195 
473 474 1046 1175 
493 568 701 949 
496 830 1037 1115 
537 538 584 639 
558 775 1011 1073 
751 767 778 1081 
782 783 1082 1173 
805 953 1165 1252 
882 883 978 1200 
898 1069 1140 1170 
906 961 962 1159 
9 826 1144 
19 108 598 
24 36 976 
34 103 219 
48 73 78 
49 95 574 
54 444 445 
57 1076 1274 
69 857 921 
85 972 1256 
96 398 995 
151 987 1157 
155 829 1166 
165 179 615 
191 192 1193 
200 549 706 
209 634 1099 
234 550 950 
311 561 1199 
397 434 564 
401 704 705 
406 1070 1215 
435 716 877 
441 442 1068 
462 847 870 
532 760 866 
571 601 645 
581 712 1089 
631 781 837 
689 1005 1006 
733 734 1281 
737 738 1267 
827 1106 1154 
878 935 1186 
904 905 1168 
951 960 1222 
1047 1048 1225 
1134 1135 1139 
