55 56 83 138 141 144 146 156 177 190 204 245 251 262 280 286 376 402 419 476 497 530 563 565 605 609 699 708 752 771 804 873 911 985 994 1023 1080 1236 1251 1263 
35 38 53 82 89 97 139 163 312 332 368 383 488 515 542 556 577 617 630 715 743 764 836 852 861 871 932 983 1138 1228 
80 110 111 180 294 303 364 520 538 543 584 620 622 639 663 810 838 887 917 971 1034 1043 1109 1151 1162 1213 1238 1239 1244 
90 120 182 192 233 263 264 362 492 539 595 643 644 677 757 806 967 1032 1050 1053 1067 1101 1128 1226 
282 410 417 433 440 529 535 592 623 632 649 650 772 787 799 839 865 893 923 946 1031 1061 1072 1143 
39 62 95 130 134 135 152 171 221 231 296 621 722 808 828 831 1145 1190 1194 1258 1259 1276 
0 1 2 4 10 12 23 26 37 43 74 147 469 882 883 978 981 1200 1229 
32 102 105 185 248 367 450 475 478 482 541 684 745 773 903 909 927 1091 1250 
101 373 500 537 604 612 724 725 730 759 797 896 897 919 966 1085 1086 1211 
67 93 94 109 136 178 200 201 310 382 404 549 587 626 706 1020 1208 
269 334 357 521 590 660 736 763 788 842 843 864 925 929 934 1233 1240 
143 186 187 243 266 356 370 562 754 824 890 937 958 1026 1030 
268 553 700 747 816 846 868 869 965 968 977 1001 1028 1075 1189 
13 297 306 307 361 756 765 844 891 892 1105 1107 1235 1284 
86 114 170 203 308 388 452 637 880 924 1092 1095 1185 1273 
112 125 164 172 205 249 265 273 278 287 505 678 717 769 
184 270 283 302 337 360 369 385 479 508 572 820 1035 1282 
76 150 327 347 384 386 429 484 569 940 1064 1196 1288 
118 285 288 378 380 514 668 692 859 1074 1247 1248 1275 
142 216 252 298 299 425 466 509 916 954 969 1029 1265 
153 261 325 546 585 610 758 793 794 1002 1111 1112 1116 
17 24 36 58 123 271 344 456 489 723 822 976 
51 518 526 599 662 696 697 720 1181 1209 1241 1243 
72 392 517 582 588 625 858 913 1014 1163 1221 
335 336 532 691 694 721 760 866 970 1087 1242 
415 416 511 631 781 837 876 928 984 1063 1232 
7 126 436 446 664 974 1013 1114 1182 1203 
18 30 33 52 162 580 801 900 1059 1141 
46 206 274 544 653 707 779 1077 1103 1234 
235 236 279 618 689 727 920 933 1005 1006 
545 552 566 647 656 673 845 992 1039 1171 
91 106 122 255 586 719 728 957 1269 
116 149 275 531 642 755 1015 1049 1164 
222 393 427 447 606 748 832 885 1283 
256 798 848 884 915 1045 1120 1152 1176 
408 409 470 536 579 774 886 1118 1277 
528 576 805 827 953 1106 1154 1165 1252 
42 594 629 693 791 1025 1054 1066 
45 50 354 674 744 834 1000 1127 
60 304 394 853 854 914 955 1078 
64 338 371 481 611 1060 1104 1121 
70 792 802 803 1010 1024 1122 1130 
77 88 119 131 148 160 295 507 
167 176 281 326 483 687 1004 1007 
197 323 603 652 979 986 1126 1184 
210 211 318 443 451 457 477 490 
212 213 342 395 439 591 1223 1231 
218 230 246 901 939 1205 1216 1253 
403 683 850 874 875 1033 1113 1125 
761 784 894 895 973 993 1098 1224 
28 145 191 272 366 902 1193 
29 98 224 257 258 331 1262 
92 267 390 399 540 555 1285 
195 333 464 578 666 667 862 
196 485 872 947 1038 1057 1230 
198 352 560 991 1062 1100 1199 
208 209 309 405 449 634 1099 
291 292 681 778 849 910 1009 
314 438 510 735 835 982 1287 
319 343 391 654 1177 1204 1254 
328 635 636 676 1016 1027 1268 
412 468 501 780 1084 1110 1117 
65 619 814 922 1088 1148 
81 372 524 749 942 943 
128 414 607 809 1124 1158 
132 133 240 682 889 1123 
140 473 487 1019 1046 1175 
154 648 812 879 1161 1172 
159 573 766 964 1160 1214 
340 341 437 525 1178 1201 
351 498 633 670 930 931 
381 413 533 711 941 1119 
397 406 434 564 1070 1215 
424 495 600 638 698 753 
8 71 762 948 1056 
20 63 100 1212 1271 
25 387 426 1210 1264 
27 217 472 795 1180 
31 454 807 1018 1270 
40 127 276 277 1021 
47 980 1041 1042 1147 
59 317 494 589 1153 
61 448 602 1079 1202 
66 227 465 551 1249 
68 260 480 1188 1237 
79 183 339 841 918 
87 166 207 324 522 
121 242 396 527 671 
168 421 593 855 1261 
175 348 407 658 710 
181 461 777 952 1133 
189 228 379 732 856 
225 330 685 912 1197 
289 290 432 519 1044 
320 321 345 713 714 
358 359 726 785 1257 
374 659 770 936 1183 
377 559 888 956 1065 
428 458 680 975 1167 
459 516 596 613 1192 
729 790 1096 1102 1198 
800 988 989 1071 1146 
898 1069 1140 1170 1217 
908 959 1008 1255 1279 
3 5 41 1131 
6 375 1093 1266 
11 157 226 641 
14 84 161 646 
57 796 1076 1274 
75 259 322 867 
107 813 926 1132 
113 690 1137 1246 
124 305 1051 1052 
137 513 695 1036 
155 702 829 1166 
158 349 350 817 
173 411 624 679 
188 512 651 1286 
202 229 250 997 
220 355 499 1280 
223 467 534 1218 
237 293 389 1108 
239 244 583 1278 
329 503 1245 1272 
346 627 628 811 
363 420 616 1022 
493 568 701 949 
496 830 1037 1115 
506 686 703 1169 
558 775 1011 1073 
614 657 821 1129 
750 751 767 1081 
782 783 1082 1173 
9 826 1144 
19 108 598 
21 22 1017 
34 103 219 
48 73 78 
54 444 445 
69 857 921 
85 972 1256 
96 398 995 
115 129 675 
151 987 1157 
165 179 615 
214 215 453 
232 1150 1174 
234 550 950 
253 353 1142 
300 301 1058 
365 570 1012 
400 463 547 
401 704 705 
430 431 1195 
435 716 877 
441 442 1068 
462 847 870 
474 548 575 
571 601 645 
581 712 1089 
640 655 938 
709 851 1179 
733 734 1281 
738 742 1136 
840 1003 1191 
878 935 1186 
951 960 1222 
961 962 963 
1047 1048 1225 
1134 1135 1139 
