32 42 49 61 62 64 69 95 102 105 135 142 143 151 174 185 197 208 209 247 248 294 298 299 319 329 330 333 365 367 381 383 384 386 392 411 413 424 449 450 458 459 464 465 466 471 475 478 482 488 495 503 509 517 533 541 545 551 552 566 569 570 578 582 588 600 602 624 625 626 629 634 638 647 652 656 666 667 679 680 684 693 709 711 731 743 745 747 749 753 773 786 791 816 818 819 836 845 851 858 861 862 868 869 873 887 903 909 913 919 927 941 951 965 968 969 975 977 987 992 1001 1014 1015 1025 1028 1029 1039 1055 1060 1079 1094 1099 1102 1119 1138 1157 1163 1171 1177 1179 1189 1198 1221 1222 1227 1228 1245 1249 1250 1255 1272 1288 
36 46 53 81 86 114 115 124 139 140 163 165 170 179 203 205 212 213 265 268 278 287 288 311 312 342 343 346 368 372 395 439 460 473 487 524 542 554 560 561 574 576 577 581 591 594 615 617 630 637 653 675 689 698 700 707 712 723 727 764 779 797 802 803 814 846 852 871 882 883 922 924 930 933 942 943 976 978 983 1005 1006 1012 1019 1046 1047 1048 1051 1052 1054 1066 1075 1077 1089 1095 1155 1156 1175 1185 1223 1225 1231 1232 1273 
5 20 38 39 41 57 63 65 82 89 91 97 100 106 122 130 152 164 171 221 231 241 296 308 309 314 332 334 357 428 435 438 448 510 521 556 571 586 590 601 618 619 621 645 654 660 716 719 722 735 736 763 788 800 808 828 831 835 842 843 860 864 877 925 929 934 982 988 989 1071 1076 1131 1145 1146 1167 1190 1194 1200 1202 1204 1240 1254 1271 1274 1287 
19 54 66 101 108 153 186 187 243 261 266 325 338 356 370 373 393 427 444 445 447 500 546 562 585 598 604 606 610 612 724 725 730 748 754 758 759 793 794 824 832 890 896 897 907 937 944 945 958 966 1002 1026 1030 1085 1086 1111 1116 1211 1258 1259 1276 1283 
27 70 90 99 112 159 237 254 258 264 293 300 301 305 362 389 391 400 532 539 573 643 644 662 678 717 737 738 757 760 766 769 792 806 866 964 1010 1024 1053 1058 1108 1128 1130 1134 1135 1139 1181 1214 1262 1267 
13 128 214 215 218 230 246 249 284 297 307 403 405 414 453 502 593 607 608 683 701 746 756 765 789 790 809 825 844 874 875 891 892 901 1090 1096 1097 1105 1107 1113 1124 1125 1158 1205 1216 1235 1284 
55 56 83 138 141 146 155 156 167 175 176 177 193 204 244 245 281 326 348 376 407 452 483 609 658 672 673 687 699 702 710 742 752 771 804 829 911 985 1004 1007 1023 1136 1160 1166 1243 1251 1278 
0 1 2 3 4 10 12 15 18 21 22 23 26 30 33 37 43 44 52 74 147 162 269 285 328 351 469 498 528 580 633 636 676 801 900 981 994 1017 1027 1059 1141 1193 1229 
25 28 29 40 58 98 123 127 134 145 191 192 216 224 239 252 257 272 276 331 344 366 379 387 425 426 456 489 515 583 732 822 879 880 902 916 932 954 1021 1161 1187 1210 1264 
35 67 93 94 109 129 136 173 178 188 201 202 217 220 229 250 255 277 374 382 404 472 512 587 627 628 651 728 782 783 795 811 957 997 1020 1082 1173 1180 1208 1212 1269 1286 
6 76 116 149 150 184 270 271 275 283 302 327 337 347 360 369 375 385 429 479 484 508 531 572 589 642 755 820 906 940 961 962 1035 1049 1064 1093 1159 1164 1184 1266 1282 
34 79 80 103 183 206 219 274 339 340 341 358 359 437 525 543 544 620 622 785 810 838 841 917 918 959 971 1034 1043 1103 1162 1178 1183 1201 1213 1234 1239 1244 1257 1265 1279 
14 59 84 121 161 242 310 316 317 371 396 441 442 481 494 505 516 523 527 596 611 613 646 661 671 718 761 784 894 895 963 973 993 1068 1098 1121 1153 1192 1224 1233 
96 282 398 410 417 433 440 462 514 529 535 592 623 632 649 650 772 787 799 839 847 865 870 878 893 908 923 935 946 995 1008 1031 1061 1063 1067 1072 1143 1186 
17 45 47 50 306 354 355 361 390 412 468 499 501 674 729 744 780 823 833 834 1000 1041 1042 1084 1112 1117 1127 1147 1280 
92 182 263 267 291 292 363 399 420 463 540 547 555 595 597 616 681 750 751 767 778 849 910 939 1009 1022 1081 1226 1285 
7 16 24 48 73 78 120 126 158 233 349 350 436 446 492 511 664 677 817 967 974 1032 1050 1101 1114 1203 
9 31 225 415 416 454 614 657 685 781 807 826 840 876 912 928 960 984 1003 1018 1110 1144 1191 1197 1270 
60 68 75 259 260 304 322 323 388 394 480 603 853 854 867 914 955 979 980 986 1078 1088 1126 1188 1237 
118 256 378 380 506 668 669 686 692 703 798 848 859 863 884 915 1045 1074 1120 1152 1169 1176 1247 1248 1275 
133 144 190 251 262 280 286 402 419 476 497 530 563 565 605 635 708 1013 1016 1080 1182 1236 1263 1268 
8 71 154 189 222 228 418 455 648 688 739 762 812 856 857 885 921 948 1056 1091 1092 1172 1196 
51 125 486 518 526 599 659 696 697 720 770 815 821 936 1122 1129 1209 1241 
196 223 320 321 345 485 713 714 733 734 872 947 1038 1057 1218 1230 1281 
168 238 408 409 421 470 491 536 579 774 855 886 1118 1261 1277 
335 336 691 694 721 805 827 953 970 1087 1106 1154 1165 1242 1252 
11 157 226 640 641 655 776 898 899 938 1040 1083 1104 
210 211 318 443 451 457 474 477 490 548 575 1206 1207 
77 88 104 117 119 131 148 160 295 507 768 990 
113 235 236 279 493 568 690 715 920 949 1137 1246 
110 111 303 537 538 584 639 663 1109 1151 1238 
180 199 200 315 364 520 549 706 1149 1253 1260 
169 467 534 557 567 726 1069 1140 1170 1217 
227 240 253 273 353 401 704 705 931 1142 
87 166 207 324 430 431 504 522 1195 
137 289 290 432 513 519 695 1036 1044 
397 406 434 564 904 905 1070 1168 1215 
496 558 670 775 830 1011 1037 1073 1115 
107 559 813 850 926 1033 1132 1148 
132 665 682 740 741 888 889 1123 
181 234 461 550 777 950 952 1133 
198 313 352 881 991 1062 1100 1199 
72 232 377 956 1065 1150 1174 
194 195 553 631 796 837 996 
85 172 972 1256 
