36 38 39 53 67 81 82 89 94 97 109 124 136 139 140 163 174 188 201 235 236 249 279 297 307 312 329 330 346 372 374 383 404 460 473 474 487 503 512 524 542 554 556 577 587 594 617 626 627 630 651 683 689 698 701 723 727 747 749 756 764 765 786 816 836 852 868 869 871 891 892 919 920 933 937 942 943 965 968 976 977 983 1001 1019 1028 1046 1047 1048 1051 1052 1054 1066 1107 1163 1175 1179 1189 1200 1225 1235 1245 1272 1284 1286 
32 42 49 61 62 95 105 135 142 143 151 197 208 241 248 294 298 299 333 381 384 386 392 411 413 424 458 464 465 471 475 482 488 495 509 517 533 541 545 551 552 566 569 574 578 582 588 600 602 624 625 629 638 647 652 656 666 667 679 680 687 688 693 709 711 743 745 753 773 791 845 851 858 862 887 903 913 927 941 975 987 992 1014 1025 1029 1039 1055 1079 1094 1102 1119 1138 1157 1171 1198 1221 1227 1228 1249 1288 
54 101 153 184 186 187 243 261 266 270 271 283 302 325 337 356 360 369 370 373 385 393 427 444 445 447 449 459 479 500 508 546 562 572 585 589 604 606 610 612 628 634 748 754 758 759 793 794 811 818 819 820 824 832 890 896 897 907 944 945 958 1002 1026 1030 1035 1085 1086 1111 1116 1211 1258 1259 1276 1283 
7 16 24 27 48 73 77 78 88 90 104 117 119 120 126 131 148 158 159 233 237 264 293 295 305 349 350 362 389 391 436 446 492 507 511 539 573 643 644 664 677 737 738 742 757 766 768 806 817 964 967 974 984 990 1032 1050 1053 1101 1108 1114 1128 1134 1135 1136 1139 1160 1203 1214 1267 
9 31 65 112 130 152 164 171 209 221 225 231 273 296 415 416 428 454 505 558 614 618 619 621 654 657 685 722 775 781 800 807 808 826 828 831 840 876 912 928 951 952 960 988 989 1003 1011 1018 1071 1073 1099 1144 1145 1146 1167 1190 1191 1194 1197 1204 1222 1254 1270 
5 20 41 57 63 91 100 106 122 220 234 255 308 309 314 332 334 357 438 448 510 521 550 571 586 590 601 645 660 719 728 735 736 763 788 842 843 860 864 925 929 934 950 957 982 1076 1131 1202 1240 1269 1271 1274 1287 
55 56 83 138 141 146 155 156 167 177 193 204 244 245 281 327 376 403 483 486 496 609 672 673 699 702 752 771 804 815 821 829 874 875 911 985 1023 1113 1115 1122 1125 1129 1166 1243 1278 
0 1 2 3 4 10 12 13 15 18 21 22 23 26 30 33 37 43 44 52 74 147 162 178 269 328 469 528 580 636 676 801 879 900 981 994 1017 1027 1059 1141 1161 1193 1229 
35 118 129 173 202 205 217 229 250 256 277 278 287 288 378 380 472 506 668 669 686 692 703 782 783 795 859 863 997 1045 1074 1082 1169 1173 1180 1212 1247 1248 1275 
96 282 398 410 417 433 440 462 514 529 535 592 623 632 649 650 772 787 799 839 847 865 870 878 893 908 923 935 946 995 1008 1031 1061 1067 1072 1143 1186 
17 45 47 50 306 354 355 361 382 390 412 468 499 501 674 729 744 780 823 833 834 966 1000 1020 1037 1041 1042 1084 1110 1112 1117 1127 1147 1208 1280 
160 182 214 215 218 230 246 263 291 292 363 405 420 453 466 593 595 616 681 750 751 767 778 849 901 910 939 969 1009 1022 1081 1205 1216 1226 
8 69 71 154 189 222 223 228 319 418 455 597 648 724 725 730 739 762 812 856 857 885 906 921 948 961 962 1056 1092 1159 1172 1177 1196 
115 165 169 179 181 268 461 467 534 557 567 581 615 675 700 712 777 797 798 802 803 814 848 884 915 922 1075 1089 1120 1133 1152 1176 
6 76 116 149 150 196 275 347 375 429 484 485 531 642 684 755 835 940 1015 1049 1057 1063 1064 1093 1164 1184 1230 1266 
25 28 29 40 98 127 134 145 191 192 224 239 257 272 276 331 366 379 387 426 583 732 880 902 1021 1187 1210 1264 
60 68 75 259 260 304 322 323 365 394 480 570 603 853 854 867 914 955 979 980 986 1012 1078 1088 1126 1188 1237 
46 93 212 213 342 343 368 395 439 591 653 707 779 846 882 883 930 978 1005 1006 1077 1155 1156 1223 1231 1232 
34 79 80 103 183 219 339 543 620 622 810 838 841 917 918 959 971 1034 1043 1162 1213 1239 1244 1255 1279 
133 144 190 240 251 262 280 286 402 419 476 497 530 563 565 605 635 708 1013 1016 1080 1182 1236 1263 1268 
64 121 242 310 371 396 481 523 527 611 661 671 761 784 894 895 963 973 993 1060 1098 1121 1224 1233 
107 128 367 414 450 502 559 607 608 746 809 813 825 850 909 926 1033 1090 1097 1124 1132 1148 1158 
114 170 203 265 284 300 301 311 388 452 561 637 789 790 844 924 1091 1095 1096 1105 1185 1273 
14 59 84 102 161 185 316 317 441 442 478 494 516 596 613 646 718 1068 1153 1192 1250 
51 175 176 326 348 407 518 526 599 658 659 696 697 710 720 770 936 1004 1007 1209 1241 
86 87 166 180 199 200 207 315 324 364 430 431 504 520 522 549 706 1149 1195 1253 1260 
19 66 108 227 253 285 338 351 353 401 498 598 633 670 704 705 830 931 1142 
70 99 254 258 400 532 662 678 717 760 769 792 866 1010 1024 1058 1130 1181 1262 
72 92 232 267 377 399 435 463 540 547 555 716 877 956 1065 1150 1174 1285 
58 123 216 252 344 425 456 489 515 665 740 741 822 861 916 932 954 
206 274 340 341 358 359 437 525 544 785 1103 1178 1183 1201 1234 1257 1265 
335 336 576 691 694 721 805 827 953 970 1087 1106 1154 1165 1242 1252 1282 
168 238 408 409 421 470 491 536 579 774 855 886 1118 1251 1261 1277 
85 125 172 198 313 352 560 881 972 991 1062 1100 1199 1256 
11 157 226 640 641 655 776 898 899 938 1040 1083 1104 
210 211 318 443 451 457 477 490 548 575 1206 1207 
320 321 345 713 714 733 734 872 947 1038 1218 1281 
110 111 303 537 538 584 639 663 1109 1151 1238 
113 247 493 568 690 715 731 873 949 1137 1246 
137 289 290 432 513 519 695 1036 1044 
397 406 434 564 904 905 1070 1168 1215 
194 195 553 631 796 837 996 
132 682 888 889 1123 
726 1069 1140 1170 1217 
