0 60 61 69 70 73 131 144 150 151 157 158 159 160 174 195 227 248 295 345 348 349 350 352 363 380 421 446 464 465 526 531 544 551 561 577 578 621 624 637 638 653 658 661 668 687 692 707 713 714 743 822 860 869 913 974 1005 1006 1047 1074 1076 1077 1079 1103 1186 1196 1225 1228 1241 1249 1274 1275 
82 91 113 115 152 153 231 236 237 238 250 280 368 383 384 389 394 427 429 459 488 489 497 515 613 617 625 635 656 689 700 715 716 727 729 739 759 762 793 794 808 817 828 836 845 852 861 867 887 903 917 920 924 932 933 940 941 975 1021 1050 1055 1080 1094 1101 1108 1109 1126 1137 1145 1190 1246 1268 
44 45 46 50 51 57 76 81 93 94 107 116 149 258 260 261 272 297 336 362 370 386 413 486 493 494 503 509 517 518 542 554 570 574 599 604 612 614 640 642 646 694 719 737 749 773 785 816 823 832 834 868 902 906 950 965 970 971 1015 1022 1034 1056 1127 1138 1189 1217 1262 
3 6 41 42 71 92 253 269 314 315 332 365 378 436 496 550 590 601 641 662 666 712 728 732 745 862 863 864 957 1041 1042 1131 1150 1164 1266 1285 1287 
20 34 35 38 39 54 97 102 127 130 139 140 163 165 194 211 218 219 230 292 334 393 553 556 557 568 619 632 748 831 949 977 1088 1143 1238 1250 
13 67 122 181 254 255 306 307 373 377 408 420 435 492 502 528 555 576 586 659 701 756 800 805 825 896 966 1002 1032 1071 1097 1105 1170 1269 1284 
27 28 98 183 210 216 217 242 294 313 333 379 390 399 409 411 424 495 536 671 774 789 790 792 812 844 866 967 1010 1096 1098 1173 1212 1277 
78 161 198 353 407 416 457 511 558 560 581 710 765 770 781 830 876 904 928 984 991 1100 1116 1199 1232 1235 
5 7 21 22 26 47 49 58 203 229 328 571 600 611 629 686 722 814 983 1017 1024 1075 1107 1147 1148 
77 79 118 119 129 146 228 251 288 322 347 473 514 538 615 639 663 761 1046 1093 1247 1248 
9 11 14 15 19 23 25 30 33 37 52 162 209 801 900 951 952 1059 1141 1222 1229 
117 346 454 475 480 481 500 603 622 684 698 731 744 747 754 919 922 1001 1019 1043 1123 
126 232 319 343 391 717 755 778 849 856 857 921 946 1090 1091 1142 1159 1162 1169 1224 
29 40 282 371 396 410 471 535 592 623 691 787 839 923 1067 1072 1227 1255 
83 141 148 185 326 367 412 450 478 482 483 630 742 909 1040 1083 1136 1160 
86 170 172 202 205 206 265 274 278 300 388 452 753 826 833 997 1092 1273 
87 109 136 166 178 200 325 404 468 522 523 524 587 626 872 1084 1110 1230 
101 182 244 245 530 541 563 609 771 837 911 927 1023 1086 1211 1226 1278 
105 106 124 305 324 354 741 916 1008 1029 1051 1052 1168 1191 
184 275 283 302 344 360 369 385 552 572 589 820 1035 1039 
212 395 439 527 545 546 591 647 829 1223 1231 1258 1259 1276 
10 89 284 285 351 498 633 648 650 879 890 963 1161 
96 156 262 339 375 398 402 419 565 702 708 804 1166 
108 267 268 540 567 802 803 813 847 870 993 1104 1130 
134 225 239 276 331 583 584 631 880 897 1187 1197 
222 257 341 418 569 606 660 750 885 1153 1183 1288 
103 224 469 479 809 855 884 901 981 1026 1176 
850 851 874 875 881 926 1030 1033 1113 1125 1171 
99 220 226 355 415 437 499 810 1178 1280 
241 327 484 485 559 912 1065 1172 1174 1175 
36 110 111 506 703 942 943 1102 1129 
53 190 197 463 907 908 959 1048 1279 
376 431 594 711 791 835 1066 1119 1195 
4 32 104 201 381 1018 1165 1252 
56 138 154 204 387 426 1210 1264 
84 85 177 196 311 366 425 954 
112 249 273 505 575 588 894 1149 
114 566 675 676 985 1027 1185 1198 
277 323 456 573 651 652 1184 1214 
304 382 462 549 764 788 1000 1240 
316 358 359 657 718 766 821 1257 
543 636 752 783 799 992 1016 1251 
736 763 777 795 915 925 934 1180 
72 128 167 400 582 1124 1163 
120 121 123 164 596 618 1054 
186 187 243 266 356 818 819 
414 720 721 738 955 1181 1242 
90 263 264 433 440 726 
100 843 888 889 956 1271 
155 467 487 840 841 1122 
176 310 521 782 1082 1233 
189 286 444 510 982 1263 
214 215 252 453 593 693 
233 234 580 1037 1115 1144 
246 873 990 1095 1146 1205 
281 470 595 1009 1158 1234 
321 616 679 918 1007 1049 
441 442 677 678 769 1068 
472 704 961 962 986 987 
670 846 930 931 972 1256 
8 772 995 996 1221 
12 882 883 978 1200 
16 317 516 533 1192 
43 259 312 893 1085 
59 501 871 1112 1177 
66 562 811 937 964 
68 512 529 1188 1237 
142 143 168 169 1261 
171 417 519 1063 1064 
188 690 877 878 1286 
213 401 547 1036 1089 
289 290 432 513 1044 
296 476 667 780 976 
329 1012 1216 1245 1272 
374 455 491 936 1118 
474 669 929 1020 1208 
627 628 751 767 1081 
757 806 807 1128 1270 
758 827 953 1106 1154 
853 914 1028 1078 1157 
935 989 1061 1073 1182 
132 240 682 1114 
137 318 466 969 
179 293 520 865 
199 477 905 1117 
208 405 449 634 
303 602 779 838 
320 447 1013 1283 
392 434 564 1132 
451 490 608 746 
654 674 1204 1254 
733 734 1215 1281 
775 776 784 1011 
848 1045 1120 1152 
1201 1213 1239 1244 
1 2 723 
17 63 397 
24 271 1260 
55 287 895 
65 75 338 
80 180 620 
133 605 655 
135 688 938 
173 448 1202 
175 192 445 
191 1057 1193 
207 1053 1194 
235 279 585 
247 1058 1099 
256 534 798 
298 299 768 
337 507 994 
357 607 760 
364 372 858 
428 430 504 
458 680 1167 
460 548 1062 
461 854 1133 
525 696 697 
532 705 1151 
579 1203 1236 
598 796 1243 
649 910 968 
664 665 740 
706 709 1179 
724 725 730 
786 891 892 
898 899 1069 
947 948 1070 
1134 1135 1139 
