0 69 70 73 83 109 115 117 131 144 159 160 174 195 248 295 325 345 346 348 352 363 380 404 412 454 458 464 468 475 480 481 482 483 485 500 526 531 537 551 561 578 603 621 622 624 626 637 638 653 658 661 684 687 692 693 698 707 711 713 714 725 731 743 744 747 754 783 797 860 887 913 919 922 937 1001 1005 1006 1019 1022 1043 1074 1076 1077 1084 1110 1155 1156 1160 1178 1186 1211 1228 1241 1258 1259 1274 1275 1276 
44 45 46 50 51 57 76 81 93 94 107 116 128 137 149 167 222 258 260 261 272 275 297 323 336 362 370 386 400 413 466 486 493 494 503 509 517 518 542 554 570 574 582 598 599 604 606 612 614 616 642 646 652 679 680 694 706 709 719 737 749 773 785 796 816 823 832 834 868 885 902 903 906 918 950 961 962 965 969 970 971 1004 1007 1012 1015 1034 1049 1056 1119 1124 1127 1138 1167 1184 1189 1217 1243 1262 
72 82 120 121 123 134 152 153 164 208 231 236 250 277 280 368 383 488 489 515 596 617 618 656 689 700 715 716 727 739 759 762 793 794 808 828 836 848 852 861 867 917 920 932 941 1050 1054 1065 1101 1126 1152 1190 1227 
35 38 54 67 97 122 130 163 181 254 255 306 307 373 377 393 408 420 435 492 502 528 555 556 557 586 701 748 756 800 805 825 888 896 952 956 966 1002 1032 1071 1097 1269 1284 
27 28 98 183 209 210 216 217 227 234 242 294 313 333 379 399 409 411 424 465 495 536 544 569 625 671 774 789 792 812 866 967 1010 1098 1103 1115 1173 1212 1249 1277 1288 
42 71 92 173 202 205 253 269 278 314 315 332 378 436 448 496 550 562 590 641 662 666 705 712 728 732 745 862 864 957 964 997 1164 1202 1285 1287 
56 101 138 141 156 182 204 244 245 403 530 541 563 566 609 631 771 804 837 911 927 985 1023 1086 1198 1226 1278 
5 7 20 22 26 47 49 58 62 199 203 308 309 328 477 520 571 600 629 686 814 983 1017 1024 1147 
127 139 140 214 215 218 230 252 395 405 439 453 527 545 546 593 619 647 659 829 1238 
126 212 319 343 374 391 455 778 849 856 857 921 946 1090 1091 1142 1159 1162 1224 1256 
9 11 14 15 19 23 25 30 33 37 52 162 801 900 951 1059 1141 1222 1229 
77 79 118 119 129 146 228 229 251 288 322 347 473 514 615 761 1093 1247 1248 
6 34 39 41 102 165 211 273 292 553 632 831 977 1131 1143 1250 1266 
60 61 150 151 157 158 349 350 421 446 577 845 974 1047 1079 1196 1225 
198 353 407 416 457 511 558 560 581 770 781 876 928 984 991 1100 1199 
10 89 284 285 351 442 633 648 650 668 677 879 890 963 1161 
29 40 282 371 396 410 535 592 623 691 787 839 923 1067 1072 
53 189 190 197 286 444 463 907 908 959 1048 1263 1279 
184 185 283 302 360 369 385 478 572 630 820 1035 1040 
91 237 384 389 459 613 940 975 1055 1064 1094 1108 
99 220 226 355 390 415 437 499 729 810 1029 1280 
106 324 354 426 741 916 939 1008 1037 1168 1253 1265 
113 249 505 575 588 765 894 933 1137 1149 1235 1246 
114 225 239 276 331 583 584 880 897 1185 1187 1197 
148 240 241 326 327 367 450 484 909 1172 1174 1175 
238 394 427 429 497 635 817 924 1021 1080 1145 1268 
86 87 166 200 207 296 476 522 667 780 976 
108 267 268 540 567 802 803 813 847 870 1130 
112 206 265 274 452 717 826 872 947 948 1070 
850 851 874 875 881 926 1030 1033 1113 1125 1171 
96 262 339 375 398 402 419 565 702 708 
136 304 382 462 549 587 764 788 1000 1240 
36 110 111 703 790 844 1096 1102 1105 
100 188 683 690 843 877 878 1271 1286 
175 192 257 341 418 445 660 1153 1183 
4 32 104 201 381 1018 1165 1252 
84 85 177 196 311 366 425 954 
90 263 433 440 467 487 726 1122 
103 224 809 855 884 901 1026 1176 
191 365 472 704 986 987 1057 1193 
316 358 359 657 718 766 821 1257 
317 441 516 533 589 750 1068 1192 
320 447 675 676 1013 1027 1182 1283 
736 763 777 795 915 925 934 1180 
372 627 751 767 811 858 1081 
376 431 594 791 835 1066 1195 
543 636 752 799 992 1016 1251 
124 187 305 818 1051 1052 
170 300 388 753 1092 1273 
176 310 521 782 1082 1233 
213 318 401 547 1036 1089 
246 873 990 1095 1146 1205 
281 470 595 1009 1158 1234 
696 697 935 989 1061 1073 
12 882 883 978 1200 
43 259 312 893 1085 
59 501 871 1112 1177 
64 65 66 75 338 
68 512 529 1188 1237 
135 640 655 688 938 
142 143 168 169 1261 
223 256 534 798 1218 
451 746 853 1078 1088 
757 806 807 1128 1270 
822 869 942 943 1129 
3 337 507 994 
8 772 995 1221 
16 428 430 504 
74 525 1038 1201 
78 161 710 830 
132 682 1114 1123 
154 387 1210 1264 
155 840 841 1166 
179 293 364 865 
186 243 266 356 
219 334 568 949 
291 361 597 681 
301 724 730 988 
303 602 779 838 
329 1216 1245 1272 
357 607 608 760 
392 434 564 1132 
414 720 721 1242 
456 573 651 1214 
469 479 628 981 
506 601 863 1045 
591 1223 1231 1232 
654 674 1204 1254 
733 734 1215 1281 
775 776 784 1011 
1 2 723 
13 898 899 
17 63 397 
21 611 1075 
55 287 895 
80 180 620 
171 417 1063 
193 672 673 
235 279 585 
247 1058 1099 
264 1053 1194 
290 432 513 
298 299 768 
321 330 685 
344 552 1039 
443 490 980 
460 548 1062 
461 854 1133 
491 936 1118 
498 670 972 
523 524 1230 
532 1109 1151 
579 1203 1236 
649 910 968 
664 665 740 
669 1020 1208 
738 955 1181 
786 891 892 
827 1106 1154 
833 1041 1042 
846 930 931 
904 905 1117 
914 1028 1157 
1060 1104 1120 
1134 1135 1139 
1213 1239 1244 
