61 62 134 135 151 208 241 248 294 333 365 384 386 411 424 464 465 488 517 551 569 570 582 588 602 620 622 624 629 679 680 687 743 747 749 810 816 836 845 846 858 862 868 869 913 919 937 965 968 971 977 987 1001 1014 1015 1022 1028 1034 1043 1055 1079 1094 1138 1157 1189 1228 1249 1288 
55 56 83 138 141 144 146 156 177 189 190 193 204 244 245 251 262 280 286 327 376 402 419 476 530 563 565 609 635 672 673 699 702 708 730 752 771 804 911 985 1013 1016 1023 1080 1236 1263 1268 1278 
39 53 124 139 140 163 312 404 473 487 542 577 594 617 626 630 698 723 727 764 871 933 983 1019 1046 1047 1048 1054 1066 1175 1200 1225 
282 410 417 433 440 497 514 529 535 592 623 632 649 650 772 787 799 839 865 893 908 923 946 1008 1031 1061 1067 1072 1143 
9 130 152 171 221 231 296 618 621 654 722 808 826 828 831 1144 1145 1190 1194 1204 1254 
35 118 129 173 202 205 229 250 255 256 277 278 287 288 378 728 957 997 1247 1248 1269 
0 1 4 10 12 13 21 22 23 26 37 74 147 269 469 981 1193 1229 
7 48 112 125 126 164 265 273 436 505 560 671 678 717 769 974 1203 1256 
184 185 270 271 283 302 337 346 360 369 385 479 508 572 589 820 1035 1282 
114 170 203 239 379 388 452 583 637 732 880 924 1091 1095 1185 1187 1273 
28 29 40 98 127 145 191 192 224 257 272 276 331 366 902 1021 
46 93 213 368 395 439 653 707 779 852 882 930 1012 1077 1155 1156 
153 261 325 546 585 610 758 793 794 907 1002 1111 1116 1258 1259 1276 
101 143 373 500 562 604 612 724 725 759 896 897 966 1085 1086 
120 158 233 349 350 446 492 664 677 817 967 1032 1050 1101 1114 
332 334 357 448 521 590 660 736 763 788 843 860 864 1202 1240 
168 238 408 409 470 491 536 579 774 855 886 1118 1261 1277 
17 45 50 382 499 674 744 834 1000 1020 1127 1208 1280 
42 47 142 298 299 509 600 661 693 791 1025 1029 1147 
51 176 326 518 526 599 696 697 720 1004 1007 1209 1241 
6 76 150 347 375 429 940 1063 1064 1093 1184 1266 
18 30 33 52 162 178 580 801 900 1059 1141 
67 94 109 136 188 374 512 587 627 651 1286 
206 274 543 544 838 959 1103 1234 1255 1265 1279 
210 211 318 443 451 457 474 477 490 548 575 
5 20 41 63 100 571 601 645 1131 1271 
284 285 351 498 633 789 790 844 1096 1105 
60 304 394 746 853 854 914 1078 1088 
116 149 275 484 531 642 755 1049 1164 
186 243 266 356 370 754 824 890 1026 
218 230 246 466 901 939 969 1205 1216 
387 541 566 647 656 861 927 1210 1264 
11 157 226 640 641 655 776 938 
25 216 252 425 426 515 916 954 
92 267 399 463 540 547 555 1285 
220 340 341 437 525 1178 1183 1201 
335 336 691 694 721 970 1087 1242 
412 468 501 780 1084 1110 1112 1117 
58 123 344 456 489 822 932 
77 88 119 131 148 295 507 
159 643 644 757 806 964 1128 
160 291 292 681 849 910 1009 
194 195 553 631 796 837 996 
212 342 343 591 1223 1231 1232 
217 472 795 925 934 1180 1212 
289 290 432 513 519 695 1044 
310 371 481 611 963 1121 1233 
314 438 510 735 835 982 1287 
323 603 955 979 980 986 1126 
328 636 676 783 879 1027 1161 
380 668 692 859 1045 1074 1275 
381 413 533 709 711 851 941 
393 427 447 606 748 832 1283 
441 442 516 596 613 1068 1192 
761 784 894 895 973 993 1098 
8 154 418 739 1092 1196 
59 316 317 494 718 1153 
70 792 1010 1024 1058 1130 
71 455 688 762 948 1056 
79 80 183 339 841 918 
107 813 850 926 1033 1132 
128 367 450 809 909 1124 
167 281 483 742 1136 1160 
197 475 652 745 1102 1198 
198 352 991 1062 1100 1199 
209 449 634 951 1099 1222 
297 307 683 756 1107 1284 
306 361 823 833 1041 1042 
320 321 345 713 714 1218 
392 495 625 638 753 1221 
406 904 905 1070 1168 1215 
415 416 781 876 928 984 
797 798 814 884 922 1176 
800 988 989 1071 1146 1182 
27 90 362 391 539 
31 454 807 1018 1270 
38 82 89 97 556 
65 619 659 770 936 
68 260 480 1188 1237 
81 372 524 942 943 
86 166 207 324 522 
91 106 122 586 719 
113 690 715 1137 1246 
132 682 888 889 1123 
175 348 407 658 710 
180 199 364 520 1253 
181 461 777 952 1133 
187 459 818 819 1030 
214 215 405 453 593 
225 685 912 960 1197 
258 400 662 1181 1262 
268 700 802 803 1075 
329 330 503 1245 1272 
403 874 875 1113 1125 
458 578 666 667 975 
537 538 584 639 663 
545 552 992 1039 1171 
750 751 767 778 1081 
906 961 962 1159 1224 
14 84 161 646 
19 66 108 598 
32 105 773 1119 
72 435 716 877 
75 259 322 867 
174 786 1163 1179 
182 263 595 1226 
222 223 597 885 
227 401 704 705 
228 856 857 921 
237 293 389 1108 
253 353 931 1142 
305 573 766 1214 
354 670 830 1037 
358 359 785 1257 
383 848 915 1152 
414 607 608 1158 
486 821 1122 1129 
493 568 701 949 
506 669 686 863 
558 775 1011 1073 
648 812 1140 1172 
726 1069 1170 1217 
805 953 1165 1252 
16 24 511 
34 103 219 
49 95 574 
54 444 445 
57 1076 1274 
69 319 1177 
85 172 972 
96 398 995 
102 478 1250 
110 1109 1151 
111 303 1238 
121 396 523 
133 240 605 
155 829 1166 
165 179 615 
196 485 1230 
200 549 706 
232 1150 1174 
234 550 950 
236 279 920 
247 731 873 
249 765 1235 
355 390 729 
363 420 616 
377 956 1065 
397 434 564 
430 431 1195 
460 554 1089 
462 847 870 
467 534 567 
482 887 903 
496 815 1115 
532 760 866 
628 811 1211 
665 740 741 
689 1005 1006 
733 734 1281 
737 738 1267 
782 1082 1173 
827 1106 1154 
840 1003 1191 
842 929 958 
872 947 1038 
878 935 1186 
891 892 1243 
1060 1104 1120 
1134 1135 1139 
1213 1239 1244 
