3 6 13 20 34 35 38 39 41 42 54 66 67 71 92 97 102 122 127 130 139 140 163 165 181 184 194 211 212 213 218 219 230 253 254 255 269 275 283 292 302 306 307 314 315 332 334 344 357 360 365 369 373 377 378 385 393 395 401 408 420 435 436 439 451 490 492 496 502 527 528 545 546 547 550 552 553 555 556 557 562 568 572 576 586 589 590 591 601 607 608 619 632 641 647 659 662 666 701 712 728 732 745 746 748 756 757 760 800 805 806 807 811 820 825 829 831 859 862 863 864 896 937 944 945 949 957 964 966 977 979 1002 1032 1035 1036 1039 1041 1042 1071 1088 1089 1097 1105 1128 1131 1143 1150 1164 1170 1223 1231 1238 1250 1258 1259 1266 1269 1270 1276 1284 1285 1287 
0 36 60 61 69 70 73 83 110 111 117 131 141 144 148 150 151 157 158 159 160 174 185 195 227 241 248 295 326 327 345 346 348 349 350 352 363 367 376 380 412 421 431 446 450 454 464 465 475 478 480 481 482 483 484 485 500 506 526 531 537 544 551 559 561 577 578 594 603 621 622 624 630 637 638 653 658 661 668 684 687 692 698 703 707 711 713 714 731 742 743 744 747 754 791 797 822 835 860 869 909 912 913 919 922 942 943 974 1001 1005 1006 1019 1040 1043 1047 1065 1066 1074 1076 1077 1079 1083 1102 1103 1119 1123 1129 1136 1155 1156 1160 1172 1174 1175 1186 1195 1196 1225 1228 1241 1249 1274 1275 
16 44 45 46 50 51 57 72 76 81 93 94 107 116 128 132 137 142 143 149 167 168 169 175 192 222 240 247 257 258 260 261 272 277 297 298 299 317 318 321 323 336 340 341 362 370 386 400 413 418 445 456 458 466 486 493 494 503 509 516 517 518 533 542 554 569 570 573 574 582 598 599 604 606 612 614 616 640 642 646 651 652 660 664 665 679 680 682 694 706 709 719 737 740 749 750 768 773 785 796 816 823 824 832 834 868 885 902 906 918 950 965 969 970 971 1003 1004 1007 1015 1022 1034 1049 1056 1058 1099 1114 1124 1127 1138 1153 1163 1167 1179 1183 1184 1189 1192 1214 1217 1243 1261 1262 1288 
82 91 112 113 115 120 121 123 152 153 164 221 231 236 237 238 249 250 273 280 330 368 383 384 389 394 427 429 459 488 489 497 505 515 575 588 596 613 617 618 625 635 643 644 656 685 689 699 700 715 716 727 729 739 759 762 793 794 808 817 828 836 845 852 861 867 887 894 903 917 920 924 932 933 940 941 975 1021 1050 1054 1055 1080 1094 1101 1108 1109 1126 1137 1145 1149 1190 1246 1268 
96 100 101 133 134 145 156 182 193 225 239 244 245 262 276 331 339 375 398 402 403 419 530 539 541 563 565 583 584 605 609 631 655 672 683 702 708 771 786 804 837 843 880 888 889 891 892 897 911 927 956 1023 1086 1166 1187 1197 1211 1226 1271 1278 
68 87 109 136 166 173 176 178 200 291 296 303 304 310 325 361 382 404 448 462 468 476 512 521 522 523 524 529 549 587 597 602 626 667 681 764 779 780 782 788 838 872 976 1000 1082 1084 1110 1188 1202 1230 1233 1237 1240 
78 86 161 170 172 198 202 205 206 265 274 278 300 353 388 407 416 452 457 511 558 560 581 710 753 765 770 781 826 830 833 876 904 928 984 991 997 1092 1100 1116 1199 1232 1235 1273 
27 28 98 183 210 216 217 233 234 242 294 313 333 379 390 399 406 409 411 424 495 536 580 671 774 789 790 792 812 844 866 967 1010 1037 1096 1098 1111 1115 1144 1173 1212 1277 
1 2 5 7 17 21 22 26 47 49 58 62 63 199 203 229 308 309 328 397 477 571 600 611 629 645 686 722 723 814 905 960 983 1017 1024 1075 1107 1117 1121 1147 1148 
56 125 126 135 138 154 204 232 256 319 343 374 387 391 426 455 491 534 688 717 755 778 798 849 856 857 921 936 938 946 1090 1091 1118 1142 1159 1162 1169 1209 1210 1224 1264 
48 95 105 106 124 186 187 235 243 266 279 305 324 354 356 461 585 670 673 741 818 819 846 854 916 930 931 939 972 1008 1029 1051 1052 1133 1168 1191 1253 1256 1265 
24 108 267 268 271 329 508 540 567 735 736 763 775 776 777 784 795 802 803 813 847 870 915 925 934 993 1011 1012 1104 1130 1180 1216 1245 1260 1272 
4 18 31 32 53 104 189 190 197 201 270 286 381 444 463 510 853 907 908 914 959 982 1018 1028 1048 1078 1087 1140 1157 1165 1252 1263 1279 1282 
77 79 88 118 119 129 146 214 215 228 251 252 288 322 342 347 453 460 473 514 538 548 593 615 639 663 693 761 1046 1062 1093 1247 1248 
8 9 11 14 15 19 23 25 30 33 37 52 162 208 209 405 449 634 772 801 900 951 952 995 996 1059 1141 1221 1222 1229 
29 40 282 371 392 396 410 434 471 535 564 592 623 649 691 787 839 910 923 935 968 989 1061 1067 1072 1073 1132 1182 1227 1255 
10 89 284 285 301 351 438 441 442 498 610 633 648 650 677 678 724 725 730 769 879 890 963 988 1031 1068 1161 1267 
114 188 207 320 447 566 675 676 690 758 827 877 878 953 985 1013 1027 1053 1106 1134 1135 1139 1154 1185 1194 1198 1283 1286 
12 59 281 470 501 595 815 848 871 882 883 886 978 1009 1045 1112 1120 1152 1158 1177 1200 1234 
90 155 263 264 316 358 359 433 440 467 487 657 718 726 766 821 840 841 1122 1257 
84 85 103 177 196 224 311 366 425 469 479 809 855 884 901 954 981 1026 1176 
80 179 180 293 364 372 520 620 627 628 751 767 858 865 1081 
414 532 654 674 705 720 721 738 955 1151 1181 1204 1242 1254 
99 147 220 226 355 415 437 499 810 1014 1178 1280 
543 636 752 783 799 992 1016 1201 1213 1239 1244 1251 
850 851 874 875 881 926 1030 1033 1113 1125 1171 
43 171 259 312 417 519 893 1063 1064 1085 
55 287 289 290 432 513 695 895 973 1044 
191 472 704 961 962 986 987 1057 1193 
246 335 873 990 1025 1095 1146 1205 
223 733 734 1215 1218 1281 
428 430 504 579 1203 1236 
64 65 75 338 1060 
74 525 696 697 1038 
474 669 929 1020 1208 
443 980 1206 1207 
337 507 994 
898 899 1069 
947 948 1070 
