67 94 109 136 139 140 178 201 310 312 319 382 383 404 487 542 576 577 587 594 617 626 630 723 764 836 841 845 871 932 983 1015 1019 1020 1054 1066 1177 1208 
144 146 156 177 190 245 251 262 280 286 376 402 419 452 476 497 530 563 565 609 635 702 708 771 804 911 985 994 1016 1080 1166 1236 1263 1268 
282 410 417 433 440 529 535 592 623 632 649 650 772 787 799 839 865 893 908 923 946 1008 1031 1061 1072 1143 
79 80 180 183 339 364 520 543 620 622 810 838 917 918 959 971 1034 1043 1162 1213 1239 1244 1253 1255 1279 
55 56 83 138 141 167 176 204 244 281 326 483 687 699 752 840 1003 1004 1007 1023 1191 1251 1278 
46 93 206 274 285 368 395 498 544 633 653 670 707 779 852 930 1012 1077 1103 1234 
168 214 215 238 408 409 421 453 470 491 536 579 593 774 855 886 1118 1261 1277 
0 1 2 4 10 12 21 22 23 26 43 74 147 269 469 528 981 1017 
102 185 197 248 367 450 475 478 482 541 652 684 745 903 909 927 1184 1250 
153 261 325 546 585 610 665 758 793 794 907 1002 1111 1116 1258 1259 1276 
62 135 195 294 333 424 464 488 578 666 667 743 862 887 1138 1228 
39 130 152 171 221 231 296 621 722 808 828 831 1145 1190 1194 
120 158 233 349 350 446 492 664 677 817 967 1032 1050 1101 1114 
268 700 747 802 803 816 846 868 869 965 968 1001 1028 1075 1189 
334 357 521 590 660 736 763 788 842 843 864 925 929 934 1240 
184 271 283 302 337 360 369 385 479 508 572 589 820 1035 
186 187 243 266 356 370 562 754 824 890 937 958 1026 1030 
13 297 307 683 756 765 844 891 892 1105 1107 1235 1284 
28 40 127 145 191 192 272 276 277 366 902 1021 1193 
51 400 518 526 599 662 696 697 720 1181 1209 1241 1243 
81 196 372 485 524 749 872 942 943 947 1038 1057 1230 
101 373 500 604 612 759 896 897 919 966 1085 1086 1211 
17 45 50 354 355 499 674 744 834 1000 1127 1280 
18 30 33 37 52 162 580 801 900 1059 1141 1229 
42 142 143 298 299 466 509 629 791 969 1025 1029 
118 288 378 380 514 668 692 859 1074 1247 1248 1275 
134 189 228 239 351 379 583 732 856 879 880 1161 
27 90 264 362 539 643 644 757 806 1053 1128 
72 392 517 582 588 625 858 913 1014 1163 1221 
112 125 164 172 205 249 265 273 278 287 505 
86 114 170 203 308 637 924 1095 1185 1273 
110 303 537 538 584 639 663 1109 1151 1238 
210 211 318 443 451 457 477 490 548 575 
235 236 279 618 689 727 920 933 1005 1006 
60 304 388 394 853 854 914 955 1078 
66 227 384 386 465 551 569 1249 1288 
70 678 717 769 792 1010 1024 1058 1130 
92 267 390 399 463 540 547 555 1285 
545 552 566 647 656 861 992 1039 1171 
761 784 894 895 973 993 1098 1104 1224 
8 222 418 739 885 1091 1092 1196 
64 338 371 481 611 963 1060 1121 
77 88 119 131 148 160 295 507 
116 149 275 531 642 755 1049 1164 
129 202 220 229 250 728 957 997 
292 750 751 767 778 849 1009 1081 
335 336 691 694 721 970 1087 1242 
343 391 397 434 564 654 1204 1254 
428 458 459 680 818 819 975 1167 
6 76 150 347 375 1093 1266 
29 98 224 257 258 331 1262 
35 38 82 89 97 332 556 
65 619 797 814 922 1088 1148 
91 106 122 255 586 719 1269 
159 305 573 766 964 1160 1214 
212 213 342 439 591 1223 1231 
218 230 246 901 939 1205 1216 
314 438 510 735 835 982 1287 
340 341 437 525 1178 1183 1201 
393 427 447 606 748 832 1283 
800 952 988 989 1071 1146 1182 
848 884 915 1045 1120 1152 1176 
7 126 436 974 1013 1203 
11 157 226 641 1040 1083 
25 387 426 1187 1210 1264 
58 123 344 456 489 822 
59 316 317 494 718 1153 
107 813 850 926 1033 1132 
128 414 607 809 1124 1158 
132 240 682 888 889 1123 
198 352 560 991 1062 1100 
327 429 484 940 1044 1064 
403 874 875 1113 1125 1233 
31 454 807 1018 1270 
47 980 1041 1042 1147 
61 448 602 1079 1202 
68 260 480 1188 1237 
87 166 207 324 522 
111 506 686 703 1169 
113 690 715 1137 1246 
121 242 396 527 671 
175 348 407 658 710 
182 263 595 1067 1226 
194 553 796 977 996 
216 425 515 916 954 
217 472 795 1180 1212 
291 468 910 1084 1110 
320 321 345 713 714 
323 603 979 986 1126 
329 330 503 1245 1272 
377 559 956 1065 1150 
412 501 780 1112 1117 
415 416 876 928 984 
486 815 821 1122 1129 
495 600 638 698 753 
533 709 851 941 1179 
729 790 1096 1102 1198 
3 5 41 1131 
14 84 161 646 
16 511 1063 1232 
20 63 100 1271 
71 762 948 1056 
75 259 322 867 
137 513 695 1036 
154 648 812 1172 
173 411 624 679 
181 461 777 1133 
188 512 651 1286 
225 685 912 1197 
237 293 389 1108 
253 353 931 1142 
289 290 432 519 
306 361 823 833 
328 636 676 1027 
346 627 628 811 
358 359 785 1257 
363 420 616 1022 
381 413 711 1119 
430 431 504 1195 
467 534 567 1260 
473 474 1046 1175 
493 568 701 949 
496 830 1037 1115 
516 596 613 1192 
558 775 1011 1073 
782 783 1082 1173 
805 953 1165 1252 
882 883 978 1200 
898 1069 1140 1170 
906 961 962 1159 
9 826 1144 
19 108 598 
24 36 976 
32 105 773 
34 103 219 
48 73 78 
49 95 574 
53 124 163 
54 444 445 
57 1076 1274 
69 857 921 
85 972 1256 
96 398 995 
151 987 1157 
165 179 615 
200 549 706 
209 634 1099 
234 550 950 
247 731 873 
311 561 1199 
374 455 688 
401 704 705 
406 1070 1215 
435 716 877 
441 442 1068 
462 847 870 
532 760 866 
571 601 645 
581 712 1089 
631 781 837 
640 655 938 
659 770 936 
724 725 730 
733 734 1281 
738 742 1136 
827 1106 1154 
878 935 1186 
951 960 1222 
1047 1048 1225 
1134 1135 1139 
