32 42 47 49 61 62 95 101 105 134 135 142 143 151 186 187 197 241 243 248 266 294 298 299 333 356 370 373 381 384 386 392 411 413 424 427 447 464 465 471 475 482 488 495 500 509 517 533 541 545 551 552 562 566 569 574 578 582 588 600 602 604 606 612 624 625 629 638 647 652 656 666 667 679 687 693 709 711 743 745 749 753 754 759 773 791 811 824 845 851 858 861 862 869 887 890 896 897 903 913 919 927 937 941 958 966 987 992 1014 1015 1025 1026 1029 1030 1039 1055 1079 1085 1086 1094 1102 1119 1138 1147 1157 1171 1198 1211 1221 1227 1228 1249 1283 1288 
36 46 53 67 81 93 94 109 115 124 136 139 140 163 188 201 212 213 235 236 279 312 329 330 342 343 346 368 372 374 376 383 387 395 404 430 431 439 441 442 460 473 487 503 512 516 524 542 554 577 581 587 591 594 596 613 617 626 627 630 637 651 653 675 689 698 707 712 723 727 747 764 779 797 798 814 816 836 846 848 852 868 871 882 883 884 915 920 922 930 932 933 965 968 976 977 978 983 1001 1005 1006 1019 1028 1046 1047 1048 1054 1066 1068 1077 1089 1120 1152 1155 1156 1175 1176 1189 1192 1195 1210 1223 1225 1231 1232 1245 1264 1272 1286 
25 28 29 40 58 98 114 123 127 145 170 191 192 196 203 205 216 224 239 252 256 257 265 272 276 278 287 300 301 311 331 344 366 379 388 425 426 452 456 474 485 489 515 561 583 732 822 880 902 916 924 954 1021 1057 1091 1095 1185 1187 1230 1273 
14 59 84 102 121 161 184 185 242 270 271 283 302 310 316 317 337 360 369 371 385 396 478 481 494 508 523 527 572 589 611 646 661 718 761 784 820 827 894 895 963 973 993 1035 1040 1083 1098 1104 1106 1121 1153 1154 1224 1233 1250 1282 
7 16 24 48 73 77 78 85 88 104 112 117 119 120 125 126 131 148 158 164 172 233 273 295 349 350 436 446 492 505 507 511 560 664 671 677 678 717 768 769 817 967 972 974 984 990 1032 1050 1101 1114 1203 1256 
0 1 2 3 4 10 12 13 15 18 21 22 23 26 30 33 37 43 44 52 74 147 162 178 269 285 328 351 453 469 498 528 580 633 636 676 801 879 900 981 994 1017 1027 1059 1141 1161 1193 1229 
5 20 39 41 63 72 100 130 152 171 221 225 231 296 308 309 428 435 571 601 618 621 645 654 685 716 722 800 808 828 831 877 912 960 988 989 1071 1131 1145 1146 1167 1190 1194 1197 1200 1204 1254 1271 
35 118 129 173 202 217 220 229 250 255 277 288 378 380 472 506 668 669 686 692 703 728 782 783 795 859 863 925 934 942 943 957 997 1045 1074 1082 1169 1173 1180 1212 1247 1248 1269 1275 
96 264 282 398 410 417 433 440 462 497 514 529 535 592 623 632 649 650 772 787 799 839 847 865 870 878 893 908 923 935 946 995 1008 1031 1053 1061 1067 1072 1134 1135 1139 1143 1186 
57 65 91 106 122 234 314 332 334 357 438 448 510 521 550 586 590 619 659 660 719 735 736 763 770 788 835 842 843 860 864 929 936 950 982 1076 1202 1240 1274 1287 
55 56 83 138 141 146 155 156 167 177 193 204 244 245 281 327 483 486 496 565 609 672 673 699 702 752 771 804 815 821 829 911 985 1023 1115 1122 1129 1166 1278 
17 45 50 306 354 355 361 382 390 412 468 499 501 558 670 674 729 744 775 780 823 830 833 834 1000 1011 1020 1037 1041 1042 1073 1084 1110 1112 1117 1127 1208 1280 
92 160 218 230 246 267 291 292 363 399 420 463 466 540 547 555 576 616 681 750 751 767 778 849 901 910 939 969 1009 1022 1081 1205 1216 1260 1285 
27 90 159 182 237 263 293 305 362 389 391 539 573 595 643 644 737 738 742 757 766 806 964 1051 1052 1108 1128 1136 1160 1214 1226 1267 
34 79 80 103 183 219 339 458 459 543 620 622 680 810 818 819 838 841 917 918 959 971 975 1034 1043 1162 1201 1213 1239 1244 1255 1279 
60 68 75 259 260 304 322 323 365 393 394 480 570 603 748 832 853 854 867 914 955 979 980 986 1012 1078 1088 1126 1188 1237 
107 128 232 367 377 414 450 502 559 607 608 746 809 813 825 850 909 926 956 1033 1065 1090 1097 1124 1132 1148 1150 1158 1174 
133 144 189 190 240 251 262 280 286 402 419 476 530 563 605 635 708 724 725 730 873 1013 1016 1080 1182 1236 1263 1268 
153 174 222 223 261 325 546 585 597 610 758 786 793 794 885 907 1002 1111 1116 1163 1179 1258 1259 1276 
8 69 71 154 228 319 418 455 648 688 739 762 812 856 857 921 948 1056 1092 1172 1177 1196 
116 149 198 275 313 352 484 531 642 684 755 881 906 961 962 991 1049 1062 1100 1159 1164 1199 
6 76 150 165 179 268 347 375 429 615 700 802 803 940 1063 1064 1075 1093 1184 1266 
249 284 297 307 403 683 756 765 789 790 844 874 875 1096 1105 1107 1113 1125 1235 1284 
9 31 415 416 454 614 657 781 807 826 840 876 928 1003 1018 1144 1191 1270 
51 175 176 326 348 407 518 526 599 658 696 697 710 720 1004 1007 1209 1241 
70 99 254 258 400 532 662 760 792 866 1010 1024 1058 1130 1181 1262 
168 238 408 409 421 470 491 536 579 774 855 886 1118 1251 1261 1277 
206 274 340 341 358 359 437 525 544 785 1103 1178 1183 1234 1257 1265 
38 54 82 89 97 181 444 445 461 556 777 952 1133 
210 211 318 443 451 457 477 490 548 575 1206 1207 
320 321 345 713 714 733 734 872 947 1038 1218 1281 
335 336 691 694 721 805 953 970 1087 1165 1242 1252 
110 111 303 537 538 584 639 663 1109 1151 1238 
113 247 493 568 690 701 715 731 949 1137 1246 
208 209 214 215 405 449 593 634 951 1099 1222 
11 157 226 640 641 655 776 898 899 938 
19 64 66 108 338 598 891 892 1060 1243 
169 467 534 557 567 726 1069 1140 1170 1217 
180 199 200 315 364 520 549 706 1149 1253 
137 289 290 432 513 519 695 1036 1044 
397 406 434 564 904 905 1070 1168 1215 
132 665 682 740 741 888 889 1123 
227 253 353 401 704 705 931 1142 
86 87 166 207 324 504 522 
194 195 553 631 796 837 996 
