3 6 20 34 35 38 39 41 42 54 67 71 92 97 102 122 127 130 139 140 163 165 173 181 184 194 211 212 214 215 218 219 230 253 254 255 269 273 283 291 292 302 306 307 314 315 332 334 344 357 360 361 365 369 373 377 378 385 393 395 408 420 435 436 439 448 453 492 496 502 520 527 528 545 546 550 552 553 555 556 557 562 568 572 586 590 591 593 601 607 608 619 632 641 647 659 662 666 701 705 712 728 732 745 748 756 760 800 805 820 825 829 831 844 859 862 863 864 888 889 896 939 944 945 949 956 957 964 966 977 979 1002 1032 1035 1039 1041 1042 1071 1078 1088 1097 1105 1131 1143 1150 1164 1202 1223 1231 1238 1250 1266 1269 1284 1285 1287 
44 45 46 50 51 57 76 81 93 94 107 116 128 137 142 143 149 167 168 169 213 247 258 259 260 261 272 275 277 297 298 299 318 323 336 362 370 386 400 401 413 456 458 466 486 493 494 503 509 517 518 542 547 554 570 573 574 582 598 599 604 606 612 614 616 642 646 651 652 664 665 679 680 682 694 706 709 719 737 740 749 768 773 785 796 816 823 832 834 868 902 903 906 918 950 961 962 965 969 970 971 975 1004 1007 1012 1015 1034 1036 1049 1056 1058 1069 1089 1099 1114 1124 1127 1138 1167 1170 1184 1189 1214 1217 1243 1261 1262 
0 36 60 61 69 70 73 110 111 117 131 144 150 151 157 158 159 160 174 195 227 248 295 345 346 348 349 350 352 363 380 412 421 446 454 464 465 475 480 481 482 483 485 500 526 531 537 544 551 561 577 578 603 621 622 624 637 638 653 658 661 684 687 692 698 703 707 713 714 725 731 738 742 743 744 747 783 790 797 822 860 869 913 919 922 937 942 943 974 1001 1019 1022 1043 1047 1074 1076 1077 1079 1096 1102 1103 1123 1129 1136 1155 1156 1160 1178 1186 1196 1225 1228 1241 1249 1258 1259 1274 1275 1276 
72 82 91 113 115 120 121 123 134 152 153 164 208 209 221 231 236 237 238 249 250 280 289 290 330 368 383 384 389 394 427 429 432 459 488 489 497 505 513 515 523 575 588 596 613 617 618 625 635 643 644 656 685 689 699 700 715 716 727 729 739 754 759 762 765 793 794 808 817 828 836 845 848 852 861 867 887 894 917 920 924 932 933 940 941 1005 1006 1021 1044 1050 1054 1055 1064 1065 1080 1094 1101 1108 1109 1126 1137 1145 1149 1152 1190 1235 1246 1268 
1 2 5 7 10 17 21 22 26 47 49 58 62 63 79 118 125 129 146 199 203 228 229 251 288 308 309 322 328 347 397 473 477 514 538 571 600 611 615 629 639 645 663 686 722 723 761 814 905 960 983 1017 1024 1045 1046 1075 1093 1107 1117 1121 1147 1209 1247 1248 
77 78 88 112 119 161 170 186 198 202 206 243 265 266 274 300 321 342 353 356 388 405 407 416 449 452 457 511 558 560 581 710 717 753 770 781 826 830 833 872 876 904 928 984 991 997 1092 1100 1116 1199 1232 1273 
56 83 96 101 133 138 141 145 156 182 193 204 244 245 262 339 375 398 402 419 506 530 539 541 563 565 605 609 672 673 702 708 771 786 804 837 873 891 892 911 927 1023 1086 1146 1163 1166 1179 1226 1278 
126 135 154 172 205 222 223 232 256 278 319 343 374 387 391 455 532 534 597 640 655 681 688 733 734 755 798 849 856 857 885 921 938 946 1090 1091 1142 1151 1159 1162 1169 1210 1215 1218 1224 1256 1264 1281 
68 86 87 109 136 166 176 178 200 296 303 304 310 325 382 404 462 468 476 512 521 522 524 529 549 580 587 602 626 667 764 778 779 780 782 788 838 976 1000 1082 1084 1110 1188 1230 1233 1237 1240 
4 13 18 31 32 53 104 189 190 197 201 235 270 279 286 381 444 463 510 585 898 899 907 908 914 959 982 1018 1028 1048 1087 1140 1157 1165 1252 1263 1279 1282 
27 28 98 183 210 216 217 233 234 242 294 313 333 379 390 399 406 409 411 424 495 536 671 774 789 792 812 866 967 1010 1098 1111 1115 1144 1173 1212 1277 
24 108 267 268 271 329 508 540 567 576 735 736 763 775 776 777 784 795 802 803 813 847 870 915 925 934 993 1011 1130 1180 1216 1245 1260 1272 
48 95 105 106 124 187 305 324 354 426 461 498 670 741 818 819 846 854 916 930 931 972 1003 1008 1029 1037 1051 1052 1133 1168 1191 1253 1265 
89 284 285 301 351 438 442 543 610 633 636 648 650 668 677 678 724 730 752 769 799 842 879 890 958 963 988 992 1016 1031 1161 1251 1267 
29 40 282 371 392 396 410 434 471 535 564 592 623 649 691 696 697 787 839 910 923 935 968 989 1061 1067 1072 1073 1132 1227 1255 
8 9 11 14 15 19 23 25 30 33 37 52 162 772 801 900 951 952 995 996 1059 1141 1213 1221 1222 1229 1239 1244 
16 175 257 317 340 341 418 428 430 441 445 504 516 533 569 589 660 750 824 1068 1153 1183 1192 1288 
114 188 225 239 276 331 566 583 584 631 675 676 877 878 880 897 985 1027 1185 1187 1197 1198 1286 
84 85 103 177 192 196 224 311 366 425 469 479 628 809 855 884 901 954 981 1026 1176 
90 155 263 316 358 359 433 440 467 487 657 718 726 766 821 840 841 1122 1257 
132 148 185 240 241 326 327 367 450 478 484 630 909 912 1040 1083 1172 1174 1175 
12 59 281 470 501 595 815 871 882 883 886 978 1009 1112 1158 1177 1200 1234 
100 403 683 690 757 758 806 807 827 843 953 1106 1128 1154 1270 1271 
80 179 180 293 364 372 620 627 751 767 811 858 865 1081 1211 
414 491 559 654 674 720 721 936 955 1118 1148 1181 1204 1242 1254 
252 376 431 460 548 594 693 711 791 835 1062 1066 1119 1195 
43 74 171 312 417 519 525 634 893 1038 1063 1085 1201 
207 264 320 447 1013 1053 1134 1135 1139 1182 1194 1283 
99 147 220 226 355 415 437 499 810 1014 1280 
850 851 874 875 881 926 1030 1033 1113 1125 1171 
64 65 66 75 338 1060 1104 1120 
443 451 490 746 853 980 1206 1207 
191 472 704 986 987 1057 1193 
246 335 990 1025 1095 1205 
55 287 695 895 973 
474 669 929 1020 1208 
337 507 994 
579 1203 1236 
947 948 1070 
