55 56 83 138 141 146 156 167 176 177 204 239 244 245 281 326 376 452 483 583 609 687 699 752 771 804 840 911 985 994 1003 1004 1007 1023 1191 1251 1278 
72 386 392 517 553 569 582 588 625 747 749 816 846 852 858 868 869 913 965 968 977 1001 1012 1014 1022 1028 1163 1189 1221 1288 
101 329 330 373 393 427 447 500 503 537 604 606 612 724 725 730 748 759 797 832 896 897 919 966 1085 1086 1211 1245 1272 1283 
35 38 53 89 97 139 140 163 312 473 487 542 556 577 594 617 630 723 764 836 841 871 983 1019 1046 1054 1066 1175 
282 410 417 433 440 529 535 592 623 632 649 650 772 787 799 839 865 893 908 923 946 1008 1031 1061 1072 1143 
80 180 294 364 520 543 620 622 810 838 887 917 959 971 1034 1043 1162 1213 1239 1244 1253 1255 1279 
168 214 215 238 408 409 421 453 470 491 536 579 593 774 855 886 1118 1261 1277 
20 24 62 63 65 100 130 134 135 296 619 621 1088 1194 1258 1259 1271 1276 
32 102 105 185 248 367 450 475 478 482 541 684 745 773 903 909 927 1250 
0 1 2 4 10 12 21 22 26 43 74 147 269 469 981 1017 1193 
42 142 216 252 298 299 425 466 509 629 693 791 916 954 969 1025 1029 
67 93 94 109 136 178 200 201 310 382 404 549 587 626 706 1020 1208 
184 270 271 283 302 337 360 369 385 479 508 572 589 820 1035 1282 
332 334 357 521 590 660 736 763 788 842 843 864 925 929 934 1240 
143 186 187 243 266 356 370 562 754 824 890 937 958 1026 1030 
13 297 306 307 361 756 765 844 891 892 1105 1107 1235 1284 
86 114 170 203 308 351 637 879 880 924 1095 1161 1185 1273 
144 190 262 286 402 419 476 530 563 565 708 873 1236 1263 
18 23 30 33 37 52 162 580 801 900 1059 1141 1229 
51 400 518 526 599 662 696 697 720 1181 1209 1241 1243 
17 45 50 354 355 499 674 744 834 1000 1127 1280 
118 288 378 380 514 668 692 859 1074 1247 1248 1275 
153 261 325 546 585 610 758 793 794 1002 1111 1116 
27 90 264 362 539 643 644 757 806 1053 1128 
39 152 171 221 231 722 808 828 831 1145 1190 
112 125 164 172 205 249 265 273 278 287 505 
335 336 532 691 694 721 760 866 970 1087 1242 
107 128 414 607 809 813 926 1124 1132 1158 
110 538 584 639 663 729 1102 1109 1151 1198 
158 349 350 446 664 817 967 1050 1101 1114 
235 236 279 618 689 727 920 933 1005 1006 
291 292 750 751 767 778 849 910 1009 1081 
545 552 566 647 656 845 861 992 1039 1171 
60 304 388 394 853 854 914 955 1078 
76 150 327 347 384 429 484 940 1064 
81 196 372 485 524 942 943 1057 1230 
92 267 390 399 463 540 547 555 1285 
116 149 275 531 642 755 1015 1049 1164 
197 323 603 652 979 986 1126 1184 1192 
403 683 850 874 875 1033 1113 1125 1233 
761 784 894 895 973 993 1098 1104 1224 
8 222 418 739 885 1091 1092 1196 
64 338 371 481 611 963 1060 1121 
70 792 802 803 1010 1024 1058 1130 
77 88 119 131 148 160 295 507 
82 368 383 488 715 743 932 1228 
195 333 464 515 578 666 667 862 
206 274 544 653 779 1077 1103 1234 
210 211 318 443 451 457 477 490 
212 213 342 395 439 591 1223 1231 
412 468 501 780 1084 1110 1112 1117 
415 416 631 781 837 876 928 984 
28 145 191 192 272 366 902 
29 98 224 257 258 331 1262 
111 303 506 686 703 1169 1238 
198 352 560 991 1062 1100 1199 
208 209 309 405 449 634 1099 
251 280 497 635 1016 1080 1268 
314 438 510 735 835 982 1287 
319 343 391 654 1177 1204 1254 
424 495 600 638 698 753 1205 
441 442 459 516 596 613 1068 
848 884 915 1045 1120 1152 1176 
7 126 436 974 1013 1203 
11 157 226 641 1040 1083 
58 123 344 456 489 822 
59 316 317 494 718 1153 
129 220 255 728 957 1269 
132 240 682 888 889 1123 
159 573 766 964 1160 1214 
218 230 246 901 939 1216 
285 498 633 670 930 931 
289 290 432 519 695 1044 
340 341 437 525 1178 1201 
528 576 805 953 1165 1252 
800 988 989 1071 1146 1182 
25 387 426 1210 1264 
31 454 807 1018 1270 
40 127 276 277 1021 
47 980 1041 1042 1147 
61 448 602 1079 1202 
66 227 465 551 1249 
68 260 480 1188 1237 
87 166 207 324 522 
91 106 122 586 719 
120 233 492 677 1032 
121 242 396 527 671 
175 348 407 658 710 
181 461 777 952 1133 
182 263 595 1067 1226 
189 228 379 732 856 
217 472 795 1180 1212 
320 321 345 713 714 
374 659 770 936 1183 
377 559 956 1065 1150 
428 458 680 975 1167 
533 709 851 941 1179 
906 961 962 1138 1159 
3 5 41 1131 
6 375 1093 1266 
14 84 161 646 
16 511 1063 1232 
46 707 1155 1156 
57 796 1076 1274 
71 762 948 1056 
75 259 322 867 
79 183 339 918 
113 690 1137 1246 
124 305 1051 1052 
154 648 812 1172 
155 702 829 1166 
173 411 624 679 
188 512 651 1286 
202 229 250 997 
225 685 912 1197 
237 293 389 1108 
284 789 790 1096 
328 636 676 1027 
346 627 628 811 
358 359 785 1257 
381 413 711 1119 
430 431 504 1195 
493 568 701 949 
496 830 1037 1115 
558 775 1011 1073 
614 657 821 1129 
782 783 1082 1173 
882 883 978 1200 
898 1069 1140 1170 
9 826 1144 
19 108 598 
34 103 219 
48 73 78 
49 95 574 
54 444 445 
69 857 921 
85 972 1256 
96 398 995 
137 513 1036 
151 987 1157 
165 179 615 
223 534 1218 
234 550 950 
253 353 1142 
268 700 1075 
363 420 616 
397 434 564 
401 704 705 
406 1070 1215 
435 716 877 
462 847 870 
467 567 1260 
474 548 575 
486 815 1122 
571 601 645 
581 712 1089 
597 681 1187 
640 655 938 
678 717 769 
733 734 1281 
738 742 1136 
814 922 1148 
827 1106 1154 
872 947 1038 
878 935 1186 
951 960 1222 
1047 1048 1225 
1134 1135 1139 
