32 42 49 61 62 95 105 134 135 142 151 197 208 209 214 215 241 247 248 268 294 298 299 329 330 333 358 359 365 371 381 384 386 392 405 411 413 424 449 458 464 465 471 475 481 482 488 495 503 509 517 533 541 545 551 552 566 569 570 574 578 582 588 593 600 602 611 620 622 624 625 629 634 638 647 652 656 666 667 679 680 687 693 700 709 711 731 743 745 747 749 753 773 785 791 803 810 816 836 845 846 851 852 858 862 868 869 873 887 903 913 917 919 927 937 941 951 965 968 971 975 977 987 992 1001 1012 1014 1015 1022 1028 1029 1034 1039 1043 1055 1056 1075 1079 1094 1099 1102 1119 1121 1138 1157 1162 1171 1189 1198 1221 1222 1227 1228 1245 1249 1257 1272 1288 
36 39 46 53 124 139 140 160 163 212 213 235 236 279 291 292 310 312 342 343 363 368 383 387 395 420 439 441 442 460 473 474 487 516 542 554 577 591 596 613 616 617 626 630 653 681 689 698 707 723 727 764 779 848 849 871 882 883 910 915 920 930 933 976 978 983 1005 1006 1009 1019 1046 1047 1048 1068 1077 1089 1152 1155 1156 1175 1192 1200 1210 1223 1225 1231 1232 1264 
54 101 143 153 174 186 187 222 223 243 261 266 325 356 370 373 393 427 444 445 447 459 500 546 562 585 597 604 606 610 612 628 724 725 730 748 754 758 759 786 793 794 811 818 819 824 832 885 890 896 897 907 944 945 958 966 1002 1026 1030 1085 1086 1111 1116 1163 1179 1211 1258 1259 1276 1283 
38 51 57 65 82 89 97 175 176 181 234 314 326 332 334 348 357 407 438 448 461 510 518 521 526 550 556 590 599 619 658 659 660 696 697 710 720 735 736 763 770 777 788 835 842 843 864 929 936 950 952 982 1004 1007 1076 1133 1202 1209 1233 1240 1241 1274 1287 
9 31 72 79 80 91 106 122 152 171 183 221 231 255 339 415 416 428 435 454 586 614 618 654 657 716 719 722 781 800 807 808 826 828 831 840 841 860 876 877 918 928 984 988 989 1003 1018 1025 1071 1144 1145 1146 1167 1182 1190 1191 1204 1254 1269 1270 
16 24 27 48 73 78 90 120 158 159 182 233 237 263 293 305 349 350 362 389 391 436 446 492 511 539 573 595 643 644 664 677 737 738 742 757 766 806 817 964 967 974 1032 1050 1051 1052 1101 1108 1114 1128 1136 1160 1203 1214 1226 1267 
0 1 2 3 4 10 12 13 15 18 21 22 23 26 30 33 37 43 44 52 74 147 162 178 269 284 285 328 351 453 469 498 528 580 633 636 676 801 879 900 981 994 1017 1027 1059 1141 1161 1193 1229 
25 28 29 40 58 98 114 123 127 145 170 191 192 203 216 224 239 252 257 265 272 276 331 344 366 379 388 425 426 452 456 489 515 583 732 822 861 880 902 916 924 932 954 1021 1091 1095 1185 1187 1273 
35 118 129 173 202 217 220 229 250 277 288 340 341 378 380 437 472 506 525 668 669 686 692 703 728 782 783 795 859 863 925 934 957 997 1045 1074 1082 1169 1173 1178 1180 1183 1201 1212 1247 1248 1275 
96 264 282 398 410 417 433 440 462 497 514 529 535 592 623 632 649 650 772 787 799 802 839 847 865 870 878 893 908 923 935 946 995 1008 1031 1053 1061 1067 1072 1134 1135 1139 1143 1186 
67 81 93 94 109 121 136 188 196 201 242 311 372 374 382 396 404 485 512 523 524 527 561 587 627 651 661 761 784 894 895 942 943 973 993 1020 1057 1098 1208 1224 1230 1286 
34 103 184 185 206 219 270 271 274 275 283 302 337 346 360 369 385 479 508 543 544 572 589 750 751 767 778 820 838 959 1035 1081 1103 1213 1234 1239 1244 1255 1265 1279 1282 
14 59 60 68 75 84 102 161 259 260 304 316 317 322 323 394 478 480 494 603 608 646 718 746 853 854 867 914 955 963 979 980 986 1078 1088 1126 1153 1188 1237 1250 
55 56 83 138 141 146 155 156 167 177 193 204 244 245 281 327 483 486 496 565 609 672 673 699 702 752 771 804 815 821 829 911 985 1023 1115 1122 1129 1166 1278 
7 70 85 99 112 125 126 164 172 205 254 256 258 273 278 287 300 301 400 505 532 560 662 671 678 717 760 769 792 866 972 1010 1024 1058 1130 1181 1256 1262 
17 45 47 50 306 354 355 361 390 412 468 499 501 558 670 674 729 744 775 780 823 830 833 834 1000 1011 1037 1041 1042 1073 1084 1110 1112 1117 1127 1147 1280 
92 107 128 232 267 367 377 399 414 450 463 502 540 547 555 559 607 809 813 825 850 909 926 956 1033 1065 1090 1097 1124 1132 1148 1150 1158 1174 1285 
5 20 41 63 100 130 218 225 230 246 296 308 309 466 571 601 621 645 685 901 912 939 960 969 1131 1194 1197 1205 1216 1271 
6 8 71 76 150 154 347 375 418 429 455 688 739 762 940 948 1063 1064 1092 1093 1184 1196 1266 
133 144 189 190 240 251 262 280 286 402 419 476 530 563 605 635 708 1013 1016 1080 1236 1263 1268 
116 149 198 313 352 484 531 642 684 755 881 906 961 962 991 1049 1062 1100 1159 1164 1199 
249 297 307 403 683 756 765 789 790 844 874 875 1096 1105 1107 1113 1125 1235 1284 
115 376 430 431 581 594 637 675 712 797 798 814 884 922 1054 1066 1176 1195 
11 64 157 226 338 640 641 655 776 898 899 938 1040 1060 1083 1104 1120 
168 238 408 409 421 470 491 536 579 774 855 886 1118 1251 1261 1277 
19 66 108 227 253 353 401 598 704 705 891 892 931 1142 1243 
335 336 691 694 721 805 827 953 970 1087 1106 1154 1165 1242 1252 
165 169 179 467 534 557 567 615 726 1069 1170 1217 
180 199 200 315 364 520 549 576 706 1149 1253 1260 
210 211 318 443 451 457 477 490 548 575 1206 1207 
320 321 345 713 714 733 734 872 947 1038 1218 1281 
69 228 319 648 812 856 857 921 1140 1172 1177 
77 88 104 117 119 131 148 295 507 768 990 
110 111 303 537 538 584 639 663 1109 1151 1238 
113 493 568 690 701 715 949 1137 1246 
137 289 290 432 513 519 695 1036 1044 
397 406 434 564 904 905 1070 1168 1215 
132 665 682 740 741 888 889 1123 
86 87 166 207 324 504 522 
194 195 553 631 796 837 996 
