64 65 66 75 111 194 195 216 217 242 329 330 349 350 379 399 424 446 464 465 480 481 483 488 493 494 503 509 524 526 531 533 542 553 554 569 570 574 577 578 582 585 586 588 599 602 603 606 612 613 614 616 618 621 622 624 625 626 629 630 637 638 644 651 652 653 661 674 679 680 682 687 689 690 692 693 698 700 703 706 707 711 716 719 722 723 731 739 744 745 747 749 754 759 762 764 773 785 808 816 822 828 832 836 845 846 852 860 861 866 867 868 869 887 903 905 906 909 916 917 918 919 922 924 927 932 933 937 950 965 968 972 974 976 977 983 1001 1002 1012 1015 1017 1022 1024 1028 1037 1039 1055 1056 1060 1065 1066 1080 1100 1106 1109 1138 1145 1164 1189 1192 1204 1210 1241 1246 1258 1259 1267 1272 1276 1288 
90 91 175 176 212 213 226 237 293 300 301 342 343 348 387 388 389 394 395 407 532 591 658 677 678 705 710 713 714 717 735 736 763 769 775 776 777 784 788 789 795 797 798 802 803 812 813 847 848 884 888 889 894 895 904 913 915 925 930 931 934 956 1000 1011 1058 1090 1091 1092 1093 1097 1108 1120 1130 1132 1142 1159 1162 1163 1169 1184 1202 1223 1224 1240 1256 1268 1281 
0 1 2 3 4 5 6 7 8 9 10 11 12 13 14 15 18 19 21 22 23 25 26 30 33 37 43 47 52 58 59 74 147 162 214 215 230 252 269 328 405 421 453 469 486 487 593 657 662 666 667 780 800 821 899 900 942 943 981 1053 1059 1111 1112 1129 1134 1135 1139 1141 1147 1193 1209 1213 1229 1239 1244 1245 1266 
84 85 107 108 110 127 139 140 253 254 276 277 282 303 306 307 311 314 315 334 357 373 420 435 455 456 485 492 496 502 528 571 573 576 646 659 683 684 701 732 750 751 753 767 778 805 825 829 849 856 859 875 877 878 944 945 953 973 986 993 1021 1032 1057 1081 1083 1104 1105 1148 1150 1183 1205 1233 1238 1250 1286 1287 
55 56 83 100 101 128 138 141 144 145 146 154 155 156 167 177 182 193 204 244 245 246 247 262 280 281 326 327 375 376 398 402 403 452 475 476 482 506 530 559 563 565 566 609 699 702 708 752 760 771 786 792 801 804 873 911 914 985 994 1014 1023 1071 1124 1146 1151 1166 1185 1226 1251 1271 1278 
41 42 67 68 72 86 87 93 94 109 114 115 129 136 161 170 171 173 178 188 200 201 220 221 228 229 238 239 250 255 304 310 319 325 347 365 372 374 382 383 404 428 512 513 522 523 549 587 686 696 728 756 833 844 863 864 871 891 892 957 1020 1103 1131 1177 1188 1208 1269 1273 1284 
34 35 38 39 53 54 71 82 89 92 97 120 121 122 123 181 196 197 218 219 251 259 260 312 322 323 332 377 378 386 393 436 448 521 550 556 594 617 619 660 715 727 831 862 882 883 926 941 948 949 978 1007 1038 1040 1054 1078 1088 1126 1156 1157 1158 1181 1196 1198 1200 1203 1230 1285 
77 78 88 104 117 118 119 131 148 160 208 209 235 289 290 295 309 340 341 391 392 397 406 432 434 437 466 467 472 499 500 507 519 525 534 537 538 541 557 564 567 615 634 639 725 733 734 814 815 935 936 995 996 1029 1070 1075 1128 1137 1144 1201 1215 1218 1221 1249 1280 
105 106 124 191 192 233 234 305 313 366 425 426 438 439 445 457 458 459 461 501 580 581 643 648 663 818 819 823 886 898 954 967 969 975 990 991 1046 1051 1052 1069 1085 1086 1119 1122 1133 1136 1140 1152 1165 1167 1170 1174 1175 1180 1252 1264 1282 
48 49 102 103 112 113 125 126 130 163 164 165 172 198 202 203 205 206 211 232 249 256 265 273 278 287 288 308 352 353 460 498 505 511 560 575 590 670 671 721 1036 1063 1114 1149 1168 1231 1232 1242 
263 264 362 363 371 396 410 417 433 440 450 462 471 478 497 514 529 535 539 592 595 623 632 649 650 691 694 726 772 787 799 839 865 881 893 908 923 946 1018 1031 1061 1067 1072 1073 1143 1186 1247 1248 
236 279 358 359 443 543 544 545 546 552 596 600 601 620 645 647 656 672 673 695 718 740 741 757 758 766 779 793 794 838 920 964 992 1019 1045 1123 1160 1171 1206 1207 1214 1217 1227 1257 
28 29 40 60 61 69 70 73 98 150 151 157 158 159 174 224 225 248 257 258 331 527 551 712 743 817 853 854 857 921 987 1050 1077 1079 1101 1155 1176 1190 1228 1253 1260 1262 1265 
184 185 270 271 274 275 283 302 337 338 344 346 360 369 380 381 384 385 414 429 447 479 484 508 572 589 627 628 761 811 820 827 858 940 1035 1044 1064 1211 1237 
166 320 321 324 345 415 416 454 558 685 704 770 781 826 830 837 840 841 872 876 896 897 928 947 979 980 984 1003 1004 1041 1042 1049 1110 1153 1154 1191 1197 1234 
44 45 46 50 51 57 76 81 116 137 149 222 223 261 272 297 335 336 418 427 517 597 642 720 774 796 885 1062 1107 1127 1172 1173 1187 1243 1263 1277 
152 153 189 231 354 355 390 489 515 610 611 697 709 724 729 730 790 850 851 874 939 951 952 960 988 989 1033 1096 1102 1113 1125 1222 1283 
62 63 95 134 135 210 294 333 411 441 442 451 473 474 516 548 607 608 746 902 1047 1048 1068 1082 1094 1099 1179 1212 1225 
408 409 412 413 430 431 470 491 536 568 579 834 879 880 959 961 962 963 1010 1076 1117 1118 1161 1178 1195 1255 1274 1279 
16 17 20 24 27 36 190 286 296 419 444 504 510 654 755 791 835 966 1013 1025 1182 1236 1254 
79 80 96 99 183 339 598 604 605 640 641 655 688 737 738 742 912 938 955 1084 1121 
142 143 168 169 207 298 299 518 561 562 664 665 768 855 907 997 1194 1199 1261 
284 285 291 292 351 361 368 468 633 668 669 681 748 765 910 1008 1009 1115 1235 
179 180 199 364 520 809 810 890 901 958 1026 1098 1216 
186 187 243 266 356 370 449 824 842 843 929 1030 1116 
31 32 806 807 870 970 971 982 1034 1043 1270 
132 133 227 240 241 367 782 783 1074 1275 
316 317 318 477 490 1005 1006 1087 1089 1095 
267 268 400 401 463 495 540 547 555 
635 636 675 676 1016 1027 
583 584 631 
