6 34 35 38 39 41 42 54 67 71 82 92 97 102 122 124 127 130 139 140 163 165 169 173 181 194 202 205 211 218 219 230 253 254 255 269 278 292 307 314 315 332 334 344 357 373 377 378 393 408 420 435 436 439 448 492 496 502 506 510 527 545 546 550 552 553 555 556 557 568 586 590 591 601 607 608 619 632 641 647 662 666 701 705 712 727 732 748 756 760 790 800 805 825 829 831 833 844 862 863 864 877 896 944 945 948 949 950 952 956 966 977 980 982 996 997 1002 1032 1039 1041 1042 1071 1089 1096 1097 1105 1131 1143 1150 1170 1171 1202 1223 1231 1232 1238 1250 1266 1269 1284 1285 1287 
0 36 60 61 69 70 73 80 83 110 111 115 117 131 144 147 150 151 157 158 159 160 174 180 195 226 248 295 348 349 350 352 355 363 376 380 382 412 421 430 431 446 454 464 475 480 482 483 485 499 500 503 526 531 544 551 561 577 578 594 603 620 621 622 624 637 638 653 658 661 684 687 692 698 703 707 711 713 714 725 731 742 743 744 747 754 768 785 822 845 860 869 882 883 887 903 913 919 922 942 943 974 978 1000 1001 1005 1006 1014 1015 1022 1043 1045 1047 1066 1074 1076 1077 1079 1103 1129 1136 1138 1155 1156 1160 1186 1195 1225 1228 1241 1274 1275 1280 
44 45 46 50 51 56 57 76 81 93 94 107 116 128 137 138 141 142 143 149 167 168 204 247 258 259 260 261 272 275 297 298 299 318 321 323 336 345 362 365 370 386 400 413 438 456 458 466 493 494 509 517 518 542 554 570 573 574 582 598 599 604 606 612 616 642 646 651 654 674 679 680 694 706 709 719 720 721 737 738 749 773 796 832 834 851 902 906 918 955 961 962 963 965 969 970 971 975 986 1003 1004 1007 1034 1036 1049 1056 1058 1099 1119 1124 1127 1181 1184 1189 1191 1204 1214 1242 1243 1254 1261 1262 1267 
68 72 109 113 120 121 123 152 153 164 221 231 236 238 249 273 280 291 325 330 368 374 383 384 394 404 427 429 455 459 468 489 497 505 512 516 523 524 529 575 588 596 613 617 618 626 635 643 644 656 685 689 699 700 715 716 739 759 762 765 793 794 808 816 817 828 836 848 852 861 867 868 871 894 917 920 924 932 933 941 964 1012 1021 1050 1054 1055 1065 1080 1094 1101 1109 1110 1120 1126 1137 1145 1149 1152 1177 1188 1190 1192 1235 1237 1246 1258 1259 1268 1276 
5 7 12 17 20 21 22 26 43 47 48 49 58 62 63 77 79 95 114 118 119 129 146 199 203 228 229 251 288 308 309 322 328 347 397 428 473 477 504 514 520 537 538 560 571 600 611 615 639 645 663 686 722 761 797 814 983 1017 1046 1069 1075 1093 1121 1147 1167 1185 1200 1212 1247 1248 
16 78 154 161 170 175 192 198 206 222 257 265 274 300 341 353 388 407 409 416 418 445 452 457 491 511 536 558 581 659 660 695 710 750 753 757 758 770 781 789 806 807 830 872 876 885 928 936 947 953 973 984 991 1070 1091 1092 1100 1116 1118 1128 1153 1180 1183 1199 1270 1273 
96 100 101 145 156 182 188 193 244 245 250 262 263 277 375 398 402 403 419 513 530 539 541 563 565 566 605 609 672 673 683 690 702 708 728 771 804 837 843 873 875 878 911 927 957 985 1023 1086 1113 1125 1146 1166 1198 1211 1226 1271 1278 1286 
4 8 9 11 13 14 15 18 19 23 25 30 31 32 33 37 52 104 162 189 190 197 201 235 270 279 286 381 444 463 585 772 801 826 898 899 900 908 914 951 995 1018 1028 1059 1087 1140 1141 1157 1165 1196 1221 1222 1229 1252 1263 1282 
28 64 65 66 75 98 134 183 208 209 210 216 217 227 233 234 242 294 313 316 317 333 379 390 399 411 424 449 465 481 488 495 533 569 589 614 625 629 652 671 745 792 866 967 1102 1115 1144 1164 1249 1288 
10 89 132 284 285 301 319 343 351 441 442 474 610 633 648 650 664 668 669 677 678 682 724 730 769 812 842 856 857 888 889 890 921 929 946 958 988 1010 1020 1031 1068 1098 1114 1123 1169 1173 1208 
112 125 126 135 172 223 256 387 391 498 532 534 640 655 670 688 717 733 734 755 778 798 846 849 930 931 938 972 1024 1090 1130 1142 1151 1159 1162 1209 1210 1215 1218 1224 1256 1264 1281 
24 105 106 186 187 243 266 271 305 324 338 354 356 358 359 426 461 515 576 657 718 729 740 741 766 818 819 854 916 939 1008 1037 1051 1052 1133 1168 1253 1257 1260 1265 
1 2 91 133 148 185 232 237 240 241 326 327 346 367 389 443 450 478 484 528 630 723 909 912 940 960 1019 1040 1044 1064 1108 1172 1174 1175 1206 1207 
108 267 268 329 508 540 562 567 735 736 763 775 776 777 784 795 802 803 813 847 870 915 925 934 937 993 1011 1060 1083 1104 1216 1245 1272 
29 40 282 371 392 396 410 434 471 535 564 592 623 649 691 787 839 910 923 935 968 989 1061 1067 1072 1073 1132 1182 1227 1255 
136 176 213 303 304 310 395 401 451 462 490 521 547 549 587 602 746 764 779 782 788 838 853 1078 1082 1088 1233 1240 
3 59 184 281 283 302 337 360 369 385 414 470 501 507 572 595 815 820 886 994 1009 1035 1112 1158 1234 
86 87 166 200 207 264 296 320 447 476 522 667 675 676 780 976 1013 1027 1053 1134 1135 1139 1194 1283 
99 214 215 220 252 339 405 415 437 453 460 548 593 693 791 810 827 835 1029 1062 1084 1106 1154 1178 
53 406 543 636 665 752 783 799 879 904 905 907 959 992 1016 1048 1111 1117 1161 1251 1279 
103 224 469 479 628 774 809 855 884 901 981 1026 1107 1176 1277 
90 155 433 440 467 486 487 726 821 840 841 1122 1217 
225 239 276 331 583 584 597 631 681 880 897 1187 1197 
74 340 525 696 697 824 1038 1201 1213 1239 1244 
171 289 290 312 417 432 519 634 893 1063 1085 
179 293 364 372 627 751 767 811 858 865 1081 
84 85 177 196 311 366 425 954 1230 
559 850 874 881 926 1030 1033 1148 
27 246 335 990 1025 1095 1205 
178 306 361 580 823 859 979 
191 472 704 987 1057 1193 
786 891 892 1163 1179 
55 287 895 
88 212 342 
579 1203 1236 
