0 36 60 61 69 70 73 77 110 111 119 131 144 150 151 157 158 159 160 174 195 227 248 295 345 348 349 350 352 363 421 446 454 458 464 465 475 480 481 500 526 531 544 551 561 577 578 603 621 622 624 637 638 653 658 661 687 692 698 703 707 713 714 731 743 744 747 790 822 860 869 913 919 922 942 943 974 1001 1019 1022 1043 1047 1074 1076 1077 1079 1096 1102 1103 1123 1129 1155 1156 1160 1186 1196 1211 1225 1228 1241 1249 1258 1259 1274 1275 1276 
44 45 46 50 51 57 76 81 93 94 107 116 142 143 149 168 169 222 258 260 261 272 275 277 297 298 299 323 336 362 386 413 456 486 493 494 503 509 517 518 542 554 570 573 574 598 599 604 606 612 614 642 646 651 652 679 680 694 706 709 719 737 749 768 773 785 796 816 823 832 834 846 868 885 902 903 906 918 950 961 962 965 970 971 1015 1034 1049 1056 1127 1138 1167 1179 1184 1189 1214 1217 1261 1262 
3 6 20 34 35 38 39 41 54 71 97 102 124 130 139 140 163 165 181 194 211 218 219 230 292 334 393 528 553 556 557 568 632 701 748 805 825 831 949 952 977 1041 1042 1097 1131 1143 1150 1238 1250 1266 
56 96 100 138 141 145 156 182 204 244 245 262 375 398 402 419 506 530 539 541 563 565 609 702 708 771 804 837 843 873 911 927 1023 1146 1166 1226 1271 1278 
170 186 198 202 243 266 300 353 356 407 416 457 511 558 560 581 753 770 781 833 876 904 928 984 991 1092 1100 1116 1199 1232 1273 
13 67 122 254 255 306 307 373 377 408 420 435 492 502 555 586 756 800 844 888 889 896 956 966 1002 1032 1071 1105 1269 1284 
5 7 10 21 22 26 47 49 58 203 229 328 571 600 611 629 686 722 814 983 1017 1024 1075 1107 1147 1148 
8 9 11 14 15 19 23 25 30 33 37 52 162 772 801 900 951 995 996 1059 1141 1221 1222 1229 
27 28 98 183 210 216 217 242 294 313 333 379 390 399 411 424 495 671 789 792 866 967 1212 
42 92 253 269 315 332 378 436 496 550 590 601 662 666 712 732 745 862 863 864 1164 1285 
238 280 394 427 429 497 635 739 759 817 852 861 924 933 941 1012 1021 1080 1126 1145 1268 
79 118 129 146 228 251 288 322 347 473 514 538 615 639 663 761 1046 1093 1247 1248 
136 176 304 310 382 462 515 521 549 587 729 764 778 782 788 1000 1082 1233 1240 
91 115 237 384 389 459 596 613 617 836 845 867 887 917 932 940 975 1108 
105 106 305 324 354 426 673 741 819 916 1008 1029 1051 1052 1168 1191 1253 1265 
29 40 282 371 396 410 535 592 623 691 787 839 923 935 1073 
113 152 153 231 489 700 808 828 1050 1101 1137 1190 1246 
184 283 302 337 360 369 380 385 507 572 820 994 1035 
89 284 351 442 633 648 650 677 879 890 963 1161 
90 155 263 433 440 467 487 726 840 841 1067 1122 
108 267 268 540 567 802 803 813 847 870 993 1130 
109 178 325 404 468 523 524 580 626 1084 1110 1230 
117 241 327 484 485 559 684 912 1065 1172 1174 1175 
126 319 391 849 946 1090 1091 1142 1159 1162 1224 1256 
175 192 257 341 418 445 569 660 750 1153 1183 1288 
53 189 190 197 444 463 907 908 959 1048 1279 
82 134 208 209 368 449 488 625 754 1055 1094 
99 220 226 339 355 415 437 499 810 939 1280 
148 185 326 367 450 478 630 909 1040 1072 1083 
212 395 439 527 545 546 591 647 829 1223 1231 
225 239 276 331 583 584 631 880 897 1187 1197 
850 851 874 875 881 926 1030 1033 1113 1125 1171 
101 250 289 290 432 513 728 957 1044 1086 
78 161 291 361 710 765 830 1037 1235 
376 431 594 711 791 835 1066 1119 1195 
4 32 104 201 381 1018 1165 1252 
72 128 167 400 582 1124 1163 1243 
84 85 177 196 311 366 425 954 
103 224 809 855 884 901 1026 1176 
114 566 675 676 985 1027 1185 1198 
316 358 359 657 718 766 821 1257 
409 536 774 812 1010 1098 1173 1277 
543 636 752 783 799 992 1016 1251 
736 763 777 795 915 925 934 1180 
120 121 123 164 618 727 1054 
214 215 252 405 453 593 693 
317 441 516 533 589 1068 1192 
656 689 793 794 1005 1006 1227 
86 87 166 200 207 522 
171 417 519 634 1063 1064 
213 401 547 1036 1089 1170 
232 343 856 857 921 1169 
249 505 575 588 894 1149 
281 470 595 1009 1158 1234 
414 720 721 955 1181 1242 
12 882 883 978 1200 
43 259 312 893 1085 
59 501 871 1112 1177 
66 562 937 964 997 
68 512 529 1188 1237 
83 412 482 483 1178 
112 265 273 717 826 
135 640 655 688 938 
188 690 877 878 1286 
236 715 716 920 1109 
296 476 667 780 976 
346 627 751 767 1081 
365 472 704 986 987 
370 616 1003 1004 1007 
374 455 491 936 1118 
383 762 848 1045 1152 
498 670 930 931 972 
757 806 807 1128 1270 
16 428 430 504 
64 65 75 338 
127 619 659 1088 
137 318 466 969 
154 387 1210 1264 
172 205 278 755 
179 293 520 865 
199 477 905 1117 
206 274 452 872 
233 234 1115 1144 
246 990 1095 1205 
286 510 982 1263 
303 602 779 838 
320 447 1013 1283 
329 1216 1245 1272 
357 607 608 760 
364 372 811 858 
388 532 705 1151 
392 434 564 1132 
451 746 853 1078 
469 479 628 981 
525 696 697 1201 
654 674 1204 1254 
733 734 1215 1281 
775 776 784 1011 
1 2 723 
17 63 397 
55 287 895 
80 180 620 
173 448 1202 
191 1057 1193 
223 534 1218 
235 279 585 
247 1058 1099 
264 1053 1194 
314 641 1287 
321 330 685 
344 552 1039 
443 490 980 
460 548 1062 
461 854 1133 
579 1203 1236 
649 910 968 
664 665 740 
669 1020 1208 
724 725 730 
738 742 1136 
786 891 892 
827 1106 1154 
898 899 1069 
914 1028 1157 
947 948 1070 
989 1061 1182 
1060 1104 1120 
1134 1135 1139 
1213 1239 1244 
