35 38 53 67 69 82 86 89 94 97 109 114 115 124 136 139 140 163 170 178 201 203 308 310 312 319 329 330 332 382 383 404 441 442 460 471 473 474 487 503 516 542 545 552 554 556 566 576 577 587 594 596 613 617 626 630 637 647 656 675 723 764 836 841 845 857 861 871 921 924 932 983 992 1015 1019 1020 1039 1046 1047 1048 1054 1066 1068 1095 1171 1175 1177 1185 1192 1208 1225 1227 1245 1272 1273 
20 57 63 100 133 144 146 156 177 190 193 234 245 247 251 262 280 286 314 334 357 376 402 419 430 431 438 452 476 497 504 510 521 530 550 563 565 590 605 609 635 660 669 672 702 708 731 735 736 763 771 788 804 835 842 843 863 864 873 911 925 929 934 950 982 985 994 1016 1076 1080 1166 1195 1236 1240 1263 1268 1271 1274 1287 
8 14 19 32 59 64 66 72 84 102 105 108 161 185 197 222 227 248 316 317 338 367 371 384 386 392 401 418 450 465 475 478 481 482 494 517 541 551 569 582 588 598 611 625 646 652 684 704 705 718 729 739 745 773 790 858 885 903 909 913 927 963 1014 1060 1091 1092 1096 1102 1121 1153 1163 1184 1196 1198 1221 1249 1250 1288 
49 61 62 95 132 135 151 173 194 195 199 240 268 294 333 381 411 413 424 428 448 458 459 464 488 533 553 574 578 602 624 666 667 679 680 682 700 709 711 743 747 796 802 803 816 818 819 846 851 862 868 869 887 888 889 905 941 965 968 975 977 987 996 1001 1028 1055 1075 1079 1094 1119 1123 1138 1157 1167 1179 1189 1202 1228 
34 46 81 93 103 155 196 206 212 213 219 274 285 311 320 321 340 341 342 345 368 372 395 437 439 485 498 524 525 544 561 591 633 653 670 673 707 713 714 733 734 749 779 829 852 872 930 942 943 947 1012 1038 1057 1077 1103 1155 1156 1178 1183 1199 1201 1223 1230 1231 1234 1265 1281 
54 101 153 186 187 243 261 266 325 356 370 373 393 427 444 445 447 500 546 562 585 604 606 610 612 665 724 725 730 748 754 758 759 793 794 824 832 890 896 897 907 919 937 944 945 958 966 1002 1026 1030 1085 1086 1111 1116 1211 1258 1259 1276 1283 
0 1 2 3 4 5 10 12 15 18 21 22 23 26 30 33 37 41 43 44 52 74 147 162 269 328 469 528 571 580 601 636 645 676 801 882 883 900 978 981 1017 1027 1059 1131 1141 1200 1229 
6 58 76 116 123 149 150 184 270 271 275 283 302 327 337 344 347 360 369 375 385 429 456 479 484 489 508 531 572 589 642 755 820 822 906 940 961 962 1035 1044 1049 1064 1093 1159 1164 1266 1282 
25 28 29 40 98 127 134 145 189 191 192 224 228 239 257 258 272 276 277 331 351 366 379 387 426 583 732 761 784 856 879 880 894 895 902 973 993 1021 1098 1104 1161 1187 1193 1210 1224 1262 1264 
39 65 130 152 171 221 231 235 236 279 296 435 495 600 618 619 621 638 689 698 716 722 727 753 797 800 808 814 828 831 877 920 922 933 952 988 989 1005 1006 1071 1088 1145 1146 1148 1182 1190 1194 
7 16 48 73 77 78 88 104 117 119 120 126 131 148 158 160 174 233 295 349 350 436 446 492 507 511 664 677 768 786 817 967 974 990 1013 1032 1050 1063 1101 1114 1203 1232 
51 55 56 83 138 141 167 175 176 204 244 281 326 348 400 407 483 518 526 599 658 662 687 696 697 699 710 720 752 840 1003 1004 1007 1023 1181 1191 1209 1241 1243 1251 1278 
24 36 92 218 230 246 267 291 292 363 390 399 420 463 468 540 547 555 597 616 681 750 751 767 778 849 901 910 939 976 1009 1022 1081 1084 1110 1205 1216 1285 
27 90 159 182 237 263 264 293 305 362 389 539 573 595 643 644 737 738 742 757 766 806 964 1051 1052 1053 1067 1108 1128 1134 1135 1136 1139 1160 1214 1226 1267 
79 80 169 180 183 339 358 359 364 520 543 557 620 622 726 785 810 838 898 917 918 959 971 1034 1043 1069 1140 1162 1170 1213 1217 1239 1244 1253 1255 1257 1279 
13 17 45 50 297 306 307 354 355 361 403 499 674 683 744 756 765 823 833 834 844 874 875 891 892 1000 1105 1107 1113 1125 1127 1233 1235 1280 1284 
96 282 398 410 417 433 440 462 529 535 592 623 632 649 650 772 787 799 839 847 865 870 878 893 908 923 935 946 995 1008 1031 1061 1072 1143 1186 
42 121 142 143 208 216 242 252 298 299 309 396 425 466 509 515 527 629 671 693 740 741 791 916 954 969 1025 1029 
107 128 225 377 414 502 559 607 608 685 746 809 813 825 850 912 926 956 1033 1065 1090 1097 1124 1132 1150 1158 1197 
110 111 118 288 303 378 380 506 514 537 538 584 639 663 668 686 692 703 859 1074 1109 1151 1169 1238 1247 1248 1275 
129 188 202 217 220 229 250 346 472 512 523 627 628 651 661 728 782 783 795 811 957 997 1082 1173 1180 1212 1286 
60 68 75 259 260 304 322 323 365 388 394 480 570 603 853 854 867 914 955 979 986 1078 1126 1188 1237 
70 99 254 300 301 343 391 397 434 564 654 678 717 769 792 1010 1024 1058 1130 1204 1254 
168 214 215 238 408 409 421 453 470 491 536 579 593 774 855 886 1118 1261 1277 
9 31 415 416 454 614 631 657 781 807 826 837 876 928 984 1018 1144 1270 
335 336 532 691 694 721 760 805 827 866 953 970 1087 1106 1154 1165 1242 1252 
85 112 125 164 172 205 232 249 265 273 278 287 505 972 1174 1256 
165 179 181 223 461 467 534 567 581 615 712 777 1089 1133 1218 1260 
210 211 318 443 451 457 477 490 548 575 1206 1207 
253 353 496 558 775 830 931 1011 1037 1073 1115 1142 
11 157 226 640 641 655 776 899 938 1040 1083 
374 455 486 659 688 770 815 821 936 1122 1129 
47 412 501 780 980 1041 1042 1112 1117 1147 
87 166 200 207 315 324 522 549 706 1149 
91 106 122 241 255 586 719 860 1269 
113 493 568 690 701 715 949 1137 1246 
256 798 848 884 915 1045 1120 1152 1176 
71 154 648 762 812 948 1056 1172 
137 289 290 432 513 519 695 1036 
198 313 352 560 881 991 1062 1100 
209 405 449 634 951 960 1099 1222 
406 904 1070 1168 1215 
