36 46 53 67 81 93 94 109 124 136 139 140 163 188 201 212 213 235 236 279 312 329 330 342 343 346 368 372 374 383 395 404 439 441 442 460 473 487 503 512 516 524 542 554 574 577 587 591 594 596 613 617 626 627 630 637 651 653 689 698 707 723 727 747 749 764 779 797 798 814 816 836 846 848 852 868 869 871 882 883 884 915 919 920 930 933 937 942 943 965 968 976 977 978 983 1001 1005 1006 1015 1019 1028 1046 1047 1048 1051 1052 1054 1066 1068 1077 1089 1120 1138 1152 1155 1156 1175 1176 1189 1192 1223 1225 1231 1232 1245 1272 1286 
32 42 49 61 62 95 105 135 142 151 197 241 248 294 298 299 333 381 384 386 387 392 411 413 424 458 464 465 471 475 482 488 495 509 517 533 541 545 551 552 566 569 578 582 588 600 602 622 624 625 629 638 647 652 656 666 667 679 680 687 693 709 711 743 745 753 773 791 810 845 851 858 861 862 887 903 913 917 927 941 971 975 987 992 1014 1025 1029 1034 1039 1043 1055 1079 1094 1102 1119 1157 1162 1163 1171 1179 1198 1210 1221 1227 1228 1249 1255 1264 1288 
5 9 20 31 39 41 63 79 80 91 100 106 122 130 152 171 183 221 225 231 285 296 308 309 320 321 339 345 351 415 416 428 454 498 558 571 586 601 614 618 621 633 645 654 657 670 685 713 714 719 722 733 734 775 781 800 807 808 826 828 830 831 840 841 860 872 876 912 918 928 947 952 960 984 988 989 1003 1011 1018 1038 1071 1073 1131 1144 1145 1146 1167 1190 1191 1194 1197 1200 1204 1218 1254 1270 1271 1281 
7 16 24 27 48 70 73 77 78 85 88 90 99 104 112 117 119 120 125 126 131 148 158 159 164 172 182 233 237 254 258 263 273 293 295 305 349 350 362 389 391 400 436 446 492 505 507 511 532 539 560 573 595 643 644 662 664 671 677 678 717 737 738 742 757 760 766 768 769 792 806 817 866 964 967 972 974 990 1010 1024 1032 1050 1058 1101 1108 1114 1128 1130 1136 1160 1181 1203 1214 1226 1256 1262 1267 
72 92 107 128 160 218 230 232 246 249 267 284 291 292 297 307 363 367 377 399 403 414 420 435 450 463 466 502 540 547 555 559 576 597 607 608 616 681 683 716 746 750 751 756 765 767 778 789 790 809 813 825 844 849 850 874 875 877 891 892 901 909 910 926 939 956 969 1009 1022 1033 1065 1081 1090 1096 1097 1105 1107 1113 1124 1125 1132 1148 1150 1158 1174 1205 1216 1235 1260 1284 1285 
25 28 29 40 58 98 114 116 123 127 134 145 149 170 191 192 196 198 203 205 216 224 239 252 256 257 265 272 275 276 278 287 300 301 311 313 331 344 352 366 379 388 425 426 452 456 484 485 489 515 531 561 583 642 684 732 755 822 880 881 902 906 916 924 932 954 961 962 991 1021 1049 1057 1062 1091 1095 1100 1159 1164 1185 1187 1199 1230 1273 
86 87 96 166 180 199 200 207 264 282 315 324 335 336 364 398 410 417 430 431 433 440 462 497 504 514 520 522 529 535 549 592 623 632 649 650 691 694 706 721 772 787 799 805 839 847 865 870 878 893 908 923 935 946 953 970 995 1008 1031 1053 1061 1067 1072 1087 1134 1135 1139 1143 1149 1165 1186 1195 1242 1252 1253 
55 56 83 133 138 141 144 146 155 156 167 177 190 193 204 240 244 245 247 251 262 280 281 286 327 376 402 419 476 483 486 496 530 563 565 605 609 635 672 673 699 702 708 731 752 771 804 815 821 829 873 911 985 1013 1016 1023 1080 1115 1122 1129 1166 1182 1236 1243 1263 1268 1278 
54 101 143 153 174 186 187 222 223 243 261 266 325 356 370 373 393 427 444 445 447 459 500 546 562 585 604 606 610 612 724 725 748 754 758 759 786 793 794 811 818 819 824 832 885 890 896 897 907 944 945 958 1002 1026 1030 1085 1086 1111 1116 1211 1258 1259 1276 1283 
38 57 65 82 89 97 115 165 179 181 234 268 314 332 334 357 438 448 461 510 521 550 556 581 590 615 619 659 660 675 700 712 735 736 763 770 777 788 802 803 835 842 843 864 922 925 929 934 936 950 982 1075 1076 1133 1202 1240 1274 1287 
0 1 2 3 4 10 12 13 15 18 21 22 23 26 30 33 37 43 44 52 74 147 162 178 208 209 214 215 269 328 405 449 453 469 528 580 593 634 636 676 801 879 900 951 981 994 1017 1027 1059 1099 1141 1161 1193 1222 1229 
14 59 84 102 121 161 184 185 242 270 271 283 302 310 316 317 337 360 369 371 385 396 478 479 481 494 508 523 527 572 589 611 628 646 661 718 761 784 820 827 894 895 963 973 993 1035 1098 1106 1121 1153 1154 1224 1233 1250 1282 
17 45 47 50 51 175 176 306 326 348 354 355 361 382 390 407 412 468 499 501 518 526 599 658 674 696 697 710 720 729 744 780 823 833 834 966 1000 1004 1007 1020 1037 1041 1042 1084 1110 1112 1117 1127 1147 1208 1209 1241 1280 
35 118 129 173 202 217 220 229 250 255 277 288 378 380 472 506 668 669 686 692 703 728 782 783 795 859 863 957 997 1045 1074 1082 1169 1173 1180 1212 1247 1248 1269 1275 
6 8 69 71 76 150 154 189 228 319 347 375 418 429 455 648 688 730 739 762 812 856 857 921 940 948 1056 1063 1064 1092 1093 1172 1177 1184 1196 1266 
60 68 75 113 259 260 304 322 323 365 394 480 493 568 570 603 690 701 715 853 854 867 914 949 955 979 980 986 1012 1078 1088 1126 1137 1188 1237 1246 
34 103 206 219 274 340 341 358 359 437 525 543 544 620 785 838 959 1103 1178 1183 1201 1213 1234 1239 1244 1257 1265 1279 
168 238 408 409 421 470 491 536 579 774 855 886 1118 1251 1261 1277 
11 157 226 640 641 655 776 898 899 938 1040 1083 1104 
210 211 318 443 451 457 474 477 490 548 575 1206 1207 
110 111 303 537 538 584 639 663 1109 1151 1238 
169 467 534 557 567 726 1069 1140 1170 1217 
137 289 290 432 513 519 695 1036 1044 
397 406 434 564 904 905 1070 1168 1215 
132 665 682 740 741 888 889 1123 
227 253 353 401 704 705 931 1142 
19 64 66 108 338 598 1060 
194 195 553 631 796 837 996 
