39 53 124 139 140 163 178 312 383 460 473 487 542 554 560 576 577 594 617 626 630 689 698 723 727 747 749 764 816 836 841 846 852 868 869 871 933 965 968 977 983 1001 1012 1015 1019 1028 1046 1047 1048 1054 1066 1175 1189 1225 
282 410 417 433 440 514 529 535 592 623 632 649 650 772 787 799 839 865 893 908 923 946 1008 1031 1061 1063 1067 1072 1143 
32 102 105 185 197 248 367 450 475 478 482 541 652 684 745 773 887 903 909 927 1102 1198 1250 
55 56 138 146 156 177 245 265 376 452 609 699 752 771 804 911 985 994 1023 1166 1251 
79 80 183 339 543 620 622 810 838 917 918 959 971 1034 1043 1162 1213 1239 1244 1279 
101 373 393 427 447 500 604 606 612 748 759 832 896 897 919 966 1085 1086 1211 1283 
120 158 191 192 233 349 350 436 446 492 664 677 817 967 974 1032 1050 1101 1114 1203 
135 294 333 424 458 459 464 488 578 666 667 680 688 743 818 819 862 975 1138 1228 
0 1 4 10 12 21 22 23 26 43 74 147 269 285 351 469 981 1017 1193 
24 184 270 271 283 302 337 360 369 385 479 508 572 589 820 827 1035 1282 
28 40 127 134 145 239 272 276 366 379 583 732 879 880 902 1021 1161 1187 
20 63 100 144 190 262 286 402 419 476 530 563 565 708 1236 1263 1271 
27 90 159 264 362 391 539 643 644 654 757 806 964 1053 1128 1204 1254 
118 288 378 380 668 692 848 859 915 1045 1074 1120 1152 1247 1248 1275 
153 261 325 546 585 610 758 793 794 907 1002 1111 1116 1258 1259 1276 
83 141 167 176 204 244 281 326 483 687 742 1007 1136 1160 1278 
168 238 408 409 421 470 491 536 579 774 855 886 1118 1261 1277 
9 152 171 221 231 618 722 808 826 828 831 1144 1145 1190 
6 76 150 327 347 375 429 484 940 1064 1093 1184 1266 
13 249 297 307 683 701 756 765 891 892 1107 1235 1284 
47 142 143 208 298 299 466 509 629 791 969 1029 1147 
72 392 505 517 566 582 588 625 861 913 1014 1163 1221 
18 30 33 37 52 162 580 801 900 1059 1141 1229 
35 129 173 188 202 220 229 250 277 728 957 1286 
17 45 50 354 499 674 744 834 1000 1127 1280 
51 125 518 526 599 696 697 720 1209 1241 1243 
209 214 215 405 449 453 593 634 951 1099 1222 
210 211 318 443 451 457 474 477 490 548 575 
334 357 521 590 660 736 763 788 843 864 1240 
11 157 226 640 641 655 938 1040 1083 1104 
59 316 317 494 516 596 613 718 1153 1192 
67 94 109 136 201 382 404 587 1020 1208 
471 545 552 647 656 992 1039 1171 1227 1255 
46 93 498 633 670 707 930 1155 1156 
64 310 371 481 611 963 1060 1121 1233 
70 678 717 769 792 1010 1024 1058 1130 
206 274 358 359 544 785 1103 1234 1257 
212 213 342 343 439 591 1223 1231 1232 
381 413 533 709 711 851 941 1119 1179 
8 222 418 739 885 1091 1092 1196 
77 88 119 131 148 160 295 507 
92 267 399 463 540 547 555 1285 
116 149 275 531 642 755 1049 1164 
256 797 798 814 884 922 1148 1176 
335 336 691 694 721 970 1087 1242 
761 784 894 895 973 993 1098 1224 
58 123 344 456 489 822 932 
60 388 394 853 854 914 1078 
65 130 296 619 621 1088 1194 
81 372 512 524 651 942 943 
91 106 122 255 586 719 1269 
137 290 432 513 519 695 1036 
186 187 243 266 356 824 1030 
194 195 553 631 796 837 996 
196 485 872 947 1038 1057 1230 
217 472 795 925 934 1180 1212 
251 280 497 635 1016 1080 1268 
314 438 510 735 835 982 1287 
340 341 437 525 1178 1183 1201 
370 562 754 890 937 997 1026 
415 416 781 876 928 984 1154 
38 82 89 97 332 556 
61 151 845 987 1079 1157 
107 813 850 926 1033 1132 
128 414 607 809 1124 1158 
198 352 991 1062 1100 1199 
216 252 425 515 916 954 
218 230 246 901 939 1216 
284 789 790 844 1096 1105 
19 66 108 338 598 
25 387 426 1210 1264 
29 98 224 257 331 
31 454 807 1018 1270 
68 260 480 1188 1237 
71 455 762 948 1056 
87 166 207 324 522 
113 690 715 1137 1246 
114 203 637 924 1185 
121 242 396 527 671 
132 682 888 889 1123 
175 348 407 658 710 
180 199 364 520 1253 
181 461 777 952 1133 
189 228 856 857 921 
227 240 465 551 1249 
258 400 662 1181 1262 
268 700 802 803 1075 
291 361 597 681 910 
304 323 603 955 1126 
306 823 833 1041 1042 
308 309 571 601 645 
320 321 345 713 714 
329 330 503 1245 1272 
368 653 1005 1006 1077 
384 386 569 858 1288 
403 874 875 1113 1125 
412 501 780 1112 1117 
486 815 821 1122 1129 
495 600 638 753 1205 
506 686 702 703 1169 
537 538 584 639 663 
750 751 767 778 1081 
800 988 989 1071 1146 
805 953 1106 1165 1252 
3 5 41 1131 
7 126 1013 1182 
14 84 161 646 
75 259 322 867 
85 172 972 1256 
86 170 1095 1273 
154 648 812 1172 
182 263 595 1226 
225 685 912 1197 
235 236 279 920 
237 293 389 1108 
253 353 931 1142 
305 573 766 1214 
328 636 676 1027 
346 627 628 811 
363 420 616 1022 
374 659 770 936 
377 559 956 1065 
430 431 504 1195 
467 534 567 1260 
496 830 1037 1115 
558 775 1011 1073 
782 783 1082 1173 
840 1003 1004 1191 
882 883 978 1200 
898 1069 1140 1170 
906 961 962 1159 
34 103 219 
42 693 1025 
48 73 78 
49 95 574 
54 444 445 
57 1076 1274 
69 319 1177 
96 398 995 
110 1109 1151 
111 303 1238 
112 164 273 
165 179 615 
200 549 706 
205 278 287 
232 1150 1174 
234 550 950 
247 731 873 
292 849 1009 
355 390 729 
365 570 986 
397 434 564 
401 704 705 
406 1070 1215 
411 624 679 
435 716 877 
441 442 1068 
448 602 1202 
462 847 870 
468 1084 1110 
493 568 949 
532 760 866 
581 712 1089 
665 740 741 
724 725 730 
733 734 1281 
737 738 1267 
842 929 958 
878 935 1186 
904 905 1168 
1134 1135 1139 
