1 2 6 17 34 35 38 39 41 42 54 63 67 71 80 92 97 102 122 127 129 130 139 140 163 165 173 180 181 202 205 211 214 215 218 219 230 232 252 253 254 255 256 269 273 278 292 306 307 314 315 332 334 344 357 373 377 378 393 395 397 405 408 420 435 436 439 448 453 492 496 502 506 527 528 545 546 550 552 553 555 556 557 562 568 586 590 593 601 607 608 619 620 632 641 647 659 662 666 701 705 712 723 727 728 732 745 748 756 757 760 800 805 806 807 825 829 831 833 862 863 864 888 896 944 945 949 952 956 957 966 977 997 1002 1032 1039 1041 1042 1071 1097 1128 1131 1143 1150 1164 1202 1238 1250 1266 1269 1270 1284 1285 1287 
0 36 60 61 69 70 73 83 109 110 111 115 117 131 144 150 151 157 158 159 160 174 248 295 325 345 346 348 349 350 352 363 376 404 412 421 431 446 454 458 464 468 475 480 481 482 483 485 500 526 531 537 538 551 561 577 578 594 603 621 622 624 626 637 638 639 653 658 661 684 687 692 693 698 703 707 711 713 714 725 731 742 743 744 747 783 791 797 822 835 845 860 869 887 913 919 922 942 943 974 1001 1005 1006 1019 1022 1043 1045 1047 1066 1074 1076 1077 1079 1084 1102 1110 1129 1136 1155 1156 1160 1178 1186 1195 1196 1211 1225 1228 1241 1258 1259 1274 1275 1276 
44 45 46 50 51 57 76 81 93 94 107 116 128 137 142 143 149 167 168 169 213 222 223 247 258 259 260 261 272 275 297 298 299 318 321 323 336 362 370 386 400 401 413 456 466 486 493 494 503 509 517 518 542 547 554 570 573 574 582 598 599 604 606 612 614 616 640 642 646 651 679 680 694 706 709 719 737 738 749 768 773 796 816 823 832 834 868 871 885 902 903 906 918 937 950 955 961 962 965 969 970 971 1004 1007 1015 1034 1036 1049 1056 1058 1069 1089 1099 1119 1124 1127 1138 1170 1177 1181 1184 1189 1214 1217 1243 1261 1262 
68 72 82 91 113 120 121 123 134 152 153 164 208 209 221 231 236 237 238 249 250 277 280 291 330 361 368 383 384 389 394 427 429 455 459 488 489 497 505 512 513 515 523 524 529 575 588 596 613 617 618 625 635 643 644 656 681 685 689 699 700 715 716 739 754 759 762 765 793 794 808 817 828 836 848 852 861 867 894 917 920 924 932 933 940 941 964 975 1021 1050 1054 1055 1064 1065 1080 1094 1101 1108 1126 1137 1145 1149 1152 1188 1190 1227 1235 1237 1246 1268 
56 96 100 101 114 133 138 141 145 155 156 182 188 193 194 195 204 225 239 244 245 262 276 331 339 375 398 402 403 419 530 539 541 563 565 566 583 584 597 605 609 631 655 672 673 675 676 683 690 702 708 758 771 804 827 837 840 841 843 873 877 878 880 897 911 927 953 985 996 1023 1027 1086 1106 1146 1154 1166 1185 1187 1197 1198 1226 1271 1278 1286 
78 90 112 125 126 135 154 161 170 172 198 206 263 265 274 300 353 387 388 391 407 416 433 440 449 452 457 467 487 498 511 532 534 558 560 581 670 688 710 717 726 733 734 753 755 770 778 781 798 821 826 830 849 872 876 928 938 947 948 972 984 991 1070 1090 1091 1092 1100 1109 1116 1122 1142 1151 1159 1162 1199 1209 1210 1215 1218 1224 1256 1264 1273 1281 
27 28 98 132 183 210 212 216 217 227 234 242 294 313 319 333 343 374 379 399 409 411 424 465 495 536 544 569 591 652 664 665 671 682 740 774 785 789 790 792 812 844 856 857 866 889 921 946 967 1010 1096 1098 1103 1105 1114 1115 1123 1169 1173 1212 1223 1231 1232 1249 1277 1288 
4 8 9 11 13 14 15 18 19 23 25 30 31 32 33 37 52 53 104 162 189 190 197 201 235 279 286 381 444 463 510 585 772 801 898 899 900 907 908 914 951 959 982 995 1018 1028 1048 1059 1087 1140 1141 1157 1165 1221 1222 1229 1252 1263 1279 
5 7 12 20 21 22 26 47 49 58 62 77 79 118 119 146 199 203 228 229 233 251 288 308 309 322 328 347 473 477 514 571 600 611 615 629 645 686 722 761 814 882 883 978 983 1017 1024 1075 1093 1107 1121 1144 1147 1167 1200 1247 1248 
24 48 95 105 106 124 186 187 243 266 271 305 316 324 354 355 356 358 359 390 426 461 576 657 718 729 741 766 818 819 854 916 939 1003 1008 1037 1051 1052 1133 1168 1191 1253 1257 1260 1265 
10 89 284 285 301 351 438 442 543 610 633 636 648 650 668 677 678 724 730 752 769 799 879 890 963 988 992 1016 1031 1161 1251 1267 
29 40 282 371 392 396 410 434 471 535 564 592 623 649 691 696 697 787 839 910 923 935 968 989 1061 1067 1072 1073 1132 1255 
108 267 268 329 508 540 567 735 736 763 775 776 777 784 795 802 803 813 847 870 915 925 934 1011 1012 1130 1180 1216 1245 1272 
136 176 303 304 310 382 451 462 521 549 587 602 746 764 779 782 788 838 853 859 979 1000 1078 1082 1088 1233 1240 
184 270 283 302 360 369 380 385 414 491 559 572 654 674 720 721 820 936 1035 1118 1148 1204 1242 1254 1282 
16 175 192 257 317 340 341 418 428 430 441 445 504 516 533 589 660 750 824 1068 1153 1183 1192 
86 87 166 200 207 264 296 320 447 476 522 667 780 976 1013 1053 1134 1135 1139 1182 1194 1283 
84 85 103 177 196 224 311 366 425 469 479 628 809 855 884 901 954 981 1026 1176 1230 
148 185 240 241 326 327 367 450 460 478 484 548 630 909 912 960 1040 1062 1172 1174 1175 
43 74 171 312 417 519 525 634 893 1038 1063 1085 1201 1213 1239 1244 
99 147 220 226 415 437 499 810 846 930 931 1014 1029 1280 
59 178 281 470 501 580 595 815 886 1009 1112 1158 1234 
88 191 342 365 406 472 704 986 987 1057 1111 1193 
179 293 364 372 520 627 751 767 811 858 865 1081 
850 851 874 875 881 926 1030 1033 1113 1125 1171 
64 65 66 75 338 993 1060 1083 1104 1120 
246 335 663 990 1025 1046 1095 1205 
474 669 842 929 958 1020 1208 
55 287 695 895 973 
443 490 980 1206 1207 
786 891 892 1163 1179 
3 337 507 994 
289 290 432 1044 
579 1203 1236 
904 905 1117 
