61 62 134 135 151 208 209 241 294 333 384 386 387 392 411 424 449 464 465 488 495 517 551 566 569 582 588 602 624 625 629 634 638 679 680 687 743 845 846 858 862 913 937 1014 1015 1079 1099 1138 1157 1210 1221 1228 1249 1264 1288 
67 101 109 188 248 329 330 373 393 404 427 447 475 482 500 503 541 604 606 612 626 724 725 745 748 759 832 887 896 897 903 919 927 966 1085 1086 1211 1245 1272 1283 1286 
39 53 115 124 139 140 163 312 460 473 487 542 554 560 574 577 594 617 630 637 675 698 723 727 764 797 814 836 852 871 922 933 983 1012 1019 1046 1054 1066 1089 1175 
55 56 83 138 141 146 156 167 177 204 244 245 281 327 376 452 483 530 565 609 699 742 752 771 804 911 985 1023 1136 1160 1278 
282 410 417 433 440 497 514 529 535 592 623 632 649 650 772 787 799 839 865 893 908 923 946 1008 1031 1061 1067 1072 1143 
0 1 4 10 12 13 21 22 23 26 37 43 74 147 269 453 469 981 1017 1200 1229 
9 122 152 171 221 231 586 618 654 722 808 826 828 831 860 861 1144 1145 1190 1204 1254 
81 372 494 524 709 747 749 816 851 868 869 942 943 965 968 977 1001 1028 1189 
184 185 270 271 274 283 302 337 346 360 369 380 385 479 508 572 820 1035 1282 
35 118 129 173 202 220 229 250 255 277 288 378 728 957 997 1247 1248 1269 
153 261 325 546 585 610 758 793 794 907 1002 1111 1116 1258 1259 1276 
46 93 94 136 213 368 374 395 439 587 653 707 779 930 1077 
79 80 183 320 321 339 345 713 714 841 872 918 947 1038 1218 
120 158 233 349 350 446 492 664 677 817 967 1032 1050 1101 1114 
168 238 408 409 470 491 536 579 774 855 886 1118 1261 1277 
206 340 341 437 525 544 824 1103 1183 1201 1213 1234 1244 1265 
332 334 357 448 521 590 660 736 763 788 843 864 1202 1240 
17 45 50 382 499 674 744 834 1000 1020 1127 1208 1280 
51 176 326 518 526 599 696 697 720 1004 1007 1209 1241 
144 189 190 262 286 402 419 563 708 730 873 1236 1263 
6 76 150 347 375 429 940 1063 1064 1093 1184 1266 
543 620 622 810 838 917 959 971 1034 1043 1162 1279 
18 30 33 52 162 178 580 801 900 1059 1141 
186 243 266 356 370 562 628 754 811 890 1026 
210 211 318 443 451 457 474 477 490 548 575 
5 20 41 63 100 571 601 645 1131 1271 
60 304 388 394 746 853 854 914 1078 1088 
128 367 414 450 607 608 809 909 1124 1158 
187 458 459 578 666 667 818 819 975 1030 
471 545 552 647 656 992 1039 1171 1227 1255 
25 216 252 425 426 515 916 954 1187 
28 40 127 191 192 276 366 1021 1193 
116 149 275 484 531 642 684 1049 1164 
218 230 246 466 901 939 969 1205 1216 
412 468 501 780 1084 1110 1112 1117 1178 
505 761 784 894 895 973 993 1098 1224 
59 310 371 481 611 963 1121 1233 
92 267 399 463 540 547 555 1285 
114 170 203 924 1091 1095 1185 1273 
145 239 272 379 583 732 880 902 
175 348 407 658 710 733 734 1281 
228 648 812 856 857 921 1140 1172 
335 336 691 694 721 970 1087 1242 
800 951 988 989 1071 1146 1182 1222 
47 142 143 298 299 509 1147 
58 123 344 456 489 822 932 
77 88 119 131 148 295 507 
125 164 205 256 273 278 287 
159 643 644 757 806 964 1128 
160 291 292 681 849 910 1009 
194 195 553 631 796 837 996 
212 342 343 591 1223 1231 1232 
217 472 795 925 934 1180 1212 
289 290 432 513 519 695 1044 
314 438 510 735 835 982 1287 
383 798 848 884 915 1152 1176 
441 442 516 596 613 1068 1192 
7 126 436 974 1203 1256 
8 154 418 739 1092 1196 
42 600 693 791 1025 1029 
65 130 296 619 621 1194 
70 792 1010 1024 1058 1130 
71 455 688 762 948 1056 
107 813 850 926 1033 1132 
198 352 991 1062 1100 1199 
251 280 635 1016 1080 1268 
285 506 668 669 686 863 
297 307 683 756 1107 1284 
306 361 823 833 1041 1042 
323 603 955 979 980 1126 
328 636 676 879 1027 1161 
406 904 905 1070 1168 1215 
415 416 781 876 928 984 
11 157 226 641 1239 
27 90 362 391 539 
29 98 224 257 331 
31 454 807 1018 1270 
38 82 89 97 556 
68 260 480 1188 1237 
86 166 207 324 522 
87 430 431 504 1195 
112 265 678 717 769 
113 690 715 1137 1246 
132 682 888 889 1123 
180 199 364 520 1253 
181 461 777 952 1133 
225 685 912 960 1197 
258 400 662 1181 1262 
268 700 802 803 1075 
316 317 589 718 750 
403 874 875 1113 1125 
537 538 584 639 663 
692 859 1045 1074 1275 
882 883 978 1155 1156 
14 84 161 646 
32 105 773 1119 
49 95 533 941 
72 435 716 877 
75 259 322 867 
85 172 755 972 
102 478 1153 1250 
121 396 523 661 
155 702 829 1166 
174 786 1163 1179 
182 263 595 1226 
196 485 1057 1230 
197 652 1102 1198 
214 215 405 593 
222 223 597 885 
227 401 704 705 
237 293 389 1108 
253 353 931 1142 
284 789 790 1096 
305 573 766 1214 
354 670 830 1037 
358 359 785 1257 
363 420 616 1022 
365 570 986 987 
381 413 711 753 
486 821 1122 1129 
493 568 701 949 
558 775 1011 1073 
726 1069 1170 1217 
751 767 778 1081 
782 783 1082 1173 
805 953 1165 1252 
906 961 962 1159 
16 24 511 
19 108 598 
34 103 219 
48 73 78 
54 444 445 
57 1076 1274 
64 66 338 
69 319 1177 
91 106 719 
96 398 995 
110 1109 1151 
111 303 1238 
133 240 605 
165 179 615 
193 672 673 
200 549 706 
232 1150 1174 
234 550 950 
236 279 920 
242 527 671 
249 765 1235 
351 498 633 
355 390 729 
377 956 1065 
397 434 564 
462 847 870 
467 534 567 
496 815 1115 
512 627 651 
532 760 866 
640 655 938 
659 770 936 
665 740 741 
689 1005 1006 
737 738 1267 
776 898 899 
827 1106 1154 
840 1003 1191 
842 929 958 
878 935 1186 
891 892 1243 
1047 1048 1225 
1060 1104 1120 
1134 1135 1139 
