64 65 66 75 111 194 195 216 217 242 329 330 349 350 379 399 424 446 464 465 480 481 483 488 493 494 503 509 524 526 531 533 542 553 554 569 570 574 577 578 582 585 586 588 599 602 603 606 612 613 614 616 618 621 622 624 625 626 629 630 637 638 644 651 652 653 661 674 679 680 682 687 689 690 692 693 698 700 703 706 707 711 716 719 722 723 731 739 744 745 747 749 754 759 762 764 773 785 808 816 822 828 832 836 845 846 852 860 861 866 867 868 869 887 903 905 906 909 916 917 918 919 922 924 927 932 933 937 950 965 968 972 974 976 977 983 1001 1002 1012 1015 1017 1022 1024 1028 1037 1039 1055 1056 1065 1066 1080 1100 1106 1109 1138 1145 1164 1189 1192 1204 1210 1241 1246 1258 1259 1267 1272 1276 1288 
55 56 83 100 101 128 138 141 144 145 146 154 155 156 167 177 182 193 204 244 245 246 247 262 280 281 326 327 375 376 398 402 403 452 475 476 482 506 530 559 563 565 566 609 699 702 708 752 760 771 786 792 801 804 873 911 914 985 994 1014 1023 1071 1124 1146 1151 1166 1185 1226 1251 1271 1278 
0 1 2 3 4 5 6 7 8 9 10 11 12 13 14 15 18 19 21 22 23 25 26 30 37 43 47 52 58 59 74 147 162 269 328 469 487 899 900 981 1053 1147 1193 1209 1229 1239 1245 1266 
263 264 362 363 371 396 410 417 433 440 450 462 471 478 497 514 529 535 539 592 595 623 632 649 650 691 694 726 772 787 799 839 865 881 893 908 923 946 1018 1031 1061 1067 1072 1073 1143 1186 1247 1248 
41 42 72 114 115 129 171 173 178 220 228 229 238 239 250 255 319 347 365 428 513 686 728 756 844 863 864 871 891 892 957 1103 1131 1177 1269 1284 
48 49 102 103 112 113 125 126 130 163 164 165 172 198 211 249 265 273 352 353 460 498 505 511 560 575 670 671 721 1036 1063 1114 1149 1168 1242 
184 185 270 271 274 275 283 302 337 338 344 346 360 369 380 381 384 385 414 429 447 479 484 508 572 589 761 820 827 940 1035 1044 1064 1237 
105 106 124 233 234 305 313 425 426 438 439 461 501 580 581 648 823 886 954 1051 1052 1085 1086 1119 1122 1133 1136 1152 1264 
139 140 303 307 314 315 334 357 420 435 496 502 528 571 576 659 732 805 825 829 849 856 953 973 1183 1238 1250 1286 1287 
67 68 93 94 109 136 161 170 188 200 201 221 304 310 325 372 374 382 383 404 512 523 549 587 1020 1188 1208 1273 
34 35 38 39 53 54 71 82 89 92 97 122 181 332 393 556 926 948 1007 1038 1040 1157 1158 1196 1198 1200 1285 
44 45 46 50 51 57 76 81 137 149 272 297 335 336 517 642 720 774 796 1062 1107 1127 1172 1173 1243 1277 
284 300 677 678 705 717 769 789 802 803 812 813 847 1091 1092 1130 1132 1142 1159 1162 1184 
84 85 107 108 127 253 254 276 277 282 311 455 456 485 573 646 1021 1148 1230 
320 321 345 415 416 454 558 685 770 781 826 830 837 876 897 928 984 1153 1154 
28 29 40 98 224 225 257 258 331 527 551 743 1050 1077 1101 1176 1228 1262 
60 61 69 70 73 150 151 157 158 159 174 248 712 857 921 987 1079 1155 
77 78 88 104 117 118 119 131 148 160 295 499 500 507 541 725 1280 
120 218 219 594 617 619 715 727 831 941 949 1054 1078 1088 1126 
62 63 95 134 135 210 294 333 411 607 1094 1099 1179 1212 
235 236 279 443 600 601 645 695 920 964 1019 1045 1123 1160 
408 409 430 431 470 491 536 579 1010 1076 1118 1195 1274 
16 17 20 24 27 36 296 504 966 1013 1025 1182 
202 203 205 206 232 256 278 287 288 308 590 
291 292 361 368 468 681 765 910 1009 1115 1235 
391 392 397 406 434 472 564 1070 1075 1137 1221 
457 663 990 991 1046 1165 1174 1175 1180 1252 1282 
33 486 657 662 821 942 943 1059 1129 1141 
116 222 223 261 418 427 597 885 1187 1263 
180 364 809 810 890 901 958 1026 1098 1216 
189 697 724 730 951 952 960 988 989 1222 
354 355 390 515 729 790 939 1096 1102 1283 
377 378 436 448 521 550 660 862 1181 1203 
79 80 96 99 183 339 598 912 1084 
175 176 348 407 658 710 913 1224 1281 
214 215 230 252 405 421 453 593 800 
301 775 776 784 894 895 904 1011 1058 
458 459 818 819 898 969 975 1069 1167 
537 538 639 814 815 935 936 1128 1144 
545 546 552 647 656 793 794 992 1217 
736 763 777 788 795 915 925 934 1240 
90 91 226 237 293 389 1108 1163 
121 123 259 260 312 322 323 386 
186 187 243 266 356 370 824 1030 
306 373 492 683 701 859 875 1032 
543 544 596 620 779 838 1213 1244 
31 32 806 807 870 982 1270 
212 213 342 343 395 591 1223 
285 351 633 668 669 748 1008 
466 467 534 557 567 615 1218 
604 605 640 641 655 688 938 
750 751 767 778 986 1081 1233 
872 947 979 980 1041 1042 1049 
879 880 961 962 963 1117 1161 
86 87 166 207 324 522 
132 133 227 240 241 367 
142 168 169 518 855 1261 
316 317 318 477 490 1089 
358 359 718 766 1214 1257 
510 654 755 791 835 1254 
635 636 675 676 1016 1027 
733 734 995 996 1215 1249 
797 798 848 884 1060 1120 
143 561 562 997 1199 
190 286 419 444 1236 
289 290 432 519 634 
412 413 568 834 1178 
449 842 843 929 1116 
473 474 548 902 1048 
610 611 709 851 1125 
627 628 811 858 1211 
737 738 742 955 1121 
817 1190 1253 1260 1265 
840 841 1003 1004 1191 
930 931 1000 1093 1256 
152 153 231 489 
340 341 525 1201 
387 388 394 532 
400 401 463 547 
441 442 516 1068 
782 783 1074 1275 
850 874 1033 1113 
882 883 978 1156 
888 889 956 1169 
970 971 1034 1043 
1005 1006 1087 1095 
110 753 1205 
179 199 520 
191 366 445 
192 643 967 
196 197 251 
209 437 1029 
268 540 555 
298 299 768 
451 608 746 
583 584 631 
666 667 780 
672 673 1171 
704 896 1234 
713 714 1090 
757 758 1227 
959 1255 1279 
993 1083 1104 
1047 1082 1225 
1134 1135 1139 
