1 2 6 34 35 38 39 41 42 54 67 71 92 97 102 122 124 127 130 139 140 163 165 173 181 194 202 205 211 214 215 218 219 230 253 254 255 269 273 278 292 307 314 315 332 334 344 346 357 373 377 378 393 405 408 420 435 436 439 443 448 453 490 491 492 496 502 506 527 528 545 546 550 552 553 555 556 557 562 568 586 590 591 593 601 607 608 619 632 641 647 659 662 666 701 705 712 723 727 732 748 756 760 800 805 825 829 831 833 844 859 862 863 864 877 896 936 937 944 945 948 949 950 952 956 966 977 979 980 996 997 1002 1019 1032 1039 1041 1042 1071 1097 1105 1118 1131 1143 1150 1170 1202 1206 1207 1223 1231 1232 1238 1250 1266 1269 1284 1285 1287 
44 45 46 50 51 57 76 81 90 93 94 107 116 128 137 142 143 149 167 168 169 247 258 259 260 261 264 272 275 297 298 299 306 318 321 323 336 361 362 370 386 400 410 413 433 438 440 456 466 467 486 487 493 494 509 517 518 542 554 570 573 574 582 598 599 604 606 612 616 642 646 651 679 680 694 706 709 719 726 737 738 749 768 773 796 816 819 821 823 832 834 868 902 906 918 955 961 962 965 969 970 971 1004 1007 1015 1034 1036 1049 1056 1058 1067 1099 1119 1122 1124 1127 1181 1184 1189 1214 1217 1243 1261 1262 1267 
0 36 60 61 69 70 73 83 110 111 115 117 131 144 147 150 151 157 158 159 160 174 195 226 248 295 345 348 349 350 352 363 376 380 412 421 430 431 446 454 458 464 475 480 482 483 485 499 500 526 531 551 561 577 578 594 603 621 622 624 637 638 658 661 684 687 692 698 703 707 711 713 714 725 731 742 743 744 747 822 845 860 869 882 883 887 913 919 922 942 943 974 978 1001 1014 1022 1043 1045 1047 1066 1074 1076 1078 1079 1088 1129 1136 1138 1155 1156 1160 1178 1186 1195 1225 1228 1241 1274 1275 1280 
68 72 82 109 113 120 121 123 136 152 153 164 221 231 236 238 249 280 291 325 330 368 374 383 384 394 404 416 427 429 455 459 468 489 497 503 505 512 523 524 529 575 587 588 596 613 617 618 626 635 643 644 656 685 689 699 700 715 716 739 759 762 765 793 794 808 817 828 836 848 852 861 867 894 903 917 920 924 932 933 941 964 975 1012 1021 1050 1054 1055 1065 1080 1094 1101 1110 1120 1126 1137 1145 1149 1152 1188 1190 1235 1237 1246 1258 1259 1268 1276 
96 100 101 145 155 156 182 193 244 245 250 262 263 277 375 398 402 403 419 474 513 530 539 541 559 563 565 566 605 609 669 672 673 675 676 683 702 708 771 781 804 837 840 841 842 843 850 851 873 874 875 881 911 926 927 929 958 985 1003 1020 1023 1027 1030 1033 1086 1113 1125 1146 1148 1166 1171 1191 1198 1208 1211 1226 1271 1278 
5 7 12 17 20 21 22 26 43 47 48 49 58 62 63 77 79 95 114 118 119 129 146 199 203 228 229 251 288 308 309 322 328 347 397 428 473 477 504 514 520 537 538 571 600 611 615 639 645 686 722 761 774 797 814 957 983 1017 1069 1075 1093 1107 1121 1147 1167 1185 1200 1212 1247 1248 1277 
28 64 65 66 75 98 134 183 208 209 210 216 217 227 233 234 242 294 313 316 317 333 338 379 390 399 411 424 465 481 488 495 516 533 569 589 614 625 629 652 671 745 754 789 790 792 866 967 1096 1102 1115 1144 1164 1192 1249 1288 
16 78 161 170 175 198 206 222 257 265 274 300 341 353 388 407 418 445 449 452 457 498 511 558 560 581 660 670 710 753 770 830 872 876 885 928 947 972 984 991 1070 1092 1100 1116 1153 1180 1183 1199 1273 
10 89 132 284 285 301 319 343 351 441 442 610 633 648 650 664 665 668 677 678 682 724 730 740 769 812 856 857 888 889 890 921 946 963 988 1010 1031 1068 1098 1114 1123 1169 1173 
112 125 126 135 154 172 223 256 387 391 532 534 640 655 688 717 733 734 755 778 798 849 931 938 1024 1090 1091 1109 1130 1142 1151 1159 1162 1209 1210 1215 1218 1224 1256 1264 1281 
56 133 138 141 148 184 185 204 232 240 241 283 302 326 327 360 367 369 385 450 478 484 572 630 820 909 912 960 993 1035 1040 1060 1083 1104 1172 1174 1175 
24 105 106 271 305 324 354 355 358 359 426 461 515 576 657 718 729 741 766 854 916 939 1008 1037 1051 1052 1133 1168 1253 1257 1260 1265 
8 9 11 14 15 19 23 25 30 33 37 52 162 772 801 826 900 951 995 1059 1141 1196 1201 1213 1221 1222 1229 1239 1244 
108 267 268 329 508 540 567 735 736 763 775 776 777 784 795 802 803 813 847 870 915 925 934 1011 1216 1245 1272 
29 40 282 371 392 396 434 471 535 564 592 623 649 691 787 839 910 923 935 968 1072 1073 1132 1227 1255 
53 80 180 414 544 620 653 654 674 720 721 785 907 959 1005 1006 1048 1077 1089 1103 1204 1242 1254 1279 
84 85 103 177 192 196 224 311 366 425 469 479 628 809 855 884 901 954 981 1026 1176 1230 
176 213 303 304 310 382 395 401 462 521 547 549 602 764 779 782 788 838 1000 1082 1233 1240 
13 18 189 190 286 444 451 463 510 746 853 898 899 908 914 982 1028 1087 1157 1263 
86 87 166 200 207 296 320 447 476 522 667 780 976 1013 1053 1134 1135 1139 1194 1283 
59 281 409 470 501 536 579 595 815 871 886 1009 1112 1158 1177 1203 1234 1236 
91 179 237 293 364 372 389 627 750 751 767 811 858 865 940 1081 1108 
4 31 32 104 197 201 235 270 279 381 585 1018 1140 1165 1252 1282 
99 178 220 339 365 415 437 580 728 791 810 835 846 930 1029 1084 
406 543 636 752 783 799 879 904 905 992 1016 1111 1117 1161 1251 
188 690 757 758 806 807 827 878 953 1106 1128 1154 1270 1286 
171 289 290 312 417 432 519 634 893 1044 1063 1064 1085 
225 239 276 331 583 584 597 631 681 880 897 1187 1197 
27 246 335 663 990 1025 1046 1095 1205 
74 525 696 697 989 1038 1061 1182 
186 187 243 266 340 356 818 824 
191 472 704 986 987 1057 1193 
55 287 695 895 973 
252 460 548 693 1062 
786 891 892 1163 1179 
3 337 507 994 
88 212 342 
