67 81 86 87 93 94 109 114 129 136 166 170 174 178 188 189 196 200 201 202 203 207 217 220 228 229 250 255 300 301 308 310 311 320 321 324 345 346 351 372 379 382 404 472 485 512 522 523 524 549 561 587 626 627 628 637 651 661 706 713 714 728 732 733 734 761 784 786 795 811 856 872 879 880 894 895 924 942 943 947 957 973 993 997 1020 1038 1057 1095 1098 1104 1161 1180 1185 1208 1212 1224 1230 1269 1273 1281 1286 
51 55 56 83 138 141 146 154 156 167 175 176 177 193 198 204 239 244 245 281 313 326 340 341 348 352 374 376 400 407 430 431 437 452 483 486 496 504 518 525 526 558 560 583 599 609 648 658 659 662 672 687 696 697 699 710 720 752 770 771 775 804 812 815 830 840 881 911 936 985 991 994 1003 1004 1007 1011 1023 1037 1062 1073 1100 1115 1122 1172 1178 1181 1183 1191 1195 1199 1201 1209 1241 1243 1251 1278 
8 71 72 76 116 132 149 150 184 194 222 240 247 270 271 275 283 302 327 337 347 360 369 384 385 386 392 418 429 479 484 508 517 531 553 569 572 582 588 589 625 642 682 731 739 747 749 755 762 816 820 846 852 858 868 869 885 888 889 906 913 940 948 961 962 965 968 977 996 1001 1012 1014 1015 1022 1028 1035 1049 1055 1056 1064 1091 1092 1094 1123 1138 1159 1163 1164 1189 1196 1221 1282 1288 
54 101 143 153 186 187 243 261 266 325 329 330 356 370 373 393 427 444 445 447 500 503 537 546 562 585 604 606 610 612 665 724 725 730 748 754 758 759 782 783 793 794 797 824 832 890 896 897 907 919 937 944 945 958 966 1002 1026 1030 1082 1085 1086 1111 1116 1173 1211 1245 1272 1283 
20 24 49 61 62 63 65 95 100 130 134 135 173 195 199 296 333 381 411 413 424 448 464 493 495 515 533 568 574 578 600 602 619 621 624 638 666 667 679 698 701 709 711 753 814 851 862 905 922 941 949 1079 1088 1119 1148 1179 1194 1202 1205 1258 1259 1271 1276 
7 16 27 48 73 78 90 120 126 158 182 233 237 263 264 293 349 350 362 389 436 446 492 511 539 595 643 644 664 677 678 717 757 769 806 817 967 974 1013 1032 1050 1053 1063 1067 1101 1108 1114 1128 1134 1135 1139 1203 1226 1232 
35 36 38 53 58 75 89 97 115 123 124 139 140 163 259 305 312 322 344 456 473 487 489 542 556 577 594 617 630 675 723 764 822 836 841 867 871 976 983 1019 1046 1047 1048 1051 1052 1054 1066 1175 1225 
0 1 2 3 4 5 10 12 15 18 21 22 23 26 30 33 37 41 43 44 52 74 147 162 269 328 469 571 580 601 636 645 676 801 882 883 900 978 981 1017 1027 1059 1131 1141 1193 1200 1229 
34 46 103 112 125 164 172 205 206 212 213 219 232 249 253 265 273 274 278 285 287 342 353 395 439 498 505 544 591 633 653 670 707 779 930 931 1077 1103 1142 1155 1156 1174 1223 1231 1234 
79 80 180 183 294 339 364 471 520 543 545 552 566 620 622 647 656 673 810 838 845 861 887 917 918 959 971 992 1034 1039 1043 1162 1171 1213 1227 1239 1244 1253 1255 1265 1279 
39 91 106 122 152 171 221 231 235 236 241 279 435 586 618 689 716 719 722 727 800 808 828 831 860 877 920 933 988 989 1005 1006 1071 1145 1146 1182 1190 
96 282 398 410 417 433 440 462 529 535 592 623 632 649 650 772 787 799 839 847 865 870 878 893 908 923 935 946 995 1008 1031 1061 1072 1143 1186 
57 234 314 332 334 357 438 460 510 521 550 554 590 660 669 735 736 763 788 796 835 842 843 863 864 925 929 934 950 982 1076 1240 1274 1287 
92 107 128 225 267 377 390 399 414 463 502 540 547 555 559 607 608 685 746 809 813 912 926 956 1065 1090 1124 1132 1150 1158 1197 1285 
6 82 113 151 268 365 368 375 383 428 458 488 570 680 690 700 715 743 818 819 932 975 987 1075 1093 1137 1157 1167 1228 1246 1266 
14 59 64 84 121 161 242 316 317 338 371 396 441 442 459 481 494 516 527 596 611 613 646 671 718 963 1060 1068 1121 1153 
19 32 66 102 105 108 185 227 248 367 401 450 465 475 478 482 541 551 598 684 704 705 745 773 903 909 927 1249 1250 
42 142 208 209 216 252 298 299 309 405 425 449 466 509 629 634 693 740 741 791 916 951 954 960 969 1025 1029 1099 1222 
110 111 118 288 303 378 380 506 514 538 584 639 663 668 686 692 703 729 859 1074 1102 1109 1151 1169 1198 1238 1247 1248 1275 
133 144 155 190 251 262 280 286 402 419 476 497 530 563 565 605 635 702 708 829 873 1016 1080 1166 1236 1263 1268 
13 297 306 307 361 403 683 756 765 844 850 874 875 891 892 1033 1105 1107 1113 1125 1233 1235 1284 
60 68 197 260 304 323 388 394 480 603 652 853 854 914 955 979 986 1078 1126 1184 1188 1192 1237 
335 336 528 532 576 691 694 721 760 805 825 827 866 953 970 1087 1097 1106 1154 1165 1242 1252 
9 31 415 416 454 614 631 657 781 807 821 826 837 876 928 984 1018 1129 1144 1270 
28 29 40 98 127 145 191 192 224 257 258 272 276 277 331 366 902 1021 1262 
168 214 215 238 408 409 421 453 470 491 536 579 593 774 855 886 1118 1261 1277 
218 230 246 291 292 363 420 616 750 751 767 778 849 901 910 939 1009 1081 1216 
169 223 358 359 467 534 557 567 726 785 898 1069 1140 1170 1217 1218 1257 1260 
17 45 50 354 355 499 674 744 823 833 834 1000 1127 1280 
47 412 468 501 780 980 1041 1042 1084 1110 1112 1117 1147 
159 315 573 737 738 742 766 964 1136 1149 1160 1214 1267 
210 211 318 443 451 457 474 477 490 548 575 1206 1207 
69 319 343 391 455 654 688 857 921 1177 1204 1254 
77 88 104 117 119 131 148 160 295 507 768 990 
11 157 226 640 641 655 776 899 938 1040 1083 
165 179 181 461 581 615 712 777 952 1089 1133 
70 99 254 792 802 803 1010 1024 1058 1130 
137 289 290 432 513 519 695 1036 1044 
256 798 848 884 915 1045 1120 1152 1176 
25 387 426 597 681 1187 1210 1264 
397 406 434 564 904 1070 1168 1215 
284 789 790 1096 
85 972 1256 
