42 47 61 62 113 134 135 142 151 208 209 241 248 268 294 298 299 333 358 359 365 381 384 386 387 392 411 413 424 449 458 464 465 471 488 493 495 509 517 533 541 545 551 552 566 568 569 570 578 582 588 600 602 620 622 624 625 629 634 638 647 656 661 666 667 679 680 687 690 693 700 701 709 711 715 743 747 749 753 785 791 802 803 810 816 836 845 846 851 858 861 862 868 869 913 917 919 927 937 941 949 951 965 968 971 975 977 987 992 1001 1014 1015 1022 1025 1028 1029 1034 1039 1043 1055 1075 1079 1094 1099 1137 1138 1147 1157 1162 1171 1189 1210 1221 1222 1227 1228 1246 1249 1257 1264 1288 
5 9 20 31 41 63 72 79 80 100 130 152 171 183 221 225 231 296 308 309 339 415 416 428 435 454 571 601 614 618 621 645 654 657 685 716 722 781 800 807 808 826 828 831 840 841 876 877 912 918 928 960 984 988 989 1003 1018 1071 1131 1144 1145 1146 1167 1182 1190 1191 1194 1197 1204 1254 1270 1271 
6 55 56 76 83 133 138 141 144 146 150 155 156 177 189 190 193 204 240 244 245 251 262 280 286 327 347 375 376 402 419 429 476 530 563 565 605 609 635 672 673 699 702 708 730 752 771 804 829 911 940 985 1013 1016 1023 1063 1064 1080 1093 1166 1184 1236 1263 1266 1268 1278 
54 101 143 153 174 186 222 223 243 261 266 325 356 370 373 393 427 444 445 447 500 546 562 585 597 604 606 610 612 628 724 725 748 754 758 759 786 793 794 811 824 832 885 890 896 897 907 944 945 966 1002 1026 1085 1086 1111 1116 1163 1179 1211 1258 1259 1276 1283 
38 51 57 65 82 89 91 97 106 122 175 176 234 314 326 332 334 348 357 407 438 448 510 518 521 526 550 556 586 590 599 619 658 659 660 696 697 710 719 720 735 736 763 770 788 835 843 860 864 936 950 982 1004 1007 1076 1202 1209 1240 1241 1274 1287 
36 39 53 115 124 139 140 163 312 329 330 383 404 460 473 487 503 542 554 577 581 594 617 626 630 675 698 712 723 727 764 797 798 814 848 871 884 915 922 933 976 983 1019 1046 1047 1048 1054 1066 1089 1152 1175 1176 1200 1225 1245 1272 
7 16 24 48 73 78 112 120 125 126 158 159 164 233 265 273 305 349 350 436 446 492 505 511 560 573 643 644 664 671 677 678 717 737 738 757 766 769 806 817 964 967 974 1032 1050 1051 1052 1101 1114 1128 1203 1214 1256 1267 
46 67 81 93 94 109 136 188 201 212 213 235 236 279 342 343 368 372 374 395 439 512 524 587 591 627 651 653 689 707 750 751 767 778 779 852 882 883 920 930 942 943 978 1005 1006 1012 1077 1081 1155 1156 1223 1231 1232 1286 
25 28 29 40 58 98 114 123 127 145 170 191 192 203 216 224 239 252 257 272 276 331 344 366 379 388 425 426 452 456 489 515 583 637 732 822 880 902 916 924 932 954 1021 1091 1095 1185 1187 1273 
0 1 2 3 4 10 12 13 15 18 21 22 23 26 30 33 37 43 44 52 74 147 162 178 269 328 469 528 580 636 676 783 801 879 900 981 994 1017 1027 1059 1141 1161 1193 1229 
35 118 129 173 202 205 217 229 250 255 256 277 278 287 288 378 380 472 506 668 669 686 692 703 728 782 795 859 863 925 934 957 997 1045 1074 1082 1169 1173 1180 1212 1247 1248 1269 1275 
34 103 184 185 206 219 220 270 271 274 283 302 337 340 341 346 360 369 385 437 479 508 525 543 544 572 589 820 827 838 959 1035 1103 1106 1154 1178 1183 1201 1234 1255 1265 1279 1282 
96 264 282 398 410 417 433 440 462 497 514 529 535 592 623 632 649 650 772 787 799 839 847 865 870 878 893 908 923 935 946 995 1008 1031 1053 1061 1067 1072 1134 1135 1139 1143 1186 
17 45 50 306 354 355 361 382 390 412 468 499 501 558 670 674 729 744 775 780 823 830 833 834 1000 1011 1020 1037 1041 1042 1073 1084 1110 1112 1117 1127 1208 1280 
92 160 187 218 230 246 267 291 292 363 399 420 459 463 466 540 547 555 576 616 681 818 819 849 901 910 939 969 1009 1030 1205 1216 1260 1285 
14 59 84 102 161 242 310 316 317 371 441 442 478 481 494 516 527 596 611 613 646 718 963 1068 1121 1153 1192 1233 1250 
107 128 232 367 377 414 450 502 559 607 608 809 813 825 850 909 926 956 1033 1065 1090 1097 1124 1132 1148 1150 1158 1174 
60 68 75 259 260 304 322 323 394 480 603 746 853 854 867 914 955 979 980 986 1078 1088 1126 1188 1237 
249 284 285 297 307 351 403 498 633 683 756 765 789 790 844 874 875 1096 1105 1107 1113 1125 1235 1284 
168 214 215 238 405 408 409 421 453 470 491 536 579 593 774 855 886 1118 1251 1261 1277 
85 116 149 172 198 275 313 352 484 531 642 755 881 972 991 1049 1062 1100 1164 1199 
32 49 95 105 197 247 475 482 574 652 731 745 773 873 887 903 1102 1119 1198 
11 157 226 640 641 655 776 898 899 938 1040 1060 1083 1104 1120 1213 1239 1244 
70 99 254 258 300 301 400 532 662 760 792 866 1010 1024 1058 1130 1181 1262 
121 396 523 761 784 842 894 895 906 929 958 961 962 973 993 1098 1159 1224 
165 169 179 181 461 467 534 557 567 615 726 777 952 1069 1133 1170 1217 
27 90 182 237 263 293 362 389 391 539 595 1108 1226 
167 281 483 486 496 742 815 821 1115 1122 1129 1136 1160 
210 211 318 443 451 457 474 477 490 548 575 1206 1207 
8 71 154 418 455 688 739 762 948 1056 1092 1196 
320 321 345 713 714 733 734 872 947 1038 1218 1281 
335 336 691 694 721 805 953 970 1087 1165 1242 1252 
69 228 319 648 812 856 857 921 1140 1172 1177 
77 88 104 117 119 131 148 295 507 768 990 
110 111 303 537 538 584 639 663 1109 1151 1238 
86 87 166 207 324 430 431 504 522 1195 
180 199 200 315 364 520 549 706 1149 1253 
19 64 66 108 338 598 891 892 1243 
137 289 290 432 513 519 695 1036 1044 
397 406 434 564 904 905 1070 1168 1215 
132 665 682 740 741 888 889 1123 
227 253 353 401 704 705 931 1142 
194 195 553 631 796 837 996 
196 311 485 561 684 1057 1230 
