101 188 197 248 329 330 365 370 373 383 393 427 475 482 500 503 541 562 570 604 606 612 626 652 680 684 743 745 747 748 754 759 816 832 836 852 868 869 887 890 903 919 927 937 958 965 968 977 1001 1012 1026 1028 1085 1086 1102 1189 1198 1211 1228 1245 1272 1286 
42 62 64 135 151 241 294 333 384 386 411 464 465 488 517 551 569 582 588 624 629 679 687 693 791 845 858 862 913 987 1014 1022 1060 1157 1249 1288 
53 81 124 139 140 163 312 372 473 474 487 524 542 576 577 617 630 689 698 727 749 764 871 933 942 943 983 1046 1047 1048 1138 1175 1225 
55 56 83 138 141 146 156 167 177 204 244 245 281 327 483 609 699 742 752 771 804 911 985 1023 1136 1160 1243 1251 1278 
282 410 417 433 440 514 529 535 592 623 632 649 650 772 787 799 839 865 893 908 923 946 1008 1031 1061 1067 1072 1143 
9 39 130 152 171 221 231 296 618 621 654 722 808 826 828 831 1144 1145 1190 1194 1200 1204 1254 
46 67 93 94 109 136 201 374 382 404 587 707 846 882 930 1020 1155 1156 1208 
332 334 357 448 521 590 660 736 763 788 842 843 860 864 925 929 934 1202 1240 
153 261 325 546 585 610 758 793 794 907 1002 1111 1116 1258 1259 1276 
168 238 408 409 421 470 491 536 579 774 855 886 1118 1261 1277 
184 270 271 283 302 360 369 385 479 508 572 589 820 1035 1282 
0 1 4 10 12 21 22 26 74 147 269 469 981 1193 
18 23 30 33 37 52 162 178 580 801 900 1059 1141 1229 
27 90 159 264 362 391 539 643 644 757 806 964 1053 1128 
51 176 326 518 526 599 696 697 720 1004 1007 1209 1241 
543 620 622 810 838 917 959 971 1034 1043 1162 1255 1279 
144 190 262 286 402 419 530 563 565 708 1236 1263 
48 73 77 78 88 119 131 148 295 337 507 
86 114 170 203 265 388 452 924 1095 1185 1273 
118 378 380 668 692 859 1045 1074 1247 1248 1275 
214 215 218 230 246 405 453 593 901 1205 1216 
5 20 41 63 100 571 601 645 1131 1271 
13 297 307 683 701 756 891 892 1107 1284 
17 45 50 499 674 744 834 1000 1127 1280 
47 142 143 298 299 466 509 969 1029 1147 
70 112 678 717 769 792 1010 1024 1058 1130 
158 349 350 446 664 817 967 1050 1101 1114 
210 211 318 443 451 457 477 490 548 575 
223 320 321 345 713 714 733 734 1218 1281 
134 145 239 272 379 583 732 880 902 
165 179 268 288 615 700 802 803 1075 
212 213 342 343 439 591 1223 1231 1232 
545 552 566 647 656 861 992 1039 1171 
6 76 150 347 375 1093 1184 1266 
8 222 418 739 885 1091 1092 1196 
11 157 226 640 641 655 776 938 
60 304 394 853 854 914 1078 1088 
91 106 122 255 586 719 957 1269 
92 267 399 463 540 547 555 1285 
116 149 275 531 642 755 1049 1164 
220 340 341 437 525 728 1178 1183 
256 798 848 884 915 1120 1152 1176 
285 351 498 633 670 830 879 1161 
335 336 691 694 721 970 1087 1242 
376 430 431 594 637 1054 1066 1195 
392 424 495 600 625 638 753 1221 
412 468 501 780 1084 1110 1112 1117 
458 459 578 666 667 818 819 975 
761 784 894 895 973 993 1098 1224 
58 123 344 456 489 822 932 
61 381 413 602 711 1015 1079 
125 164 205 273 278 287 505 
186 187 243 266 356 824 1030 
194 195 553 631 796 837 996 
196 485 872 947 1038 1057 1230 
198 352 560 991 1062 1100 1199 
208 209 449 634 951 1099 1222 
251 280 497 635 1016 1080 1268 
289 290 432 513 519 695 1044 
310 371 481 611 963 1121 1233 
314 438 510 735 835 982 1287 
323 603 955 979 980 986 1126 
429 447 484 940 1063 1064 1283 
25 387 426 1187 1210 1264 
28 40 127 276 366 1021 
59 316 317 494 718 1153 
71 455 688 762 948 1056 
79 80 183 339 841 918 
107 813 850 926 1033 1132 
128 367 450 809 909 1124 
160 291 292 849 910 1009 
180 199 364 520 1253 1260 
206 274 544 1103 1234 1265 
216 252 425 515 916 954 
284 789 790 844 1096 1105 
306 361 823 833 1041 1042 
406 904 905 1070 1168 1215 
415 416 781 876 928 984 
7 126 436 974 1203 
19 66 108 338 598 
29 98 224 257 331 
31 454 807 1018 1270 
35 173 202 229 997 
36 346 723 976 1019 
38 82 89 97 556 
65 619 797 814 922 
68 260 480 1188 1237 
72 435 716 877 1025 
113 690 715 1137 1246 
120 233 492 677 1032 
129 506 669 686 863 
132 682 888 889 1123 
175 348 407 658 710 
181 461 777 952 1133 
189 228 856 857 921 
217 472 795 1180 1212 
225 685 912 960 1197 
258 400 662 1181 1262 
368 653 1005 1006 1077 
403 874 875 1113 1125 
460 554 581 712 1089 
512 627 628 651 811 
537 538 584 639 663 
726 1069 1140 1170 1217 
750 751 767 778 1081 
800 988 989 1071 1146 
14 84 161 646 
32 105 773 1119 
75 259 322 867 
85 172 972 1256 
102 185 478 1250 
121 396 523 661 
154 648 812 1172 
155 702 829 1166 
166 207 324 522 
174 786 1163 1179 
182 263 595 1226 
227 401 704 705 
235 236 279 920 
237 293 389 1108 
253 353 931 1142 
305 573 766 1214 
328 636 676 1027 
358 359 785 1257 
363 420 616 939 
486 821 1122 1129 
516 596 613 1192 
533 709 851 941 
558 775 1011 1073 
782 783 1082 1173 
805 953 1165 1252 
906 961 962 1159 
1201 1213 1239 1244 
16 24 511 
34 103 219 
49 95 574 
54 444 445 
57 1076 1274 
69 319 1177 
96 398 995 
110 1109 1151 
111 303 1238 
133 240 605 
193 672 673 
200 549 706 
232 1150 1174 
234 550 950 
242 527 671 
247 731 873 
249 765 1235 
355 390 729 
377 956 1065 
397 434 564 
414 607 1158 
441 442 1068 
462 847 870 
467 534 567 
476 1013 1182 
493 568 949 
496 815 1115 
532 760 866 
659 770 936 
665 740 741 
724 725 730 
737 738 1267 
827 1106 1154 
840 1003 1191 
878 935 1186 
896 897 966 
1040 1083 1104 
1134 1135 1139 
