82 86 87 101 109 113 115 136 152 153 166 178 184 200 231 238 250 280 283 291 302 325 360 361 365 368 369 382 383 384 385 394 404 427 429 459 468 488 489 497 515 522 524 572 587 613 617 625 626 635 656 689 700 715 716 728 729 739 759 762 793 794 808 817 820 828 836 852 861 867 887 903 917 924 932 957 1021 1035 1050 1055 1080 1084 1086 1094 1101 1109 1110 1137 1145 1190 1246 1268 
44 45 46 50 51 57 76 81 93 94 107 116 142 143 149 168 169 222 258 260 261 272 275 297 298 299 323 336 362 370 386 413 486 493 503 509 517 518 542 554 570 574 598 599 604 606 612 614 640 642 646 652 694 706 709 719 737 749 773 785 796 816 823 832 834 868 885 902 906 950 965 970 971 1012 1015 1034 1056 1127 1138 1179 1184 1189 1217 1261 1262 
0 60 61 69 70 73 131 150 151 157 158 159 160 174 195 227 248 295 345 349 350 352 363 421 446 464 465 531 551 577 578 621 637 638 687 707 731 845 974 993 1022 1040 1047 1079 1083 1104 1225 1241 1249 
3 6 34 35 38 39 41 54 71 97 102 130 139 163 165 181 194 211 218 219 230 273 292 332 334 393 553 556 557 568 632 748 831 949 977 1041 1042 1131 1143 1150 1250 1266 
78 161 170 198 202 300 353 388 407 416 457 511 558 560 581 710 753 765 770 781 830 833 876 904 928 984 991 997 1037 1092 1100 1116 1199 1232 1235 1273 
117 346 348 454 475 480 481 485 500 544 561 603 622 653 658 661 684 698 744 747 754 768 860 913 919 922 1001 1005 1006 1019 1043 1076 1077 1103 1123 1274 
56 96 138 141 145 156 182 244 245 262 375 398 402 419 530 539 541 563 565 609 702 708 771 804 837 873 911 927 1023 1146 1166 1211 1226 1278 
27 28 98 183 210 216 217 242 294 333 379 390 399 409 411 424 495 536 671 774 789 790 792 812 844 866 967 1010 1096 1098 1173 1212 1277 
5 7 12 22 26 47 49 58 203 229 328 571 600 629 686 722 814 882 883 978 983 1017 1024 1107 1147 1148 1200 
8 9 11 14 15 19 23 25 30 33 37 52 162 209 772 801 900 951 952 995 996 1059 1141 1221 1222 1229 
20 42 92 140 253 269 315 377 378 435 436 496 550 590 662 666 712 732 745 862 864 888 956 1164 1238 1285 
77 79 118 119 129 146 228 251 288 322 347 473 514 538 615 639 663 761 1046 1093 1247 1248 
132 148 185 204 240 241 326 327 367 450 478 484 559 630 909 912 1065 1172 1174 1175 
29 40 282 371 396 410 471 535 592 623 691 787 839 923 1067 1072 1227 1255 
13 122 254 255 306 307 373 492 586 701 756 1002 1032 1105 1269 1284 
105 106 124 305 324 354 741 916 1008 1029 1051 1052 1168 1191 
212 395 439 527 545 546 591 647 829 1223 1231 1258 1259 1276 
89 284 441 442 648 650 677 879 890 958 963 1068 1161 
90 155 263 264 433 440 467 487 726 840 841 1122 
134 225 239 276 331 583 584 631 880 897 1187 1197 
175 192 257 341 418 445 569 660 750 1153 1183 1288 
99 220 226 339 355 415 437 499 810 1178 1280 
103 224 469 479 809 855 884 901 981 1026 1176 
850 851 874 875 881 926 1030 1033 1113 1125 1171 
120 121 123 164 236 596 618 727 920 1054 
176 303 310 521 602 779 782 838 1082 1233 
376 431 523 594 711 791 835 1066 1119 1195 
53 190 197 463 907 908 959 1048 1279 
144 380 420 668 692 713 714 1074 1275 
191 472 704 961 962 986 987 1057 1193 
205 206 265 274 278 452 826 872 1230 
4 32 104 201 381 1018 1165 1252 
83 412 482 483 738 742 1136 1160 
84 85 177 196 311 366 425 954 
114 566 675 676 985 1027 1185 1198 
316 358 359 657 718 766 821 1257 
528 567 576 802 805 847 870 1260 
736 763 777 795 915 925 934 1180 
16 317 494 516 533 589 1192 
91 237 389 940 941 1108 1126 
100 403 683 842 843 889 1271 
108 267 268 540 803 813 1130 
112 126 717 755 1091 1159 1224 
172 670 846 930 931 972 1256 
249 505 575 588 894 933 1149 
304 462 549 764 788 1000 1240 
616 679 918 1003 1004 1007 1049 
36 110 111 506 703 1102 
72 128 400 582 1124 1163 
186 243 266 340 356 824 
189 286 444 510 982 1263 
213 401 547 1036 1089 1170 
214 215 252 453 593 693 
223 733 734 1215 1218 1281 
232 343 856 857 921 1169 
233 234 313 580 1115 1144 
414 720 721 955 1181 1242 
10 285 351 498 633 
43 259 312 893 1085 
59 501 871 1112 1177 
64 65 75 338 1060 
66 562 811 937 964 
67 800 896 966 1071 
68 512 529 1188 1237 
137 318 466 819 969 
154 387 426 1210 1264 
171 417 519 1063 1064 
188 690 877 878 1286 
277 456 573 651 1214 
289 290 432 513 1044 
296 476 667 780 976 
314 601 641 863 1287 
319 391 946 1090 1162 
374 455 491 936 1118 
470 595 1009 1158 1234 
526 743 869 1196 1228 
627 628 751 767 1081 
636 783 799 992 1016 
664 665 682 740 1114 
757 806 807 1128 1270 
758 827 953 1106 1154 
853 914 1028 1078 1157 
935 989 1061 1073 1182 
127 619 659 1088 
179 293 520 865 
199 477 905 1117 
208 405 449 634 
246 990 1095 1205 
320 447 1013 1283 
329 1216 1245 1272 
344 552 555 1039 
392 434 564 1132 
451 490 608 746 
458 680 975 1167 
654 674 1204 1254 
775 776 784 1011 
822 942 943 1129 
848 1045 1120 1152 
1201 1213 1239 1244 
1 2 723 
17 63 397 
21 611 1075 
55 287 895 
80 180 620 
133 605 655 
135 688 938 
173 448 1202 
207 1053 1194 
235 279 585 
247 1058 1099 
256 534 798 
281 815 886 
321 330 685 
337 507 994 
357 607 760 
364 372 858 
428 430 504 
460 548 1062 
461 854 1133 
525 696 697 
532 705 1151 
543 752 1251 
579 1203 1236 
649 910 968 
669 1020 1208 
724 725 730 
778 849 1142 
786 891 892 
898 899 1069 
947 948 1070 
1134 1135 1139 
