44 45 46 50 51 57 76 81 93 94 107 116 128 137 142 143 149 167 168 169 258 260 261 272 275 297 298 299 321 323 336 362 370 386 400 413 456 466 486 493 494 503 509 517 518 542 554 570 573 574 582 598 599 604 606 612 614 616 642 646 651 652 679 680 694 706 709 719 737 749 768 773 785 796 816 823 832 834 868 902 903 906 918 950 961 962 965 969 970 971 1004 1007 1012 1015 1034 1049 1056 1069 1119 1124 1127 1138 1167 1184 1189 1214 1217 1243 1261 1262 
0 60 61 69 70 73 83 117 131 150 151 157 158 159 160 174 195 248 295 345 346 349 350 352 363 412 421 446 454 458 464 475 480 481 482 483 485 500 531 537 551 561 577 578 621 624 637 638 653 661 684 687 698 707 711 725 731 744 747 797 860 919 922 937 974 1001 1019 1022 1047 1077 1079 1123 1155 1156 1160 1178 1186 1211 1225 1241 
82 113 115 120 121 123 134 152 153 164 208 209 231 236 280 330 368 383 459 488 489 515 524 596 613 617 618 625 656 685 689 700 715 716 727 729 739 754 759 762 793 794 808 828 836 845 848 852 861 867 887 917 920 932 941 975 1005 1006 1050 1054 1055 1094 1101 1109 1126 1137 1152 1190 1246 
6 41 42 71 92 129 173 253 269 314 315 332 344 365 377 378 435 436 448 496 520 550 552 555 590 641 662 666 705 712 728 732 745 862 864 888 889 956 957 1039 1041 1042 1131 1150 1164 1202 1266 1285 1287 
27 28 98 183 210 216 217 227 234 242 294 313 333 379 390 399 409 411 424 465 495 536 544 671 774 789 792 812 866 967 1010 1098 1103 1115 1173 1212 1249 1277 
35 38 39 54 97 122 130 165 181 194 254 255 292 306 307 361 373 393 408 420 492 502 553 556 557 586 632 681 748 756 831 952 977 1002 1032 1143 1269 1284 
109 144 325 348 380 404 526 603 622 626 658 692 713 714 743 783 913 1043 1074 1076 1196 1228 1258 1259 1274 1275 1276 
8 9 11 14 15 19 23 25 30 33 37 52 162 772 801 900 951 995 996 1059 1141 1221 1222 1229 
34 102 127 139 140 163 211 218 219 230 273 334 527 528 568 619 659 701 805 825 949 1097 1238 1250 
21 79 118 146 228 229 251 288 322 347 473 514 538 611 615 639 663 761 1046 1075 1093 1247 1248 
5 7 10 12 22 26 47 49 58 62 203 328 629 686 722 814 983 1017 1024 1107 1147 
56 96 138 141 156 204 245 262 339 375 398 402 419 565 702 708 804 873 1023 1146 1166 
136 176 303 304 310 382 462 521 549 587 602 764 778 779 782 788 838 1000 1082 1233 1240 
29 40 282 371 396 410 471 535 592 623 691 787 839 923 1067 1072 1227 1255 
53 189 190 197 286 444 463 510 907 908 959 982 1048 1263 1279 
105 106 124 305 324 354 426 741 916 1008 1029 1037 1051 1052 1168 
89 284 285 351 442 633 648 650 668 677 879 890 963 1161 
198 407 457 511 560 581 770 876 928 984 991 1100 1199 1232 
114 225 239 276 331 583 584 631 880 897 1185 1187 1197 
132 148 240 241 326 327 367 450 484 909 1172 1174 1175 
184 283 302 320 360 369 385 447 572 1013 1035 1182 1283 
108 267 268 540 567 802 803 813 847 870 993 1130 
175 257 341 418 445 569 660 750 1153 1154 1183 1288 
238 394 427 429 497 635 817 924 1021 1080 1145 1268 
77 78 119 161 353 416 558 710 781 830 904 
100 188 403 683 690 771 843 877 878 1271 1286 
182 244 530 541 563 609 837 911 927 1226 1278 
249 291 505 523 575 588 765 894 933 1149 1235 
850 851 874 875 881 926 1030 1033 1113 1125 1171 
212 395 439 545 546 591 647 829 1223 1231 
170 202 300 388 753 833 997 1092 1273 
4 32 104 201 381 1018 1165 1252 
86 87 166 200 476 522 667 780 
91 237 384 389 940 1044 1064 1108 
99 220 226 415 437 499 810 1280 
101 250 277 289 290 432 513 1086 
103 224 809 855 884 901 1026 1176 
112 206 265 274 452 717 826 872 
126 343 856 857 921 1159 1224 1256 
214 215 252 453 593 693 791 835 
316 358 359 657 718 766 821 1257 
736 763 777 795 915 925 934 1180 
36 110 111 703 790 1096 1102 
186 243 266 356 405 449 1116 
192 196 311 366 425 954 1230 
213 318 401 547 1036 1089 1170 
317 441 516 533 589 1068 1192 
543 636 752 799 992 1016 1251 
185 478 630 820 1040 1083 
281 470 595 1009 1158 1234 
319 391 946 1090 1091 1162 
355 576 939 1253 1260 1265 
566 675 676 985 1027 1198 
696 697 935 989 1061 1073 
20 308 309 571 600 
43 259 312 893 1085 
59 501 871 1112 1177 
64 65 66 75 338 
67 800 896 966 1071 
68 512 529 1188 1237 
90 263 433 440 726 
135 640 655 688 938 
171 417 519 634 1063 
172 498 670 755 972 
205 256 278 534 798 
376 431 594 1066 1195 
451 746 853 1078 1088 
733 734 1215 1218 1281 
757 806 807 1128 1270 
822 869 942 943 1129 
3 337 507 994 
16 428 430 504 
74 525 1038 1201 
154 387 1210 1264 
179 293 364 865 
199 477 905 1117 
207 264 1053 1194 
222 223 597 885 
246 990 1095 1205 
301 724 730 988 
329 1216 1245 1272 
357 607 608 760 
392 434 564 1132 
414 720 721 1242 
469 479 628 981 
472 704 986 987 
506 601 863 1045 
627 751 767 1081 
654 674 1204 1254 
775 776 784 1011 
882 883 978 1200 
1 2 723 
13 898 899 
17 63 397 
55 287 895 
80 180 620 
84 85 177 
155 840 841 
187 818 819 
191 1057 1193 
193 672 673 
235 279 585 
247 1058 1099 
372 811 858 
443 490 980 
460 548 1062 
461 854 1133 
467 487 1122 
468 1084 1110 
491 936 1118 
579 1203 1236 
649 910 968 
664 665 740 
669 1020 1208 
738 955 1181 
786 891 892 
846 930 931 
914 1028 1157 
947 948 1070 
1060 1104 1120 
1134 1135 1139 
1213 1239 1244 
