6 35 38 42 43 53 72 82 89 97 113 115 129 139 140 151 163 194 250 259 268 312 332 368 375 383 392 428 458 473 474 487 488 517 542 553 556 566 577 582 588 594 617 625 629 630 675 680 682 690 693 700 715 743 747 764 782 791 816 836 841 845 846 852 858 868 869 871 913 929 932 965 968 975 977 983 987 996 1001 1019 1025 1028 1046 1047 1054 1055 1066 1075 1082 1093 1094 1123 1137 1138 1157 1163 1167 1173 1175 1189 1221 1225 1228 1246 1266 
19 20 39 61 62 63 66 91 95 100 106 108 122 130 134 135 152 171 173 195 221 226 231 235 236 241 255 279 296 333 411 424 435 448 464 471 495 515 545 552 586 598 600 602 618 619 621 624 638 647 656 664 679 689 698 716 719 722 727 728 753 800 808 814 828 831 860 861 862 877 920 922 933 957 988 992 1005 1006 1039 1071 1079 1088 1145 1146 1148 1190 1194 1202 1205 1212 1227 1255 1258 1259 1269 1271 1276 
55 56 57 83 138 141 144 146 155 156 177 190 193 204 234 245 247 251 262 280 286 314 328 334 357 376 402 419 438 452 476 497 510 521 530 550 563 565 590 605 609 635 636 648 660 669 672 676 699 702 708 731 735 736 752 763 771 783 788 796 799 804 829 835 843 863 864 873 879 911 925 934 950 982 985 994 1014 1016 1020 1023 1027 1076 1080 1161 1166 1208 1236 1240 1251 1263 1268 1274 1287 
0 1 2 3 4 5 10 12 15 18 21 22 23 26 30 33 37 41 44 47 52 74 142 143 147 162 269 298 299 412 468 469 501 509 571 580 601 645 780 798 801 848 882 883 884 900 915 978 980 981 1017 1041 1042 1045 1059 1084 1110 1117 1120 1121 1131 1141 1147 1152 1176 1193 1200 1229 
54 101 153 186 187 222 243 261 266 325 356 370 373 393 427 444 445 447 500 537 546 562 585 604 606 610 612 665 724 725 730 748 754 758 759 793 794 797 824 832 842 885 890 896 897 907 919 937 944 945 958 966 1002 1026 1030 1031 1085 1086 1111 1112 1116 1171 1211 1283 
46 67 81 93 94 136 196 201 292 311 320 321 345 351 363 372 382 420 485 498 523 524 561 587 589 616 633 653 661 670 707 713 714 733 734 750 751 767 778 779 849 872 930 931 942 943 947 1009 1038 1057 1077 1081 1155 1156 1199 1230 1233 1281 
13 96 282 291 297 306 307 361 398 403 410 417 440 514 529 535 592 623 632 649 650 681 683 701 756 765 772 787 839 844 875 878 891 892 893 908 910 923 935 946 959 995 1008 1061 1067 1072 1105 1107 1125 1143 1186 1235 1279 1284 
86 112 121 125 164 170 172 189 203 205 216 228 242 249 252 256 273 278 287 308 379 396 425 466 505 527 637 671 732 740 741 761 784 856 894 895 916 924 954 969 973 993 1029 1095 1098 1224 1273 
32 49 102 105 132 133 185 199 227 240 248 284 300 367 371 401 450 465 475 478 481 482 541 551 574 578 611 666 667 684 704 705 745 773 789 903 905 909 927 961 962 963 1056 1091 1249 1250 
92 107 128 218 225 230 232 246 267 330 377 390 399 400 414 463 502 540 547 555 559 607 608 685 729 746 809 813 888 889 901 912 926 939 956 1065 1090 1124 1132 1150 1158 1174 1197 1216 1285 
45 50 51 75 167 175 176 281 326 348 354 374 407 483 518 526 599 658 662 674 687 696 697 710 720 744 749 823 833 834 936 1000 1003 1004 1007 1127 1181 1191 1209 1241 1243 
34 79 80 103 180 183 206 219 274 294 339 340 341 364 437 520 525 543 544 620 622 673 810 838 887 917 918 971 1034 1043 1103 1162 1178 1201 1213 1234 1239 1244 1253 1265 
90 120 191 192 233 237 263 264 293 389 433 462 492 539 643 644 677 678 717 757 769 806 847 865 870 967 1032 1050 1053 1101 1108 1128 1134 1135 1139 
7 48 73 77 78 88 104 117 119 126 131 148 158 160 182 295 349 350 362 436 507 595 768 817 974 990 1013 1021 1182 1203 1226 
14 59 65 68 84 124 161 260 305 317 441 442 446 459 480 494 516 596 613 646 818 819 1051 1052 1068 1114 1153 1188 1192 1237 
110 111 118 285 288 303 378 380 506 538 584 639 663 668 686 692 703 790 859 1074 1096 1102 1109 1151 1169 1198 1238 1247 1248 1275 
76 150 184 270 283 302 327 337 347 360 369 384 385 386 418 429 479 484 508 569 572 739 820 940 1035 1064 1196 1282 1288 
69 212 213 277 319 342 343 391 395 397 406 434 439 455 564 591 654 688 857 921 1070 1177 1204 1215 1223 1231 1254 
28 29 40 98 114 127 145 224 239 244 257 258 272 276 331 366 583 880 902 1048 1185 1262 1278 
116 149 197 275 322 323 365 531 570 603 642 652 755 867 906 986 1012 1015 1049 1126 1159 1164 1184 
87 159 166 200 207 315 324 522 549 573 706 737 738 742 766 964 1136 1149 1160 1214 1267 
335 336 528 532 576 691 694 721 760 805 825 827 953 970 1087 1097 1106 1154 1165 1242 1252 
70 99 220 254 301 355 499 511 792 802 803 1010 1024 1058 1063 1122 1130 1232 1280 
168 214 215 238 408 409 421 453 470 491 536 579 593 774 855 886 1118 1261 1277 
16 381 413 430 431 504 533 709 711 850 851 874 941 1033 1113 1119 1179 1195 
17 24 25 36 58 123 344 387 426 456 489 597 723 822 976 1187 1210 1264 
137 165 179 181 289 290 432 461 513 519 615 695 777 952 1036 1044 1133 
27 188 202 217 229 346 472 512 627 628 651 795 811 997 1180 1286 
253 353 496 558 775 830 904 989 1011 1037 1073 1115 1142 1168 
64 329 460 503 554 581 712 1022 1060 1089 1104 1245 1272 
9 31 454 614 657 807 821 840 1018 1129 1144 1270 
210 211 318 443 451 457 477 490 548 575 1206 1207 
11 157 640 641 655 776 899 938 1040 1083 
60 304 388 394 853 854 914 955 979 1078 
109 174 178 310 404 493 568 626 786 949 
208 209 309 405 449 634 951 960 1099 1222 
265 415 416 631 781 826 837 876 928 984 
8 71 154 762 812 866 948 1092 1172 
198 313 352 560 881 991 1062 1100 
169 557 898 1069 1140 1170 1217 
316 358 359 718 726 785 1257 
223 467 534 567 1218 1260 
486 659 770 815 1183 
85 972 1256 
