44 45 46 50 51 57 76 81 93 94 107 116 128 137 149 167 222 223 258 260 261 272 275 277 297 298 299 318 323 336 362 370 386 400 413 456 466 486 493 494 503 509 517 518 542 554 570 573 574 582 597 598 599 604 606 612 614 616 642 646 651 652 679 680 694 706 709 719 737 749 768 773 785 796 816 823 832 834 846 868 885 902 903 906 918 937 950 961 962 965 969 970 971 1007 1012 1015 1022 1034 1049 1056 1124 1127 1138 1167 1184 1189 1214 1217 1243 1262 
72 82 91 115 120 121 123 134 152 153 208 209 231 236 237 238 250 280 368 383 384 389 394 427 429 459 488 489 497 515 596 613 617 618 625 635 656 689 700 715 716 727 729 739 759 762 793 794 808 817 828 836 848 852 861 867 887 917 920 924 932 933 940 941 957 1021 1044 1050 1054 1055 1064 1080 1094 1101 1108 1109 1126 1145 1152 1190 1268 
117 144 160 348 352 380 454 475 480 481 485 500 526 531 544 551 561 603 622 624 653 658 661 684 692 698 713 714 725 731 744 747 754 783 860 913 919 922 1001 1005 1006 1019 1043 1074 1076 1077 1103 1123 1186 1196 1211 1258 1259 1274 1275 1276 
0 60 61 69 70 73 131 150 151 157 158 159 174 195 227 248 295 345 349 350 363 421 446 458 464 465 577 578 621 637 638 687 707 743 822 845 869 974 975 1047 1079 1155 1156 1225 1228 1241 1249 
56 96 101 138 141 145 156 182 204 244 245 262 375 398 402 419 506 530 539 541 563 565 609 702 708 771 804 837 873 911 927 985 1023 1086 1146 1166 1226 1278 
27 28 98 183 210 216 217 234 242 294 313 333 379 390 399 409 411 424 495 536 671 774 789 792 812 866 967 1010 1098 1115 1173 1212 1277 
67 122 254 255 306 307 344 373 377 408 420 435 492 502 528 552 555 586 756 800 805 888 889 896 956 966 1002 1032 1039 1071 1269 1284 
5 7 10 22 26 47 49 58 203 308 309 328 571 600 629 686 722 814 983 1017 1024 1107 1147 1148 1209 
20 42 92 140 253 269 315 332 378 436 496 550 590 601 662 666 712 732 745 862 863 864 1164 1238 1285 
3 6 41 102 124 163 211 218 219 292 334 355 568 701 831 939 949 1041 1042 1131 1150 1250 1266 
79 118 129 146 228 229 251 288 322 347 473 514 538 615 639 663 761 1046 1093 1247 1248 
9 11 14 15 19 23 25 30 33 37 52 162 801 900 951 952 1059 1141 1222 1229 
126 205 232 278 319 343 391 849 856 857 921 946 1090 1091 1142 1159 1162 1169 1224 1256 
170 198 300 388 407 457 511 560 581 753 770 876 928 984 991 1092 1100 1199 1232 1273 
29 40 282 331 371 396 410 471 535 592 623 691 787 839 923 1067 1072 1227 1255 
34 35 38 39 54 71 97 130 165 181 194 393 553 556 557 632 748 977 1143 
105 106 305 324 354 426 673 741 819 916 1008 1029 1037 1051 1052 1168 1191 1253 1265 
86 87 109 136 166 200 207 325 404 468 522 523 524 587 626 1084 1110 1230 
53 189 190 197 286 444 463 510 907 908 959 982 1048 1263 1279 
77 78 119 161 353 416 558 710 733 734 781 830 904 1215 1281 
89 284 285 351 442 633 648 650 668 677 879 890 963 1161 
113 125 164 249 273 505 575 588 765 894 1137 1149 1235 1246 
184 206 274 283 302 360 369 385 452 572 820 872 1035 
108 267 268 540 567 802 803 813 847 870 993 1130 
114 225 239 276 583 584 631 880 897 1185 1187 1197 
175 257 341 418 445 569 660 750 1153 1183 1288 
850 851 874 875 881 926 1030 1033 1113 1125 1171 
36 110 111 703 790 942 943 1096 1102 1129 
212 395 439 545 546 591 647 829 1223 1231 
99 220 226 339 415 437 499 810 1280 
241 327 484 559 912 1065 1172 1174 1175 
376 431 594 711 791 835 1066 1119 1195 
4 32 104 201 381 1018 1165 1252 
83 412 482 483 742 1136 1160 1178 
84 85 177 196 311 366 425 954 
103 224 809 855 884 901 1026 1176 
127 139 230 527 619 659 1078 1088 
304 382 462 549 764 788 1000 1240 
316 358 359 657 718 766 821 1257 
736 763 777 795 915 925 934 1180 
176 310 521 778 782 1082 1233 
317 441 516 533 589 1068 1192 
414 720 721 738 955 1181 1242 
543 636 752 799 992 1016 1251 
155 467 487 840 841 1122 
213 401 547 1036 1089 1170 
214 215 252 453 593 693 
281 470 595 1009 1158 1234 
365 472 704 728 986 987 
696 697 935 989 1061 1073 
8 772 995 996 1221 
12 882 883 978 1200 
43 259 312 893 1085 
59 501 871 1112 1177 
64 65 66 75 338 
68 512 529 1188 1237 
90 263 433 440 726 
100 403 683 843 1271 
135 640 655 688 938 
142 143 168 169 1261 
148 326 367 450 909 
171 417 519 634 1063 
185 478 630 1040 1083 
188 690 877 878 1286 
296 476 667 780 976 
320 447 1013 1182 1283 
346 627 751 767 1081 
498 670 930 931 972 
566 675 676 1027 1198 
757 806 807 1128 1270 
786 891 892 1163 1179 
13 898 899 1069 
16 428 430 504 
74 525 1038 1201 
112 265 717 826 
154 387 1210 1264 
179 293 520 865 
186 243 266 356 
191 192 1057 1193 
199 477 905 1117 
246 990 1095 1205 
289 290 432 513 
301 724 730 988 
303 602 779 838 
321 330 685 1218 
329 1216 1245 1272 
357 607 608 760 
364 372 811 858 
392 434 564 1132 
469 479 628 981 
576 825 1097 1260 
654 674 1204 1254 
775 776 784 1011 
1 2 723 
17 63 397 
21 611 1075 
55 287 895 
80 180 620 
173 448 1202 
202 833 997 
235 279 585 
247 1058 1099 
256 534 798 
264 1053 1194 
291 361 681 
314 641 1287 
337 507 994 
405 449 1116 
443 490 980 
451 746 853 
460 548 1062 
461 854 1133 
491 936 1118 
532 705 1151 
579 1203 1236 
645 1045 1121 
649 910 968 
664 665 740 
669 1020 1208 
827 1106 1154 
914 1028 1157 
947 948 1070 
1060 1104 1120 
1134 1135 1139 
1213 1239 1244 
