44 45 46 50 51 57 76 81 93 94 116 137 142 143 149 167 168 169 258 272 275 297 336 362 466 493 494 509 517 518 574 582 598 599 604 606 612 616 640 642 646 679 680 694 719 737 749 796 816 832 868 902 918 950 965 969 970 971 1004 1007 1015 1034 1036 1049 1127 1184 1189 1217 1243 1261 1262 
72 109 113 136 152 153 231 236 291 321 325 330 361 368 383 384 404 459 468 489 503 524 587 596 613 617 626 656 685 689 700 715 716 739 759 793 794 808 828 836 848 852 903 917 920 932 933 941 975 1050 1055 1065 1084 1094 1101 1110 1126 1137 1152 1190 1227 1246 1258 1259 1276 
0 60 61 69 70 73 131 144 150 151 157 158 159 160 174 195 248 295 349 350 352 380 421 446 458 464 475 485 526 531 551 577 578 594 621 624 637 638 661 687 692 711 731 743 783 822 845 937 974 1001 1045 1047 1066 1074 1079 1138 1155 1186 1196 1225 1228 1241 1275 
36 110 111 115 117 345 346 348 363 454 480 481 500 561 603 614 622 653 658 684 698 703 707 713 714 725 744 747 791 835 860 869 913 919 922 942 943 1005 1006 1019 1022 1043 1076 1077 1129 1156 1274 
35 38 54 67 97 122 130 181 254 255 307 344 373 377 393 408 420 435 492 502 545 546 552 555 556 557 586 647 701 748 756 800 805 825 896 966 1002 1032 1039 1071 1097 1269 1284 
6 34 39 41 102 124 127 139 140 163 165 211 214 215 218 219 230 252 273 292 334 405 453 553 568 593 619 632 727 831 949 977 1131 1143 1150 1238 1250 1266 
42 71 92 173 202 205 232 256 278 314 315 332 378 436 448 496 550 562 590 641 659 662 666 712 732 745 862 864 997 1164 1202 1285 1287 
27 80 180 183 217 227 294 341 379 390 399 409 424 465 495 536 544 620 774 785 792 812 866 1010 1098 1103 1173 1249 1277 
28 98 134 208 209 210 216 234 242 313 333 411 488 569 625 652 671 729 754 789 790 844 967 1096 1102 1105 1115 1288 
5 7 20 22 26 47 49 58 62 199 203 308 309 328 477 537 538 571 600 629 639 686 797 814 983 1017 1147 
114 182 244 245 403 530 541 563 566 609 675 676 771 781 837 911 927 985 1023 1027 1185 1198 1211 1226 1278 
8 9 11 14 15 19 23 25 30 33 37 52 162 772 801 900 951 952 995 1059 1141 1221 1222 1229 
77 79 118 119 129 146 228 229 251 288 347 514 615 728 957 1093 1247 1248 
82 238 280 374 394 427 429 455 497 635 762 817 861 924 1021 1080 1145 1268 
184 206 274 283 302 360 369 385 452 572 820 872 947 948 1035 1070 
29 40 282 371 396 410 535 592 623 691 787 839 923 1067 1072 
105 106 305 324 354 426 515 741 819 916 1008 1037 1051 1052 1168 
176 304 310 382 462 521 549 764 782 788 1000 1082 1233 1240 
170 265 300 388 407 416 753 770 826 876 928 984 1273 
96 156 262 375 398 402 419 565 702 708 804 1166 
56 128 138 141 148 204 326 367 450 909 1124 
86 87 166 200 207 296 476 522 667 780 976 
107 259 260 323 370 386 542 570 834 867 1056 
198 449 457 511 560 581 991 1092 1100 1116 1199 
90 155 263 433 440 467 487 726 840 841 
108 267 268 540 567 802 803 813 847 870 
112 126 717 755 1024 1091 1130 1159 1224 1256 
222 223 261 413 773 885 906 961 962 1119 
83 412 482 483 742 887 1136 1160 1178 
84 85 177 196 311 366 425 954 1230 
225 239 276 331 583 880 897 1187 1197 
4 32 104 201 381 1018 1165 1252 
89 284 441 442 677 678 769 1068 
103 224 809 855 884 901 1026 1176 
189 190 197 286 444 463 908 1263 
213 318 401 547 554 871 1089 1177 
736 763 777 795 915 925 934 1180 
10 285 351 633 668 879 1161 
24 271 576 939 1253 1260 1265 
64 65 66 75 338 1060 1120 
120 121 123 164 523 618 1054 
132 664 665 682 740 1114 1123 
175 257 418 445 660 1153 1183 
191 192 472 704 987 1057 1193 
240 241 327 484 1172 1174 1175 
316 358 359 657 718 766 1257 
543 636 752 799 992 1016 1251 
696 697 935 989 1061 1073 1182 
850 874 881 926 1030 1033 1171 
78 161 353 558 710 830 
91 237 389 940 1064 1108 
246 873 990 1095 1146 1205 
281 470 595 1009 1158 1234 
319 343 856 857 921 946 
12 882 883 978 1200 
16 317 516 533 1192 
53 907 959 1048 1279 
59 501 815 886 1112 
68 512 529 1188 1237 
101 250 277 513 1086 
171 417 519 634 1063 
179 293 364 520 865 
188 690 877 878 1286 
303 395 602 779 838 
329 1012 1216 1245 1272 
451 746 853 1078 1088 
757 806 807 1128 1270 
1 2 528 723 
3 337 507 994 
17 63 397 1212 
43 312 893 1085 
99 339 415 810 
100 683 843 1271 
154 387 1210 1264 
172 498 670 972 
185 478 630 1040 
186 243 266 356 
226 355 499 1280 
301 724 730 988 
320 447 1013 1283 
322 473 693 761 
357 607 608 760 
392 434 564 1132 
400 738 955 1181 
414 720 721 1242 
456 573 651 1214 
469 479 628 981 
591 1223 1231 1232 
627 751 767 1081 
648 650 890 963 
654 674 1204 1254 
733 734 1215 1281 
775 776 784 1011 
778 849 931 1142 
851 875 1113 1125 
888 889 956 1169 
1201 1213 1239 1244 
13 898 899 
21 611 1075 
74 525 1038 
88 212 342 
133 605 655 
135 688 938 
193 672 673 
235 279 585 
247 1058 1099 
249 765 1235 
253 269 705 
264 1053 1194 
298 299 768 
372 811 858 
376 431 1195 
391 1090 1162 
428 430 504 
439 527 829 
443 490 980 
460 548 1062 
461 854 1133 
486 821 1122 
491 936 1118 
505 575 588 
506 601 863 
532 1109 1151 
534 798 1218 
579 1203 1236 
643 644 964 
649 910 968 
669 1020 1208 
695 895 973 
722 1107 1167 
786 891 892 
827 1106 1154 
833 1041 1042 
846 930 1029 
904 905 1117 
914 1028 1157 
993 1083 1104 
1134 1135 1139 
