39 46 53 67 81 86 93 94 109 114 115 124 136 139 140 163 170 174 188 201 203 205 212 213 256 265 278 287 288 311 312 329 330 342 343 346 368 372 376 382 383 388 395 404 430 431 439 452 460 473 487 503 512 524 542 554 560 561 576 577 581 587 591 594 617 626 627 628 630 637 651 653 675 689 698 707 712 723 727 747 749 764 779 786 797 798 805 811 814 816 836 846 852 868 869 871 882 883 884 919 922 924 930 933 942 943 965 968 977 978 983 1001 1005 1006 1012 1015 1019 1020 1028 1046 1047 1048 1054 1066 1077 1089 1095 1155 1156 1175 1176 1185 1189 1195 1199 1200 1208 1223 1225 1231 1232 1245 1272 1273 1286 
42 49 61 62 64 95 135 142 143 151 165 179 208 209 248 268 294 298 299 333 381 384 386 392 411 413 424 449 458 459 464 465 466 467 471 488 495 509 517 533 534 545 551 552 566 567 569 574 578 582 588 600 615 624 625 629 634 638 647 656 666 667 679 680 693 700 709 711 743 753 791 803 818 819 845 851 858 861 862 913 941 951 969 975 987 992 1014 1025 1029 1039 1055 1060 1075 1079 1094 1099 1138 1157 1163 1171 1179 1221 1222 1227 1228 1249 1255 1288 
51 55 56 83 125 138 141 146 155 156 167 175 176 177 193 204 244 245 281 326 348 374 407 483 496 498 518 526 558 599 609 633 658 659 670 672 673 687 696 697 699 702 710 720 752 770 771 775 804 829 830 911 936 985 1004 1007 1011 1023 1037 1073 1115 1166 1209 1241 1243 1251 1278 
5 20 41 57 63 100 133 144 190 234 241 251 262 280 286 308 309 314 334 357 402 419 438 476 497 510 521 550 565 571 590 601 605 635 645 660 708 735 736 763 788 835 842 843 860 864 925 929 934 950 982 1013 1016 1076 1080 1131 1182 1236 1240 1263 1268 1271 1274 1287 
13 96 249 282 284 297 307 398 403 410 417 433 440 462 514 529 535 592 623 632 649 650 683 701 756 765 772 787 789 790 799 802 839 844 847 865 870 874 875 878 891 892 893 908 923 935 946 995 1008 1031 1061 1063 1067 1072 1096 1105 1107 1113 1125 1143 1186 1235 1284 
19 54 66 101 108 153 186 187 243 261 266 325 338 356 370 373 393 427 444 445 447 500 546 562 585 598 604 606 610 612 724 725 730 748 754 758 759 793 794 824 832 890 896 897 907 937 944 945 958 966 997 1002 1026 1030 1085 1086 1111 1116 1211 1258 1259 1276 1283 
7 16 24 27 48 73 78 90 120 126 158 159 192 233 237 264 293 305 349 350 362 389 391 436 446 492 511 539 573 643 644 654 664 677 737 738 742 757 766 806 817 964 967 974 1032 1050 1053 1101 1108 1114 1128 1134 1135 1136 1139 1160 1203 1204 1214 1254 1267 
14 29 59 84 98 121 161 224 242 257 310 316 317 331 371 396 441 442 481 494 516 523 527 596 611 613 646 661 671 718 761 784 894 895 963 973 993 1068 1098 1121 1153 1192 1224 1233 
0 1 2 3 4 10 12 15 18 21 22 23 26 30 33 37 43 44 52 74 147 162 269 285 328 351 469 528 580 636 676 801 900 981 994 1017 1027 1059 1141 1193 1229 
6 76 116 149 150 184 270 271 275 283 302 327 337 347 360 369 375 385 429 479 484 508 531 572 589 642 755 820 906 940 961 962 1035 1049 1064 1093 1159 1164 1184 1266 1282 
72 107 128 214 215 218 230 232 246 377 405 414 453 502 559 593 607 608 746 809 813 825 850 901 926 956 1033 1065 1090 1097 1124 1132 1148 1150 1158 1174 1205 1216 
65 112 130 152 164 171 221 225 231 273 296 428 435 505 618 619 621 685 716 722 800 808 828 831 877 912 960 988 989 1071 1145 1146 1167 1190 1194 1197 
36 92 182 263 267 291 292 363 399 420 463 540 547 555 595 597 616 681 750 751 767 778 849 910 939 976 1009 1022 1081 1226 1285 
17 45 47 50 306 354 355 361 390 412 468 499 501 674 729 744 780 823 833 834 1000 1041 1042 1084 1110 1112 1117 1127 1147 1280 
32 102 105 185 197 247 367 450 475 478 482 530 541 563 652 684 731 745 773 873 887 903 909 927 1102 1119 1198 1250 
38 82 89 97 181 196 223 320 321 332 345 461 485 556 713 714 733 734 777 872 947 952 1038 1057 1133 1218 1230 1281 
8 69 71 154 189 222 228 319 418 455 648 688 739 762 812 856 857 885 921 948 1056 1091 1092 1172 1177 1196 
60 68 75 259 260 304 322 323 365 394 480 570 603 853 854 867 914 955 979 980 986 1078 1088 1126 1188 1237 
25 28 40 127 134 145 191 239 272 276 366 379 387 426 583 732 879 880 902 1021 1161 1187 1210 1264 
34 79 80 103 183 219 339 543 620 622 810 838 841 917 918 959 971 1034 1043 1162 1213 1239 1244 1279 
70 99 254 258 300 301 400 486 662 678 717 769 792 815 821 1010 1024 1058 1122 1129 1130 1181 1262 
35 129 173 178 202 217 220 229 250 255 277 472 728 782 783 795 957 1082 1173 1180 1212 1269 
118 378 380 506 668 669 686 692 703 848 859 863 915 1045 1074 1120 1152 1169 1247 1248 1275 
9 31 415 416 454 614 657 781 807 826 840 876 928 984 1003 1018 1144 1191 1270 
206 274 340 341 358 359 437 525 544 785 1103 1178 1183 1201 1234 1257 1265 
335 336 532 691 694 721 760 827 866 953 970 1087 1106 1154 1165 1242 1252 
58 123 216 252 344 425 456 489 515 665 740 741 822 916 932 954 
168 238 408 409 421 470 491 536 579 774 855 886 1118 1261 1277 
210 211 318 443 451 457 474 477 490 548 575 1206 1207 
11 157 226 640 641 655 776 899 938 1040 1083 1104 
77 88 104 117 119 131 148 160 295 507 768 990 
113 235 236 279 493 568 690 715 920 949 1137 1246 
110 111 303 537 538 584 639 663 1109 1151 1238 
180 199 200 315 364 520 549 706 1149 1253 1260 
91 106 122 448 586 602 719 1051 1052 1202 
137 289 290 432 513 519 695 1036 1044 
227 240 253 353 401 704 705 931 1142 
397 406 434 564 904 905 1070 1168 1215 
169 557 726 898 1069 1140 1170 1217 
194 195 553 631 796 837 996 
198 313 352 881 991 1062 1100 
87 166 207 324 504 522 
132 682 888 889 1123 
85 172 972 1256 
