329 330 446 464 465 480 481 483 488 493 494 503 509 524 526 531 533 542 554 569 570 574 577 578 582 585 586 588 599 602 603 606 612 613 614 616 618 621 622 624 625 626 629 630 637 638 644 651 652 653 661 674 679 680 682 687 689 690 692 693 698 700 703 706 707 711 716 719 722 723 731 739 744 745 747 749 754 759 762 764 773 785 808 816 822 828 832 836 845 846 852 860 861 867 868 869 887 903 905 906 909 916 917 919 922 924 927 932 933 937 950 965 968 972 974 976 977 1001 1002 1012 1015 1017 1022 1024 1028 1037 1039 1055 1056 1065 1066 1080 1106 1109 1138 1145 1164 1189 1192 1204 1210 1241 1246 1272 1288 
0 1 2 3 4 5 6 7 8 9 10 11 12 13 14 15 18 19 21 22 23 25 26 30 33 37 43 47 52 58 59 74 147 162 214 215 230 252 269 284 285 328 351 405 421 453 469 486 487 498 593 633 657 662 666 667 780 800 821 879 880 900 942 943 963 981 983 1053 1059 1111 1112 1129 1134 1135 1139 1141 1147 1161 1193 1209 1229 1239 1245 1251 1266 
34 35 38 39 53 54 71 82 89 92 97 120 121 122 123 181 196 197 218 219 251 259 260 312 322 323 332 377 378 386 393 412 413 436 448 466 467 521 534 550 556 557 567 568 594 615 617 619 660 715 727 831 834 862 949 1007 1038 1040 1054 1078 1083 1088 1104 1117 1157 1158 1178 1181 1196 1198 1203 1230 1285 
84 85 107 108 110 111 127 139 140 179 180 199 253 254 276 277 282 303 306 307 311 314 315 334 357 364 373 420 435 455 456 484 485 492 496 502 520 528 573 576 646 659 683 684 701 732 753 805 809 810 825 829 849 859 890 901 944 945 953 958 1021 1026 1032 1057 1098 1148 1205 1216 1238 1250 1253 1286 1287 
90 91 212 213 226 237 293 300 301 342 343 387 388 389 394 395 532 591 677 678 704 705 717 735 736 763 769 775 776 777 784 788 795 797 798 802 803 812 813 847 848 884 894 895 915 925 930 931 934 973 993 1000 1011 1058 1090 1091 1092 1097 1108 1130 1132 1142 1159 1162 1163 1180 1184 1202 1223 1224 1240 1268 
55 56 83 100 101 128 138 141 144 145 146 154 155 156 167 177 182 193 204 244 245 246 247 262 280 281 326 327 375 376 398 402 403 452 475 476 482 506 530 559 563 565 566 609 699 702 708 752 760 771 786 792 801 804 873 911 914 985 994 1014 1023 1071 1124 1146 1151 1166 1185 1226 1271 1278 
41 42 67 68 72 93 94 109 114 115 129 136 161 170 171 173 178 188 200 201 220 221 228 229 238 239 250 255 304 310 319 325 347 365 372 374 382 383 404 428 512 523 549 587 686 696 697 728 756 833 863 864 871 957 1020 1103 1131 1177 1187 1188 1208 1269 1273 1284 
77 78 88 104 117 118 119 131 148 160 291 292 295 361 368 391 392 397 406 434 468 472 499 500 507 541 564 668 669 681 733 734 748 765 814 815 910 935 936 947 948 961 962 995 996 1008 1009 1070 1075 1084 1115 1128 1137 1144 1215 1221 1235 1247 1248 1249 1280 
48 49 102 103 112 113 125 126 130 163 164 165 172 198 202 203 205 206 232 249 256 265 273 278 287 288 308 309 352 353 460 505 511 560 571 575 590 670 671 721 856 857 921 1114 1149 1168 1169 1231 1232 1242 
263 264 362 363 371 396 410 417 433 440 450 462 471 478 497 514 529 535 539 592 595 623 632 649 650 691 694 726 772 787 799 839 865 881 893 907 908 923 946 1018 1031 1061 1067 1072 1073 1143 1186 
16 17 20 24 27 31 32 36 189 190 286 296 419 444 510 654 724 725 730 755 791 806 807 835 870 951 952 960 966 970 971 982 988 989 1013 1025 1034 1043 1182 1222 1236 1254 1270 
175 176 320 321 345 348 407 415 416 454 558 658 685 710 713 714 770 781 826 830 840 841 872 876 896 897 904 913 918 928 984 1003 1004 1041 1042 1049 1110 1153 1154 1197 1218 1234 1281 
191 192 233 234 313 366 425 426 438 439 445 461 501 580 581 643 648 817 823 853 854 954 967 990 991 1046 1085 1086 1119 1122 1133 1136 1140 1152 1165 1174 1175 1190 1252 1260 1264 1282 
28 29 40 60 61 69 70 73 98 150 151 157 158 159 174 224 225 248 257 258 331 349 350 527 551 712 743 1050 1077 1079 1093 1101 1176 1228 1256 1262 
142 143 168 169 298 299 408 409 430 431 470 491 504 518 536 561 562 579 627 628 768 774 811 855 858 886 997 1010 1076 1118 1195 1199 1211 1261 1274 1277 
62 63 95 134 135 216 217 242 294 333 379 399 411 424 441 442 495 516 789 790 844 866 877 878 1068 1094 1096 1099 1100 1105 1150 1179 1212 1267 
184 185 270 271 274 275 283 302 337 344 346 360 369 380 381 384 385 414 429 447 479 508 572 589 761 820 827 940 941 1035 1063 1064 1126 1237 
44 45 46 50 51 57 76 81 116 137 149 222 223 261 272 297 335 336 418 427 517 597 642 720 885 1036 1062 1107 1127 1172 1173 1263 
208 209 235 236 279 289 290 316 317 358 359 432 449 513 519 600 601 634 645 695 718 766 920 964 1019 1029 1044 1045 1123 1160 1214 1257 
79 80 96 99 183 339 598 604 605 640 641 655 688 737 738 742 891 892 912 938 955 979 980 1121 1243 
186 187 243 266 356 370 824 842 843 850 851 874 875 888 889 926 929 956 1030 1033 1113 1116 1125 
340 341 437 525 543 544 596 620 635 636 675 676 779 838 959 1016 1027 1183 1201 1213 1244 1255 1279 
545 546 552 647 656 672 673 757 758 793 794 898 899 992 1069 1170 1171 1217 1227 1258 1259 1265 1276 
210 211 318 443 451 457 473 474 477 490 548 607 608 746 902 1005 1006 1087 1089 1095 1206 1207 
152 153 231 354 355 390 489 515 610 611 709 729 939 1102 1283 
132 133 227 240 241 367 782 783 1047 1048 1074 1082 1225 1275 
105 106 124 305 458 459 818 819 969 975 1051 1052 1167 
86 87 166 207 324 522 664 665 740 741 1191 1194 
194 195 537 538 553 583 584 631 639 663 796 837 
267 268 400 401 463 540 547 555 
750 751 767 778 986 987 1081 1233 
64 65 66 75 338 1060 1120 
882 883 978 1155 1156 1200 
