36 46 53 67 81 93 94 109 124 136 139 140 163 188 201 212 213 235 236 279 312 329 330 342 343 346 368 372 374 383 395 404 439 441 442 460 473 487 503 512 516 524 542 554 574 577 587 591 594 596 613 617 626 627 630 637 651 653 689 698 707 723 727 747 749 764 779 797 798 814 816 836 846 848 852 868 869 871 882 883 884 915 919 920 930 933 937 942 943 965 968 976 977 978 983 1001 1005 1006 1015 1019 1028 1046 1047 1048 1051 1052 1054 1066 1068 1077 1089 1120 1138 1152 1155 1156 1175 1176 1189 1192 1223 1225 1231 1232 1245 1272 1286 
32 42 49 61 62 95 105 135 142 151 197 241 248 294 298 299 333 381 384 386 387 392 411 413 424 458 464 465 471 475 482 488 495 509 517 533 541 545 551 552 566 569 578 582 588 600 602 622 624 625 629 638 647 652 656 666 667 679 680 687 693 709 711 743 745 753 773 791 810 845 851 858 861 862 887 903 913 917 927 941 971 975 987 992 1014 1025 1029 1034 1039 1043 1055 1079 1094 1102 1119 1157 1162 1163 1171 1179 1198 1210 1221 1227 1228 1249 1255 1264 1288 
54 101 143 153 174 186 187 222 223 243 261 266 325 356 370 373 393 427 444 445 447 459 500 546 562 585 604 606 610 612 724 725 748 754 758 759 786 793 794 811 818 819 824 832 885 890 896 897 907 944 945 958 1002 1026 1030 1085 1086 1111 1116 1211 1258 1259 1276 1283 
38 57 65 82 89 97 115 165 179 181 234 268 314 332 334 357 438 448 461 510 521 550 556 581 590 615 619 659 660 675 700 712 735 736 763 770 777 788 802 803 835 842 843 864 922 925 929 934 936 950 982 1075 1076 1133 1202 1240 1274 1287 
17 45 47 50 51 175 176 306 326 348 354 355 361 382 390 407 412 468 499 501 518 526 599 658 674 696 697 710 720 729 744 780 823 833 834 966 1000 1004 1007 1020 1037 1041 1042 1084 1110 1112 1117 1127 1147 1208 1209 1241 1280 
5 20 39 41 63 79 80 91 100 106 122 130 152 171 183 221 231 296 308 309 339 428 571 586 601 618 621 645 654 719 722 800 808 828 831 841 860 918 952 988 989 1071 1131 1145 1146 1167 1190 1194 1200 1204 1254 1271 
7 16 24 48 73 77 78 85 88 104 112 117 119 120 125 126 131 148 158 164 172 233 273 295 349 350 436 446 492 505 507 511 560 664 671 677 678 717 768 769 817 967 972 974 990 1032 1050 1101 1114 1203 1256 
0 1 2 3 4 10 12 13 15 18 21 22 23 26 30 33 37 43 44 52 74 147 162 178 269 328 453 469 528 580 636 676 801 879 900 981 994 1017 1027 1059 1141 1161 1193 1229 
55 56 83 138 141 146 155 156 167 177 193 204 244 245 247 281 327 376 483 486 496 609 672 673 699 702 731 752 771 804 815 821 829 873 911 985 1023 1115 1122 1129 1166 1243 1278 
96 264 282 398 410 417 433 440 462 497 514 529 535 592 623 632 649 650 772 787 799 839 847 865 870 878 893 908 923 935 946 995 1008 1031 1053 1061 1067 1072 1134 1135 1139 1143 1186 
35 118 129 173 202 217 220 229 250 255 277 288 378 380 472 506 668 669 686 692 703 728 782 783 795 859 863 957 997 1045 1074 1082 1169 1173 1180 1212 1247 1248 1269 1275 
9 31 225 285 351 415 416 454 498 558 614 633 657 670 685 775 781 807 826 830 840 876 912 928 960 984 1003 1011 1018 1073 1144 1191 1197 1270 
58 116 123 149 196 198 275 313 344 352 456 484 485 489 531 642 684 755 822 881 906 932 961 962 991 1049 1057 1062 1100 1159 1164 1199 1230 
27 90 159 182 237 263 293 305 362 389 391 539 573 595 643 644 737 738 742 757 766 806 964 1108 1128 1136 1160 1214 1226 1267 
34 103 206 219 274 340 341 358 359 437 525 543 544 620 785 838 959 1103 1178 1183 1201 1213 1234 1239 1244 1257 1265 1279 
160 218 230 246 291 292 363 420 466 576 597 616 681 750 751 767 778 849 901 910 939 969 1009 1022 1081 1205 1216 1260 
60 68 75 259 260 304 322 323 365 394 480 570 603 853 854 867 914 955 979 980 986 1012 1078 1088 1126 1188 1237 
25 28 29 40 98 127 134 145 191 192 224 239 257 272 276 331 366 379 426 583 732 880 902 1021 1187 
114 170 203 205 216 252 256 265 278 287 300 301 311 388 425 452 515 561 916 924 954 1091 1095 1185 1273 
6 8 71 76 150 154 347 375 418 429 455 688 739 762 940 948 1056 1063 1064 1092 1093 1184 1196 1266 
133 144 190 240 251 262 280 286 402 419 476 530 563 565 605 635 708 1013 1016 1080 1182 1236 1263 1268 
107 128 367 414 450 502 559 607 608 746 809 813 825 850 909 926 1033 1090 1097 1124 1132 1148 1158 
249 284 297 307 403 683 756 765 789 790 844 874 875 891 892 1096 1105 1107 1113 1125 1235 1284 
121 242 310 371 396 481 523 527 611 661 761 784 894 895 963 973 993 1098 1121 1224 1233 
72 92 232 267 377 399 435 463 540 547 555 716 877 956 1065 1150 1174 1285 
14 59 84 102 161 185 316 317 478 494 646 718 827 1106 1153 1154 1250 
184 270 271 283 302 337 360 369 385 479 508 572 589 628 820 1035 1282 
70 99 254 258 400 532 662 760 792 866 1010 1024 1058 1130 1181 1262 
168 238 408 409 421 470 491 536 579 774 855 886 1118 1251 1261 1277 
11 157 226 640 641 655 776 898 899 938 1040 1083 1104 
210 211 318 443 451 457 474 477 490 548 575 1206 1207 
69 189 228 319 648 730 812 856 857 921 1172 1177 
320 321 345 713 714 733 734 872 947 1038 1218 1281 
335 336 691 694 721 805 953 970 1087 1165 1242 1252 
110 111 303 537 538 584 639 663 1109 1151 1238 
208 209 214 215 405 449 593 634 951 1099 1222 
86 87 166 207 324 430 431 504 522 1195 
169 467 534 557 567 726 1069 1140 1170 1217 
180 199 200 315 364 520 549 706 1149 1253 
113 493 568 690 701 715 949 1137 1246 
137 289 290 432 513 519 695 1036 1044 
397 406 434 564 904 905 1070 1168 1215 
132 665 682 740 741 888 889 1123 
227 253 353 401 704 705 931 1142 
19 64 66 108 338 598 1060 
194 195 553 631 796 837 996 
