32 42 49 59 61 62 95 101 105 134 135 142 143 151 188 197 208 209 241 247 248 294 329 330 333 370 373 381 384 386 387 392 393 404 411 413 424 427 447 449 458 464 465 471 475 482 488 494 495 500 503 509 517 533 541 545 551 552 562 566 569 574 578 582 588 600 602 604 606 612 624 625 626 628 629 634 638 647 652 656 666 667 679 680 687 693 711 724 725 731 743 745 747 753 754 759 773 791 811 816 832 845 846 858 861 862 868 869 873 887 890 896 897 903 913 919 927 937 941 965 966 968 977 992 1001 1014 1015 1022 1025 1026 1028 1029 1039 1055 1079 1085 1086 1094 1099 1102 1119 1138 1157 1171 1189 1198 1210 1211 1221 1227 1228 1245 1249 1255 1264 1272 1283 1286 1288 
38 39 46 53 82 89 93 97 102 115 124 139 140 163 212 213 268 312 342 343 368 395 439 441 442 459 460 473 478 487 516 542 554 556 576 577 581 591 594 596 613 617 630 637 645 653 675 689 698 700 707 712 723 727 764 779 797 798 802 803 805 814 836 852 871 882 883 884 922 930 933 975 978 983 1005 1006 1012 1019 1040 1046 1047 1048 1054 1066 1068 1075 1077 1083 1089 1153 1155 1156 1175 1176 1192 1223 1225 1231 1232 1250 
7 16 24 27 48 73 77 78 88 90 104 117 119 120 126 131 148 158 159 233 237 293 295 298 299 305 349 350 362 389 391 436 446 492 507 511 539 573 643 644 664 677 737 738 757 766 768 806 817 964 967 974 990 1021 1032 1050 1051 1052 1101 1108 1114 1128 1203 1214 1236 1256 1267 
55 56 83 128 138 141 146 155 156 167 177 186 187 193 204 218 230 243 244 245 246 266 281 327 356 367 376 402 403 450 452 466 483 530 563 565 609 672 673 699 702 742 752 771 804 809 818 819 829 901 909 911 939 969 985 1023 1124 1136 1158 1160 1166 1205 1216 1278 
5 20 41 63 65 130 152 153 171 174 221 225 231 261 296 308 309 325 428 546 571 585 610 618 619 621 654 685 722 758 786 793 794 800 808 828 831 912 951 960 988 989 1002 1071 1111 1112 1116 1131 1145 1146 1163 1167 1179 1182 1190 1194 1197 1204 1222 1254 1258 1259 1276 
0 1 2 3 4 10 12 13 15 18 21 22 23 26 30 33 37 43 44 52 74 147 162 178 214 215 269 328 351 405 453 469 498 528 580 593 633 636 676 801 879 900 981 994 1017 1027 1059 1141 1161 1200 1229 
29 81 98 121 196 224 242 257 310 311 331 371 372 396 481 485 512 523 524 527 561 611 627 651 661 709 749 750 751 761 767 778 784 894 895 942 943 963 973 993 1057 1081 1098 1121 1224 1230 1233 
116 149 184 185 198 222 223 270 271 274 275 283 302 313 337 346 352 360 369 380 385 479 484 508 531 560 572 597 642 684 820 881 885 906 961 962 991 1035 1049 1062 1100 1159 1164 1199 1282 
264 282 398 410 417 433 440 462 514 529 535 592 623 632 649 650 772 787 799 839 847 865 870 878 893 907 908 923 935 946 995 1008 1031 1053 1061 1067 1072 1134 1135 1139 1143 1186 
57 91 106 122 234 285 314 332 334 357 438 448 506 510 521 550 586 590 601 660 668 669 686 719 735 736 748 763 788 843 860 863 864 925 934 950 982 1076 1240 1274 1287 
25 28 40 58 114 123 127 145 170 191 192 203 216 239 252 272 276 344 366 379 425 426 456 489 515 583 732 822 880 902 916 924 932 954 1091 1095 1185 1187 1193 1273 
70 99 112 125 164 172 205 254 256 258 265 273 278 287 300 301 400 486 505 532 662 671 678 717 755 760 769 792 821 835 866 1010 1024 1058 1122 1129 1130 1181 1262 
17 45 47 50 306 354 355 361 382 390 412 468 496 499 501 674 729 744 780 815 823 833 834 1000 1020 1037 1041 1042 1084 1110 1115 1117 1127 1147 1178 1208 1280 
6 8 69 71 76 150 154 228 319 347 375 418 429 455 648 688 739 762 812 856 857 921 940 948 1056 1063 1064 1092 1093 1140 1172 1177 1184 1196 1266 
35 118 129 173 202 217 220 229 250 255 277 288 378 472 692 703 728 782 783 795 859 957 997 1045 1074 1082 1169 1173 1180 1212 1247 1248 1269 1275 
72 92 107 232 267 377 399 414 435 463 540 547 555 559 607 608 716 813 850 851 874 875 877 926 1030 1033 1065 1113 1125 1132 1148 1150 1174 1285 
34 103 206 219 340 341 358 359 437 525 543 544 620 622 785 810 824 838 917 959 971 1034 1043 1103 1162 1183 1201 1213 1234 1244 1257 1265 1279 
60 68 75 259 260 304 316 317 322 323 365 388 394 480 570 589 603 718 746 853 854 867 914 955 979 980 986 987 1078 1088 1126 1188 1237 
9 31 415 416 454 558 614 657 670 775 781 807 826 830 840 876 928 984 1003 1011 1018 1073 1144 1191 1270 
14 67 84 94 109 136 161 200 201 235 236 279 315 374 383 549 587 646 706 848 915 920 1149 1152 
51 175 176 326 348 407 518 526 599 658 659 696 697 710 720 733 734 770 936 1004 1007 1209 1241 1281 
133 144 189 190 240 251 262 280 286 419 476 497 605 635 708 730 1013 1016 1080 1263 1268 
181 249 297 307 420 461 502 683 701 756 765 777 825 952 1090 1097 1107 1133 1202 1235 1284 
79 80 96 183 320 321 339 345 713 714 841 872 918 947 1038 1218 
168 238 408 409 421 470 491 536 579 774 855 886 1118 1251 1261 1277 
36 160 182 263 291 292 363 595 616 681 849 910 976 1009 1226 
54 165 169 179 444 445 467 534 557 567 615 726 1069 1170 1217 
180 199 364 397 406 434 520 564 904 905 1070 1168 1215 1253 1260 
335 336 691 694 721 827 953 970 1087 1106 1154 1165 1242 1252 
210 211 318 443 451 457 474 477 490 548 575 1206 1207 
11 157 226 640 641 655 776 898 899 938 1239 
110 111 303 537 538 584 639 663 1109 1151 1238 
86 87 166 207 324 430 431 504 522 1195 
100 113 493 568 690 715 949 1137 1246 1271 
19 64 66 108 338 598 891 892 1243 
132 665 682 740 741 888 889 956 1123 
137 289 290 432 513 519 695 1036 1044 
227 253 353 401 704 705 931 1142 
194 195 553 631 796 837 996 
284 789 790 844 1096 1105 
842 929 958 
1060 1104 1120 
