64 65 66 75 111 194 195 216 217 242 329 330 349 350 379 399 424 446 464 465 480 481 483 488 493 494 503 509 524 526 531 533 542 553 554 569 570 574 577 578 582 585 586 588 599 602 603 606 612 613 614 616 618 621 622 624 625 626 629 630 637 638 644 651 652 653 661 674 679 680 682 687 689 690 692 693 698 700 703 706 707 711 716 719 722 723 731 739 744 745 747 749 754 759 762 764 773 785 808 816 822 828 832 836 845 846 852 860 861 866 867 868 869 887 903 905 906 909 916 917 919 922 924 927 932 933 937 950 965 968 972 974 976 977 983 1001 1002 1012 1015 1017 1022 1024 1028 1037 1039 1055 1056 1065 1066 1080 1100 1106 1109 1138 1145 1164 1189 1192 1204 1210 1241 1246 1267 1272 1288 
55 56 83 100 101 128 138 141 144 145 146 154 155 156 167 177 182 193 204 244 245 246 247 262 280 281 326 327 375 376 398 402 403 452 475 476 482 506 530 559 563 565 566 609 699 702 708 752 760 771 786 792 801 804 873 911 914 985 994 1014 1023 1071 1124 1146 1151 1166 1185 1226 1271 1278 
263 264 362 363 371 396 410 417 433 440 450 462 471 478 497 514 529 535 539 592 595 623 632 649 650 691 694 726 772 787 799 839 865 881 893 908 923 946 1018 1031 1061 1067 1072 1073 1143 1186 1247 1248 
0 1 2 3 4 5 6 7 8 9 10 11 12 13 14 15 18 19 21 22 23 25 26 30 37 43 47 52 58 59 74 147 162 328 469 487 900 981 1053 1147 1193 1209 1229 1239 1245 1266 
34 35 38 39 53 54 71 82 89 92 97 120 122 181 218 219 332 393 556 594 617 619 715 727 831 926 949 1007 1038 1040 1054 1078 1088 1157 1158 1196 1198 1200 1285 
41 42 72 114 115 129 171 173 178 220 228 229 238 239 250 255 319 347 365 428 513 686 728 756 863 864 871 957 1103 1131 1177 1269 1284 
184 185 270 271 274 275 283 302 337 338 344 346 360 369 380 381 384 385 414 429 447 479 508 572 589 761 820 827 1035 1237 
67 68 93 94 109 136 161 170 188 200 201 221 304 310 325 372 374 382 383 404 512 523 549 587 1020 1188 1208 1273 
44 45 46 50 51 57 76 81 137 149 272 297 318 335 336 517 642 720 774 796 1062 1107 1127 1277 
139 140 314 334 357 435 496 528 571 576 659 732 805 825 829 849 856 953 973 1183 1238 1250 1286 1287 
300 343 677 678 717 769 789 790 802 803 812 813 844 847 931 1091 1092 1096 1130 1132 1142 1159 1184 1224 
233 234 313 438 439 461 501 580 581 648 823 886 1085 1086 1119 1122 1133 1136 1140 1152 1264 
102 103 112 113 126 130 164 165 211 249 273 505 670 671 721 1036 1114 1149 1242 
28 29 40 98 224 225 257 258 331 527 551 743 1050 1077 1101 1176 1228 1262 
60 61 69 70 73 150 151 157 158 159 174 248 712 857 921 987 1079 1155 
85 107 108 127 253 254 276 277 282 311 455 456 573 646 993 1021 1148 1205 
320 415 416 454 558 685 770 781 826 830 837 840 876 897 928 984 1110 1197 
77 78 88 104 117 118 119 131 148 160 295 499 500 507 541 1009 1280 
48 49 125 163 172 198 265 352 353 460 511 560 575 1168 
62 63 95 134 135 210 294 333 411 607 1094 1099 1179 1212 
306 307 373 420 492 502 683 701 859 875 1032 1170 1233 
408 409 430 431 470 491 536 579 1010 1076 1118 1195 1274 
457 643 663 967 990 991 1046 1165 1174 1175 1180 1252 1282 
354 355 390 515 611 709 729 851 939 1102 1125 1283 
545 546 552 647 656 793 794 992 1217 1258 1259 1276 
121 123 259 260 312 322 323 386 940 941 1126 
214 215 230 252 269 405 421 453 593 800 1251 
235 443 600 601 645 695 1019 1029 1045 1123 1160 
301 388 775 776 784 894 895 904 1011 1058 1162 
377 378 436 448 521 550 660 862 1181 1203 1230 
735 736 763 777 788 795 915 925 934 1240 1268 
16 17 20 24 27 36 296 966 1013 1025 
33 486 657 662 821 942 943 1059 1129 1141 
116 222 223 261 418 427 597 885 1187 1263 
186 187 243 266 356 370 824 842 1030 1116 
202 203 205 206 232 256 278 287 288 590 
208 209 289 290 308 309 432 449 519 634 
291 292 361 368 468 681 765 910 1115 1235 
321 345 841 872 918 980 1041 1042 1049 1218 
391 392 397 406 434 472 564 1075 1137 1221 
79 80 96 99 183 339 598 912 1084 
105 106 124 305 425 426 954 1051 1052 
143 561 562 664 811 997 1194 1199 1211 
175 176 348 407 658 710 913 1202 1281 
537 538 639 814 815 935 936 1128 1144 
543 544 596 620 779 838 959 1255 1279 
86 87 166 207 324 504 522 1191 
90 91 226 237 293 389 1108 1163 
316 317 477 1005 1006 1087 1089 1095 
809 810 890 901 958 1026 1098 1216 
31 32 806 807 870 982 1270 
152 153 231 489 610 724 725 
179 180 199 315 364 520 1253 
189 190 286 419 444 730 1236 
458 459 818 819 969 975 1167 
604 605 640 641 655 688 938 
635 636 675 676 783 1016 1027 
951 952 960 988 989 1182 1222 
132 133 227 240 241 367 
142 168 169 518 855 1261 
212 213 342 395 591 1223 
236 279 766 920 964 1214 
466 467 534 557 567 615 
510 654 755 791 835 1254 
733 734 995 996 1215 1249 
737 738 742 955 979 1121 
750 751 767 778 986 1081 
797 798 848 884 1060 1120 
843 888 889 929 956 1169 
84 484 485 684 1057 
284 285 351 498 633 
340 341 437 525 697 
412 413 568 834 1178 
473 474 548 902 1048 
191 192 366 445 
358 359 718 1257 
387 394 532 705 
400 401 463 547 
441 442 516 1068 
451 490 608 746 
668 669 748 1008 
672 673 1171 1265 
713 714 1090 1097 
850 874 1033 1113 
880 961 962 963 
882 883 978 1156 
930 1000 1093 1256 
970 971 1034 1043 
110 303 753 
196 197 251 
268 540 555 
298 299 768 
583 584 631 
627 628 858 
666 667 780 
704 896 1234 
757 758 1227 
782 1074 1275 
817 1190 1260 
879 1117 1161 
891 892 1243 
898 899 1069 
947 948 1070 
1044 1063 1064 
1047 1082 1225 
1134 1135 1139 
1201 1213 1244 
