39 53 81 124 139 140 163 312 383 460 473 487 524 542 554 560 576 577 617 626 630 698 723 727 747 749 764 805 816 836 868 869 871 919 933 942 943 965 968 977 983 1001 1015 1019 1028 1046 1047 1048 1175 1189 1200 1225 
62 64 135 248 268 294 333 384 386 411 424 458 464 465 488 517 551 569 578 582 588 624 666 667 679 680 700 743 803 818 858 862 913 1014 1060 1075 1138 1163 1228 1249 1288 
55 56 83 138 141 146 156 167 176 177 204 244 245 281 326 483 609 687 699 752 771 804 911 985 1004 1007 1023 1251 1278 
282 410 417 433 440 514 529 535 592 623 632 649 650 772 787 799 839 865 893 908 923 946 1008 1031 1061 1063 1067 1072 1143 
46 67 93 94 109 136 201 368 382 395 404 587 653 707 779 846 852 882 883 930 978 1012 1020 1077 1155 1156 1208 
101 373 393 427 447 500 604 606 612 724 725 730 748 759 832 896 897 966 1085 1086 1211 1283 
61 151 381 413 471 545 552 566 647 656 711 845 861 987 992 1039 1079 1157 1171 1227 1255 
5 20 41 63 100 144 190 262 286 402 419 565 571 601 645 708 1131 1236 1263 1271 
0 1 4 10 12 21 22 26 43 74 147 269 285 351 469 981 1017 1193 
65 130 152 164 171 221 231 296 618 619 621 722 808 828 831 1145 1190 1194 
120 158 192 233 349 350 446 492 677 757 806 817 967 1032 1050 1101 1128 
153 261 325 546 585 610 758 793 794 907 1002 1111 1116 1258 1259 1276 
184 270 271 283 302 337 360 369 385 479 508 572 589 820 1035 1282 
118 378 380 668 692 848 859 915 1045 1074 1120 1152 1247 1248 1275 
168 238 408 409 421 470 491 536 579 774 855 886 1118 1261 1277 
186 187 243 266 356 370 562 754 824 890 937 958 997 1026 1030 
334 357 521 590 660 736 763 788 842 843 864 925 929 934 1240 
543 620 622 810 838 917 959 971 1034 1043 1162 1213 1239 1244 1279 
42 142 143 208 298 299 466 509 629 693 791 969 1025 1029 
102 185 197 367 450 475 478 652 684 745 909 1102 1198 1250 
6 76 150 327 347 375 429 484 940 1064 1093 1184 1266 
13 249 297 307 683 701 756 765 891 892 1107 1235 1284 
18 23 30 33 37 52 162 580 801 900 1059 1141 1229 
35 129 173 178 202 220 229 250 255 277 728 957 1269 
17 45 50 354 499 674 744 834 1000 1127 1280 
51 125 518 526 599 696 697 720 1209 1241 1243 
86 114 170 203 265 388 452 924 1095 1185 1273 
210 211 318 443 451 457 474 477 490 548 575 
214 215 218 230 246 405 453 593 901 1205 1216 
11 157 226 640 641 655 938 1040 1083 1104 
27 90 264 362 391 539 654 1053 1204 1254 
28 40 127 145 191 272 276 366 902 1021 
70 678 717 769 792 1010 1024 1058 1130 
8 222 418 739 885 1091 1092 1196 
29 98 224 242 257 331 527 671 
47 306 361 823 833 1041 1042 1147 
60 304 394 853 854 914 1078 1088 
77 88 119 131 148 160 295 507 
92 267 399 463 540 547 555 1285 
116 149 275 531 642 755 1049 1164 
134 239 379 583 732 879 880 1161 
256 288 797 798 814 884 922 1176 
335 336 691 694 721 970 1087 1242 
376 430 431 594 637 1054 1066 1195 
412 468 501 780 1084 1110 1112 1117 
761 784 894 895 973 993 1098 1224 
58 123 344 456 489 822 932 
159 643 644 742 964 1136 1160 
194 195 553 631 796 837 996 
196 485 872 947 1038 1057 1230 
212 342 343 591 1223 1231 1232 
251 280 497 635 1016 1080 1268 
289 290 432 513 519 695 1044 
310 371 481 611 963 1121 1233 
314 438 510 735 835 982 1287 
340 341 437 525 1178 1183 1201 
392 495 600 625 638 753 1221 
482 530 541 563 887 903 927 
496 498 633 670 830 1037 1115 
25 387 426 1187 1210 1264 
38 82 89 97 332 556 
59 316 317 494 718 1153 
71 455 688 762 948 1056 
72 377 559 956 1065 1148 
79 80 183 339 841 918 
107 813 850 926 1033 1132 
128 414 607 809 1124 1158 
180 199 364 520 1253 1260 
206 274 544 1103 1234 1265 
209 449 634 951 1099 1222 
216 252 425 515 916 954 
284 789 790 844 1096 1105 
406 904 905 1070 1168 1215 
415 416 781 876 928 984 
726 898 1069 1140 1170 1217 
7 126 436 974 1203 
19 66 108 338 598 
31 454 807 1018 1270 
68 260 480 1188 1237 
91 106 122 586 719 
113 690 715 1137 1246 
132 682 888 889 1123 
175 348 407 658 710 
181 461 777 952 1133 
188 372 512 651 1286 
189 228 856 857 921 
198 352 991 1062 1100 
217 472 795 1180 1212 
225 685 912 960 1197 
227 240 401 704 705 
258 400 662 1181 1262 
291 292 849 910 1009 
320 321 345 713 714 
329 330 503 1245 1272 
363 420 616 939 1022 
403 874 875 1113 1125 
486 815 821 1122 1129 
533 709 851 941 1179 
537 538 584 639 663 
750 751 767 778 1081 
800 988 989 1071 1146 
14 84 161 646 
32 105 773 1119 
75 259 322 867 
85 172 972 1256 
121 396 523 661 
154 648 812 1172 
155 702 829 1166 
166 207 324 522 
182 263 595 1226 
235 236 279 920 
237 293 389 1108 
253 353 931 1142 
305 573 766 1214 
323 603 986 1126 
328 636 676 1027 
346 627 628 811 
358 359 785 1257 
374 659 770 936 
462 802 847 870 
502 825 1090 1097 
506 669 686 863 
516 596 613 1192 
558 775 1011 1073 
782 783 1082 1173 
906 961 962 1159 
9 826 1144 
16 24 511 
34 103 219 
48 73 78 
49 95 574 
54 444 445 
57 1076 1274 
69 319 1177 
96 398 995 
110 1109 1151 
111 303 1238 
112 273 505 
165 179 615 
193 672 673 
200 549 706 
205 278 287 
232 1150 1174 
234 550 950 
247 731 873 
311 561 1199 
355 390 729 
397 434 564 
435 716 877 
441 442 1068 
448 602 1202 
459 819 975 
467 534 567 
476 1013 1182 
493 568 949 
532 760 866 
581 712 1089 
665 740 741 
689 1005 1006 
733 734 1281 
737 738 1267 
827 1106 1154 
840 1003 1191 
878 935 1186 
953 1165 1252 
955 979 980 
1134 1135 1139 
