61 62 134 135 151 208 209 241 294 333 384 386 392 411 424 449 464 465 488 495 517 551 566 569 582 588 602 624 625 629 634 638 679 687 743 845 858 862 913 937 987 1014 1015 1079 1099 1138 1157 1221 1228 1249 1288 
53 81 124 139 163 312 368 505 524 542 577 594 617 626 630 653 709 747 749 764 816 836 846 851 852 868 869 871 932 933 942 943 965 968 977 983 1001 1012 1028 1047 1048 1054 1066 1077 1189 1225 
35 67 94 109 118 129 136 173 188 202 220 229 250 255 277 288 372 374 378 382 404 512 587 627 651 661 728 957 997 1020 1208 1247 1248 1269 1286 
101 329 330 373 393 427 447 500 503 562 604 606 612 628 748 759 811 832 896 897 919 966 1085 1086 1211 1245 1272 1283 
282 410 417 433 440 514 529 535 592 623 632 649 650 772 787 799 839 865 893 908 923 946 1008 1031 1061 1067 1072 1143 
55 56 83 138 141 146 155 156 177 204 245 327 376 609 699 702 752 771 804 829 873 911 985 1023 1166 
39 122 152 171 221 231 428 586 618 654 722 808 828 831 860 861 1145 1167 1190 1200 1204 1254 
0 1 4 10 12 13 21 22 23 26 37 74 147 269 453 469 981 1193 1229 
206 340 341 437 525 543 544 824 838 959 1103 1183 1201 1213 1234 1239 1244 1265 1279 
153 261 325 546 585 610 724 725 758 793 794 907 1002 1111 1116 1258 1259 1276 
184 185 270 271 274 283 302 337 346 360 369 385 479 508 572 820 1035 1282 
332 334 357 448 521 590 660 736 763 788 842 843 864 925 929 934 1202 1240 
28 29 40 98 127 145 191 192 224 257 272 276 331 366 902 1021 
120 158 233 349 350 446 492 664 677 817 967 1032 1050 1101 1114 
159 305 573 643 644 742 757 766 806 964 1128 1136 1160 1214 
168 238 408 409 470 491 536 579 774 855 886 1118 1261 1277 
42 47 142 143 298 299 509 600 693 791 1025 1029 1147 
51 176 326 518 526 599 696 697 720 1004 1007 1209 1241 
144 189 190 262 286 402 419 530 563 565 708 1236 1263 
6 76 150 347 375 429 940 1063 1064 1093 1184 1266 
187 218 230 246 466 818 901 939 969 1030 1205 1216 
197 248 475 482 541 652 745 887 903 927 1102 1198 
18 30 33 52 162 178 580 801 900 1059 1141 
5 20 41 63 100 571 601 645 1131 1271 
17 45 50 499 674 744 834 1000 1127 1280 
60 304 388 394 746 853 854 914 1078 1088 
210 211 318 443 451 457 477 490 548 575 
471 545 552 647 656 992 1039 1171 1227 1255 
25 216 252 425 426 515 916 954 1187 
46 93 707 882 883 930 978 1155 1156 
68 260 316 317 480 589 718 1188 1237 
114 170 203 637 924 1091 1095 1185 1273 
116 149 275 484 531 642 684 1049 1164 
186 243 266 356 370 754 890 958 1026 
320 321 345 713 714 733 734 1218 1281 
412 468 501 780 1084 1110 1112 1117 1178 
441 442 459 516 596 613 819 1068 1192 
730 800 951 988 989 1071 1146 1182 1222 
92 267 399 463 540 547 555 1285 
297 307 683 698 727 756 1107 1284 
335 336 691 694 721 970 1087 1242 
620 622 810 917 971 1034 1043 1162 
761 784 894 895 973 993 1098 1224 
11 157 226 640 641 655 938 
36 387 723 976 1019 1210 1264 
125 164 205 256 273 278 287 
160 291 292 681 849 910 1009 
194 195 553 631 796 837 996 
198 352 560 991 1062 1100 1199 
212 342 343 591 1223 1231 1232 
251 280 497 635 1016 1080 1268 
289 290 432 513 519 695 1044 
310 371 481 611 963 1121 1233 
314 438 510 735 835 982 1287 
323 603 955 979 980 986 1126 
328 636 676 783 879 1027 1161 
380 668 692 859 1045 1074 1275 
7 126 436 974 1203 1256 
8 154 418 739 1092 1196 
14 59 84 161 494 646 
58 123 344 456 489 822 
70 792 1010 1024 1058 1130 
71 455 688 762 948 1056 
79 80 183 339 841 918 
107 813 850 926 1033 1132 
112 265 452 678 717 769 
128 367 450 809 909 1124 
140 473 474 487 1046 1175 
228 812 856 857 921 1172 
306 361 823 833 1041 1042 
406 904 905 1070 1168 1215 
415 416 781 876 928 984 
458 578 666 667 680 975 
797 798 814 884 922 1176 
27 90 362 391 539 
31 454 807 1018 1270 
38 82 89 97 556 
48 73 78 131 295 
49 95 533 574 941 
65 619 659 770 936 
77 88 119 148 507 
86 166 207 324 522 
113 690 715 1137 1246 
132 682 888 889 1123 
167 244 281 483 1278 
175 348 407 658 710 
180 199 364 520 1253 
181 461 777 952 1133 
217 472 795 1180 1212 
225 685 912 960 1197 
239 379 583 732 880 
258 400 662 1181 1262 
268 700 802 803 1075 
284 285 351 498 633 
403 874 875 1113 1125 
537 538 584 639 663 
750 751 767 778 1081 
789 790 844 1096 1105 
32 105 773 1119 
72 435 716 877 
75 259 322 867 
85 172 755 972 
102 478 1153 1250 
130 296 621 1194 
182 263 595 1226 
196 485 1057 1230 
213 395 439 779 
214 215 405 593 
222 223 597 885 
227 401 704 705 
237 293 389 1108 
253 353 931 1142 
354 670 830 1037 
358 359 785 1257 
363 420 616 1022 
381 413 711 753 
383 848 915 1152 
414 607 608 1158 
486 821 1122 1129 
493 568 701 949 
506 669 686 863 
558 775 1011 1073 
726 1069 1170 1217 
805 953 1165 1252 
906 961 962 1159 
9 826 1144 
16 24 511 
19 108 598 
34 103 219 
54 444 445 
57 1076 1274 
64 66 338 
69 319 1177 
91 106 719 
96 398 995 
110 1109 1151 
111 303 1238 
121 396 523 
133 240 605 
165 179 615 
193 672 673 
200 549 706 
232 1150 1174 
234 550 950 
236 279 920 
242 527 671 
249 765 1235 
355 390 729 
377 956 1065 
397 434 564 
430 431 1195 
460 554 1089 
462 847 870 
467 534 567 
496 815 1115 
532 760 866 
665 740 741 
689 1005 1006 
737 738 1267 
776 898 899 
782 1082 1173 
827 1106 1154 
840 1003 1191 
872 947 1038 
878 935 1186 
891 892 1243 
1060 1104 1120 
1134 1135 1139 
