6 34 35 38 39 41 42 54 67 71 92 97 102 122 127 129 130 139 140 163 165 173 181 194 211 212 218 219 230 253 254 255 269 273 292 306 307 314 315 332 334 344 357 361 365 373 377 378 393 395 408 420 435 436 439 448 492 496 502 506 520 527 528 545 546 550 552 553 555 556 557 562 568 586 590 591 601 607 608 619 632 641 647 659 662 666 681 701 705 712 728 732 745 748 756 757 760 800 805 806 807 825 829 831 844 859 862 863 864 888 889 896 944 945 949 952 956 957 964 966 977 979 1002 1032 1039 1041 1042 1045 1071 1097 1105 1128 1131 1143 1150 1164 1202 1223 1231 1238 1250 1266 1269 1270 1284 1285 1287 
0 36 60 61 69 70 73 83 109 110 111 117 131 144 150 151 157 158 159 160 174 195 214 215 248 252 295 325 345 346 348 349 350 352 363 376 380 404 412 421 431 446 453 454 458 464 468 475 480 481 482 483 485 500 526 531 537 551 561 577 578 593 594 603 621 622 624 626 637 638 653 658 661 684 687 692 693 698 703 707 711 713 714 725 731 742 743 744 747 783 790 791 797 822 835 860 869 913 919 922 937 942 943 974 1001 1019 1022 1043 1047 1066 1074 1076 1077 1079 1084 1096 1102 1110 1123 1129 1136 1155 1156 1160 1178 1186 1195 1196 1211 1225 1228 1241 1258 1259 1274 1275 1276 
44 45 46 50 51 57 76 81 93 94 107 116 128 137 142 143 149 167 168 169 213 222 223 247 258 260 261 272 275 297 298 299 318 321 323 336 362 370 386 400 401 413 456 466 486 493 494 503 509 517 518 542 547 554 570 573 574 582 597 598 599 604 606 612 614 616 642 646 651 652 664 665 679 680 682 694 706 709 719 737 740 749 768 773 785 796 816 823 832 834 868 885 902 903 906 918 950 961 962 965 969 970 971 1004 1007 1012 1015 1034 1036 1049 1056 1058 1069 1089 1099 1114 1119 1124 1127 1138 1167 1170 1184 1189 1214 1217 1243 1261 1262 
72 82 91 113 115 120 121 123 134 152 153 164 208 209 221 231 236 237 238 249 280 291 330 368 383 384 389 394 427 429 459 488 489 497 505 515 523 524 575 588 596 613 617 618 625 635 643 644 656 685 689 699 700 715 716 727 729 739 754 759 762 765 793 794 808 817 828 836 845 848 852 861 867 887 894 917 920 924 932 933 940 941 975 1005 1006 1021 1044 1050 1054 1055 1064 1065 1080 1094 1101 1108 1109 1126 1137 1145 1149 1152 1190 1235 1246 1268 
4 8 9 11 13 14 15 18 19 23 25 30 31 32 33 37 52 53 104 162 189 190 197 201 235 270 279 286 381 444 463 510 585 772 801 898 899 900 907 908 914 951 959 982 995 996 1018 1028 1048 1059 1087 1140 1141 1157 1165 1221 1222 1229 1252 1263 1279 1282 
68 77 78 88 112 119 161 170 186 198 202 206 243 265 266 274 300 342 353 356 388 405 407 416 449 452 457 511 512 529 558 560 581 710 717 733 734 753 770 781 826 830 833 872 876 904 928 984 991 997 1092 1100 1116 1188 1199 1215 1218 1232 1237 1273 1281 
5 7 10 12 20 21 22 26 47 49 58 62 79 118 146 199 203 228 229 251 288 308 309 322 328 347 473 477 514 538 571 600 611 615 629 639 645 663 686 722 761 814 882 883 905 978 983 1017 1024 1046 1075 1093 1107 1117 1121 1147 1200 1247 1248 
56 96 101 133 138 141 145 155 156 182 193 204 244 245 250 262 277 289 290 339 375 398 402 419 432 513 530 539 541 563 565 605 609 672 673 702 708 804 837 840 841 873 911 927 1023 1086 1146 1166 1226 1278 
125 126 135 154 172 205 232 256 278 319 343 374 387 391 455 498 532 534 640 655 670 688 738 755 798 849 856 857 921 938 946 955 972 1090 1091 1142 1151 1159 1162 1169 1181 1209 1210 1224 1256 1264 
27 28 98 183 210 216 217 227 233 234 242 294 313 333 379 390 399 406 409 411 424 465 495 536 544 671 774 789 792 812 866 967 1010 1098 1103 1111 1115 1144 1173 1212 1249 1277 
24 48 95 105 106 124 187 271 305 324 354 355 426 461 576 741 818 819 846 854 916 930 931 939 1003 1008 1029 1037 1051 1052 1133 1168 1191 1253 1260 1265 
1 2 17 63 136 176 303 304 310 382 397 451 462 521 549 587 602 723 746 764 778 779 782 788 838 853 1000 1078 1082 1088 1233 1240 
100 114 188 225 239 276 331 403 566 583 584 631 675 676 683 690 758 771 843 877 878 880 897 953 985 1027 1185 1187 1197 1198 1271 1286 
29 40 282 371 392 396 410 434 471 535 564 592 623 649 691 696 697 787 839 910 923 935 968 989 1061 1067 1072 1073 1132 1227 1255 
89 284 285 301 351 438 442 543 610 633 636 648 650 668 677 678 724 730 752 769 799 879 890 963 988 992 1016 1031 1161 1251 1267 
86 87 166 184 200 207 264 283 296 302 320 360 369 385 447 476 522 572 667 780 976 1013 1035 1053 1134 1135 1139 1182 1194 1283 
108 267 268 329 508 540 567 735 736 763 775 776 777 784 795 802 803 813 847 870 915 925 934 993 1011 1130 1180 1216 1245 1272 
16 175 257 317 340 341 418 428 430 441 445 504 516 533 569 589 660 750 824 827 1068 1106 1153 1154 1183 1192 1288 
132 148 185 240 241 326 327 367 450 460 478 484 548 630 820 909 912 960 1040 1062 1083 1172 1174 1175 
84 85 103 177 192 196 224 311 366 425 469 479 628 809 855 884 901 954 981 1026 1176 1230 
43 74 171 259 312 417 519 525 634 893 1038 1063 1085 1201 1213 1239 1244 
90 263 316 358 359 433 440 467 487 657 718 726 766 821 1122 1257 
59 178 281 470 501 580 595 815 871 886 1009 1112 1158 1177 1234 
80 179 180 293 364 372 620 627 751 767 811 858 865 1081 
414 491 559 654 674 720 721 936 1118 1148 1204 1242 1254 
850 851 874 875 881 926 1030 1033 1113 1125 1171 
99 147 220 226 415 437 499 810 1014 1280 
64 65 66 75 338 1060 1104 1120 
191 472 704 986 987 1057 1193 
246 335 990 1025 1095 1205 
55 287 695 895 973 
443 490 980 1206 1207 
474 669 929 1020 1208 
786 891 892 1163 1179 
3 337 507 994 
579 1203 1236 
947 948 1070 
