0 36 60 61 69 70 73 83 109 110 111 117 131 141 144 148 150 151 157 158 159 160 174 178 185 195 204 227 241 248 295 326 327 345 346 348 349 350 352 363 367 404 410 412 421 446 450 454 458 464 465 475 478 480 481 482 483 484 485 500 503 526 531 535 537 544 551 561 577 578 603 614 621 622 624 626 630 637 638 653 658 661 684 687 692 698 703 707 713 714 731 742 743 744 747 754 785 790 797 816 822 860 868 869 903 909 912 913 919 922 942 943 950 965 974 1001 1005 1006 1015 1019 1022 1040 1043 1047 1065 1067 1072 1074 1076 1077 1079 1083 1096 1102 1103 1123 1129 1136 1138 1155 1156 1160 1172 1174 1175 1178 1186 1189 1196 1225 1228 1241 1249 1274 1275 
3 6 13 20 34 35 38 39 41 42 54 67 71 92 97 102 122 127 130 139 140 163 165 181 194 211 212 213 218 219 230 253 254 255 269 273 292 306 307 314 315 332 334 344 357 373 377 378 393 395 401 408 420 435 436 439 492 496 502 527 528 545 546 547 550 552 553 555 556 557 568 576 586 590 591 601 607 608 619 632 641 647 662 666 701 712 732 745 756 757 760 800 805 806 807 825 829 831 844 859 862 863 864 896 944 945 949 952 957 966 977 979 1002 1032 1036 1039 1041 1042 1071 1088 1089 1097 1105 1128 1131 1143 1150 1164 1170 1223 1231 1238 1250 1258 1259 1266 1269 1270 1276 1284 1285 1287 
44 45 46 50 51 57 72 76 81 93 94 107 116 128 132 137 142 143 149 167 168 169 240 247 258 259 260 261 272 275 277 297 298 299 318 323 336 362 370 386 400 413 456 466 486 493 494 509 516 517 518 542 554 570 573 574 582 598 599 604 606 612 616 642 646 651 652 664 665 679 680 682 694 706 709 719 737 740 749 768 773 796 823 832 834 902 906 918 969 970 971 1003 1004 1007 1034 1049 1056 1058 1099 1114 1124 1127 1163 1167 1179 1184 1192 1214 1217 1243 1261 1262 
82 91 101 113 115 120 121 123 152 153 164 208 209 221 231 236 237 238 249 250 280 289 290 321 330 368 383 384 389 394 405 427 429 432 449 459 488 489 497 505 513 575 588 596 613 617 618 625 634 635 643 644 656 685 689 699 700 715 716 727 739 759 762 793 794 808 817 828 836 845 852 861 867 887 894 917 920 924 932 933 940 941 975 1012 1021 1044 1050 1054 1055 1080 1086 1094 1101 1108 1109 1126 1137 1145 1149 1190 1227 1246 1268 
56 96 100 133 134 138 145 156 182 193 225 239 244 245 262 276 331 375 398 402 403 419 506 530 539 541 563 565 583 584 605 609 631 672 683 702 708 771 786 804 837 843 873 880 888 889 891 892 897 911 927 956 985 1023 1146 1166 1187 1197 1226 1271 1278 
4 8 9 11 14 15 18 19 23 25 30 31 32 33 37 52 53 104 162 189 190 197 201 235 270 279 286 381 444 463 510 585 772 801 900 907 908 914 951 959 982 995 996 1018 1028 1048 1059 1087 1140 1141 1157 1165 1221 1222 1229 1252 1263 1279 1282 
78 86 112 161 170 186 187 198 202 205 206 243 265 266 274 278 300 353 356 407 416 452 457 511 558 560 581 710 717 733 734 753 765 770 781 818 826 830 833 876 904 928 984 991 1092 1100 1116 1199 1215 1232 1235 1273 1281 
1 2 5 7 17 21 22 26 47 49 58 59 62 63 199 203 229 308 309 328 397 414 477 501 559 571 600 611 629 645 659 686 722 723 814 815 871 886 905 960 983 1017 1024 1075 1107 1112 1117 1121 1147 1148 1177 
27 28 98 183 210 216 217 233 234 242 294 313 333 379 390 399 406 409 411 424 495 536 580 671 774 789 792 812 866 967 1010 1037 1098 1111 1115 1144 1173 1212 1277 
88 125 126 135 154 172 232 319 342 343 374 387 388 391 426 455 640 655 688 755 849 856 857 921 938 946 1090 1091 1142 1159 1162 1169 1209 1210 1224 1264 
114 184 188 207 283 302 320 360 369 380 385 447 566 572 675 676 690 758 820 827 877 878 953 1013 1027 1053 1106 1134 1135 1139 1154 1185 1194 1198 1283 1286 
24 108 267 268 271 329 508 540 567 735 736 763 775 776 777 784 795 802 803 813 847 870 915 925 934 993 1011 1130 1180 1216 1245 1260 1272 
68 87 166 196 200 296 325 376 431 468 476 512 522 523 524 529 594 667 711 780 791 835 872 976 1066 1084 1110 1119 1188 1195 1230 1237 
48 95 105 106 124 305 324 354 461 498 670 673 741 819 846 854 916 930 931 939 972 1008 1029 1051 1052 1133 1168 1191 1253 1256 1265 
77 79 118 119 129 146 214 215 228 251 252 288 322 347 453 460 473 514 538 548 593 615 639 663 693 761 1046 1062 1093 1247 1248 
136 173 176 303 304 310 382 448 451 462 515 521 549 587 602 729 746 764 778 779 782 788 838 853 1000 1078 1082 1202 1233 1240 
10 89 284 285 301 351 438 441 442 610 633 648 650 668 677 678 724 725 730 769 879 890 963 988 1031 1068 1161 1267 
16 175 192 222 257 317 340 341 418 428 430 445 504 533 569 589 660 750 824 885 1153 1183 1288 
29 40 282 371 392 396 434 471 564 592 623 691 787 839 923 935 989 1061 1073 1132 1182 1255 
90 155 263 264 316 358 359 433 440 467 487 657 718 726 766 821 840 841 1122 1257 
84 85 103 177 224 311 366 425 469 479 809 855 884 901 954 981 1026 1035 1176 
491 532 654 674 705 720 721 738 936 955 1118 1151 1181 1204 1242 1254 
80 179 180 293 364 372 520 620 627 628 751 767 858 865 1081 
99 147 220 226 339 355 415 437 499 810 1014 1280 
64 65 66 75 338 562 811 937 964 997 1211 
191 365 472 704 728 961 962 986 987 1057 1193 
223 256 534 798 848 1045 1060 1104 1120 1152 1218 
850 851 874 875 881 926 1030 1033 1113 1125 1171 
43 171 312 417 519 893 1063 1064 1085 
74 525 696 697 1038 1201 1213 1239 1244 
474 669 748 842 929 958 1020 1208 
543 636 752 783 799 992 1016 1251 
291 361 597 649 681 910 968 
246 335 990 1025 1095 1205 
281 470 595 1009 1158 1234 
12 882 883 978 1200 
55 287 695 895 973 
443 490 980 1206 1207 
337 507 994 
579 1203 1236 
898 899 1069 
947 948 1070 
