1 9 12 13 15 22 23 24 32 34 36 37 40 42 43 44 53 55 59 63 66 86 87 89 93 94 139 148 149 165 174 195 208 212 219 220 224 234 235 245 250 257 265 269 277 278 279 296 303 305 306 308 309 320 322 325 327 339 340 341 349 350 353 354 360 361 366 374 381 388 392 403 406 414 421 422 438 442 443 467 468 475 501 502 503 515 516 526 535 570 573 588 591 594 599 608 619 626 627 630 631 645 649 674 676 696 724 743 758 765 781 787 793 814 816 817 845 856 863 867 871 872 875 877 878 899 909 936 940 955 960 970 979 990 997 998 1011 1023 1029 1037 1070 1071 1078 1106 1116 1147 1148 1154 1172 1185 1187 1217 1260 1266 1273 1301 1307 1308 1332 1348 
5 48 56 57 162 191 390 393 407 418 460 530 542 556 595 600 624 648 656 657 715 742 803 809 969 996 1124 1135 1177 1223 1233 1234 1290 1302 1306 1310 1328 
7 26 30 33 97 125 126 133 158 172 180 244 271 288 294 301 302 334 410 429 434 453 454 474 598 687 693 748 778 820 944 951 985 1020 1073 
20 46 70 141 160 238 268 275 323 380 402 409 428 505 527 528 534 545 634 653 672 718 782 785 839 840 923 1030 1096 1325 
80 82 98 101 215 252 286 310 311 435 459 476 494 552 558 561 562 654 655 744 756 967 991 1007 1036 1054 1085 1281 
0 68 104 146 258 272 287 338 356 367 383 440 498 548 549 557 583 604 609 650 815 893 978 1039 1133 
19 122 140 164 166 167 179 324 343 391 400 423 427 499 520 590 652 726 835 906 907 957 1044 1045 
14 107 108 187 203 284 336 337 389 396 550 565 611 733 754 759 860 913 981 1050 1236 1329 
128 137 171 292 464 477 486 564 616 623 692 792 1102 1107 1108 1125 1129 1244 1245 1261 
84 85 136 201 210 412 424 473 506 531 581 601 702 942 956 1063 1075 1321 
109 115 487 646 647 805 806 826 868 1112 1134 1246 1259 1263 1326 1335 1336 
230 248 317 318 426 566 710 739 915 987 1031 1046 1142 1168 1170 1194 1289 
152 358 359 394 425 462 523 665 757 794 910 946 1079 1181 1218 
254 482 483 641 642 734 829 830 924 928 1084 1105 1144 1219 1312 
3 76 369 382 384 385 478 593 632 843 883 1088 1089 1265 
105 116 266 291 346 398 466 490 775 825 1032 1203 1314 1333 
47 90 147 471 798 808 879 880 1065 1082 1083 1110 1311 
25 91 213 214 299 328 415 536 537 610 729 1319 
65 135 204 263 379 589 615 732 800 804 1114 1305 
31 64 189 770 943 948 953 1205 1213 1247 1271 
45 378 446 496 622 746 747 752 763 1173 1210 
75 111 132 255 307 347 362 375 430 569 688 
88 249 681 711 712 811 812 857 1026 1094 1158 
11 206 207 222 395 448 694 714 947 1145 
61 62 96 876 896 1001 1100 1209 1286 1330 
117 121 253 372 445 755 931 1005 1034 1318 
188 260 419 437 512 721 771 974 1068 1275 
264 293 463 495 640 691 697 971 1117 1241 
769 862 873 881 976 1153 1190 1274 1284 1316 
16 83 119 259 457 489 625 779 1041 
18 178 713 788 1076 1098 1237 1295 1299 
51 221 227 961 1006 1048 1087 1146 1199 
99 198 199 270 297 335 533 628 973 
110 175 176 233 330 348 517 518 1208 
127 181 185 500 524 683 849 1229 1351 
217 232 679 680 917 918 1019 1155 1304 
240 241 261 273 413 842 929 1027 1167 
295 355 370 764 937 984 1104 1282 1342 
313 469 470 511 521 690 789 941 1049 
2 21 451 761 901 1143 1183 1276 
4 10 173 461 802 889 1195 1300 
78 142 661 662 989 1101 1264 1344 
154 225 386 387 510 1003 1056 1258 
211 216 229 283 441 753 922 1103 
364 399 420 513 1064 1149 1227 1240 
433 525 602 603 853 1081 1262 1292 
72 497 705 1166 1175 1232 1350 
73 351 404 651 723 1055 1077 
205 314 689 866 1201 1327 1338 
236 371 663 698 1122 1141 1349 
315 586 643 790 837 838 1283 
319 491 560 766 783 852 934 
555 833 834 1150 1151 1184 1257 
620 621 695 716 717 832 1228 
677 678 776 846 847 1097 1192 
27 60 100 163 332 417 
69 190 584 682 786 908 
159 262 342 926 1138 1248 
231 633 638 992 1224 1243 
239 767 958 1069 1277 1345 
267 968 1025 1090 1230 1303 
276 344 481 577 751 760 
298 326 636 699 1004 1028 
397 582 728 773 1136 1159 
401 449 450 921 964 1043 
529 664 780 930 1033 1035 
576 772 966 993 1111 1222 
796 797 824 851 1119 1120 
41 522 904 1021 1214 
58 200 667 703 745 
74 123 479 727 1002 
103 197 541 706 882 
124 155 980 1093 1189 
130 144 563 606 1239 
177 519 585 686 959 
182 290 331 975 1225 
237 539 818 932 933 
285 304 736 821 1272 
300 962 963 1047 1269 
408 431 432 701 905 
493 774 836 986 1080 
568 587 731 916 1212 
580 629 801 807 1202 
684 685 999 1215 1298 
730 831 950 1015 1057 
874 886 919 1017 1131 
1009 1010 1191 1296 1297 
6 35 246 813 
29 186 671 920 
39 223 1072 1347 
54 644 848 1182 
67 102 251 1059 
81 218 669 995 
106 145 914 1270 
112 169 226 1169 
120 1062 1160 1193 
131 138 670 1206 
193 972 1074 1156 
196 554 1042 1178 
209 900 1188 1324 
242 508 544 1211 
280 504 859 1317 
321 329 484 546 
352 532 784 1315 
357 551 666 965 
452 480 605 1186 
455 456 741 1040 
509 750 828 1346 
543 1053 1123 1200 
547 939 1163 1179 
553 673 722 1196 
571 596 597 1242 
574 740 854 1157 
617 618 861 1294 
660 1092 1216 1354 
869 888 898 1038 
902 903 935 954 
952 977 988 1091 
1165 1278 1279 1288 
8 289 1022 
28 465 735 
52 949 1067 
79 768 1066 
92 559 1099 
95 151 1255 
113 114 282 
118 458 1000 
134 1198 1231 
150 994 1118 
156 157 982 
161 897 1320 
168 202 1058 
170 363 668 
192 411 887 
256 890 1060 
281 444 870 
316 572 639 
365 659 1161 
376 377 607 
405 822 1016 
439 575 635 
488 1012 1162 
492 1013 1152 
514 819 1139 
538 675 738 
540 1226 1285 
567 777 912 
637 1121 1140 
700 719 720 
704 707 945 
795 858 864 
927 1132 1197 
1115 1254 1343 
1164 1253 1331 
1220 1221 1287 
