1 13 15 22 23 34 40 42 43 53 63 66 79 83 86 87 89 93 94 148 195 208 224 235 245 250 255 269 277 278 285 296 303 305 306 308 309 320 339 340 347 349 353 354 360 374 375 388 392 394 403 406 414 421 422 430 467 468 501 502 503 516 526 535 588 594 599 619 631 649 669 688 736 758 765 781 793 867 871 872 875 909 936 955 995 997 998 1029 1037 1078 1079 1106 1148 1154 1162 1178 1187 1193 1198 1247 1260 1265 1266 1273 1301 1307 1308 1332 1348 
0 68 69 104 146 190 275 287 293 338 356 358 367 383 440 463 498 548 549 557 582 583 604 609 640 682 691 697 786 893 971 978 1039 1117 1145 1159 1160 1168 
48 56 162 191 348 393 460 542 595 600 624 648 656 715 723 742 803 809 827 890 969 996 1060 1124 1135 1170 1177 1208 1223 1233 1234 1290 1302 1306 1328 
12 32 36 37 44 59 149 174 178 212 220 238 322 327 341 355 361 381 438 514 515 573 608 626 627 743 787 877 899 970 1024 1147 
20 47 65 70 88 112 124 135 155 204 256 263 321 379 380 570 581 589 615 636 711 732 798 804 825 980 1000 1094 1114 1189 1305 1325 
57 128 137 171 237 248 272 317 318 426 437 445 478 486 564 566 616 623 692 710 915 987 1034 1107 1142 1194 1241 1310 
19 122 140 164 166 167 179 324 391 400 423 427 470 499 520 652 726 800 835 889 906 907 957 1044 1045 
98 101 215 252 345 435 439 459 493 494 558 572 590 654 655 658 744 756 774 856 894 931 967 1036 1085 
14 107 187 203 332 336 337 396 525 550 565 603 611 709 712 733 754 759 913 981 1204 1236 1329 
24 25 91 213 214 299 328 536 537 610 657 684 685 729 1169 1215 1232 1298 1319 1350 
16 119 132 218 415 457 488 489 568 625 635 779 780 861 1035 1041 1118 
129 130 254 482 483 641 642 734 829 830 891 924 928 1084 1105 1144 1239 
5 30 33 126 133 180 288 301 302 368 577 687 802 983 985 1175 
28 61 62 96 465 646 874 876 896 990 1001 1011 1100 1209 1286 1330 
46 141 268 425 428 434 461 527 528 545 634 718 839 840 1096 
115 647 805 806 868 1004 1112 1134 1158 1246 1259 1263 1326 1335 1336 
84 85 201 300 412 473 506 531 617 618 702 942 1294 1321 
7 110 397 418 474 539 728 773 897 932 933 945 1136 
31 64 111 189 234 362 770 943 948 953 1205 1213 1271 
45 120 378 446 496 622 746 752 763 815 1062 1173 1210 
401 408 431 432 450 673 674 701 722 921 964 1043 1196 
35 177 314 329 424 519 585 607 663 686 689 959 
103 540 541 705 706 882 886 887 1031 1131 1226 1285 
151 156 157 593 612 791 911 982 1109 1113 1197 1255 
351 645 902 903 952 954 977 988 999 1047 1076 1091 
54 207 249 311 644 681 811 812 848 857 1182 
152 407 523 665 757 794 946 1181 1218 1219 1312 
153 154 225 307 386 601 750 1003 1056 1258 1346 
3 369 384 385 650 749 843 883 1088 1089 
51 221 227 228 961 1006 1048 1087 1146 1199 
76 165 279 442 630 814 816 863 878 940 
127 366 504 629 801 807 869 898 1038 1202 
139 295 370 764 937 984 1026 1104 1116 1342 
147 298 471 676 808 879 880 1065 1082 1083 
160 323 402 456 505 653 923 925 1030 1049 
211 216 229 253 262 283 441 753 1054 1103 
261 413 495 724 842 892 1027 1070 1167 1224 
281 282 326 591 638 737 914 1017 1023 1046 
105 116 398 466 775 844 1137 1203 1333 
108 161 259 352 532 784 817 1315 1320 
176 188 260 419 512 552 974 1068 1277 
181 185 524 683 696 755 849 1229 1351 
183 184 373 659 660 1092 1130 1216 1354 
313 469 511 521 690 789 941 1289 1300 
387 620 717 776 846 847 888 1097 1192 
509 510 739 799 828 1115 1254 1299 1343 
529 621 664 695 716 831 832 930 1228 
2 21 451 901 1143 1166 1183 1276 
18 546 713 714 788 905 1098 1295 
26 158 173 579 951 992 1020 1243 
240 241 273 274 929 1155 1235 1288 
294 334 389 417 704 707 820 1186 
38 106 145 210 1052 1063 1270 
41 522 904 1021 1102 1125 1214 
49 350 475 479 979 1040 1071 
73 266 404 651 919 1055 1077 
291 346 792 922 1244 1245 1261 
310 382 409 561 562 991 1281 
453 768 769 939 1190 1274 1284 
860 873 881 976 1033 1153 1316 
27 60 100 271 747 778 
75 81 284 464 477 1129 
77 78 661 662 989 1101 
97 244 410 454 944 1032 
113 114 118 458 760 1222 
198 270 297 335 533 973 
206 395 448 485 500 947 
236 371 698 1122 1141 1349 
267 968 1025 1090 1230 1303 
555 833 834 1150 1151 1257 
567 677 678 777 785 912 
1009 1010 1185 1191 1296 1297 
29 186 444 534 671 
39 223 1072 1108 1347 
58 200 667 1139 1237 
80 230 286 476 858 
159 342 926 1138 1248 
172 429 598 693 1073 
217 357 632 1019 1304 
290 331 605 975 1005 
472 547 917 918 1179 
491 560 783 852 934 
571 596 597 1242 1275 
576 772 966 993 1111 
586 587 1217 1256 1293 
9 125 319 766 
10 11 222 694 
74 123 727 1002 
92 559 1099 1280 
136 193 972 1074 
175 233 517 819 
196 554 927 1042 
205 1201 1327 1338 
231 232 633 679 
239 602 958 1069 
242 508 544 1211 
257 258 845 1172 
264 265 818 910 
280 433 859 1317 
330 518 920 1018 
333 405 822 1016 
343 344 481 751 
372 551 666 965 
390 447 530 556 
543 1053 1123 1200 
574 767 1133 1345 
680 1164 1253 1331 
730 950 1015 1057 
796 824 1119 1120 
6 246 813 
8 289 1022 
17 243 1291 
50 71 1314 
55 325 1066 
67 197 251 
72 497 748 
82 866 1007 
90 1110 1311 
95 703 745 
109 487 826 
134 735 1231 
138 670 1184 
144 563 606 
168 202 1058 
169 226 1067 
182 1163 1225 
192 411 700 
209 247 900 
219 443 1075 
276 836 1221 
304 821 1272 
315 643 790 
364 420 513 
365 1051 1161 
376 377 584 
399 1064 1227 
416 721 823 
436 841 895 
449 592 1061 
484 1149 1240 
490 578 870 
492 1013 1152 
580 1278 1279 
637 1121 1140 
639 699 1028 
731 916 1212 
740 956 1157 
771 854 1012 
797 850 851 
837 838 1283 
855 1128 1165 
908 1220 1287 
960 1132 1282 
962 963 1269 
1081 1262 1292 
