0 1 12 13 22 23 32 36 37 42 43 48 53 54 55 59 63 64 65 66 75 79 86 87 88 93 94 95 96 108 111 112 149 155 174 189 195 200 204 205 208 212 218 219 220 234 235 242 245 250 255 256 257 259 269 272 277 278 296 303 304 305 306 308 309 321 322 327 339 340 341 349 353 355 360 361 374 379 381 388 403 415 416 421 433 443 467 468 473 475 490 502 503 504 508 526 557 563 573 578 579 588 594 599 603 608 625 626 627 656 681 724 728 736 751 770 786 798 803 812 866 867 873 890 899 926 936 942 952 953 980 997 1002 1061 1070 1106 1114 1136 1137 1138 1146 1147 1159 1160 1167 1168 1187 1188 1206 1213 1234 1247 1248 1256 1270 1306 1310 1325 
6 7 25 29 34 35 40 58 67 73 74 76 80 81 83 84 85 113 115 123 132 142 147 148 157 168 169 177 190 284 285 291 307 314 315 328 329 366 382 384 398 401 402 408 412 424 457 458 466 484 488 489 516 519 531 545 546 547 555 574 584 585 586 593 606 607 612 613 629 649 660 663 667 668 686 688 700 745 760 775 779 780 788 791 792 807 832 837 838 843 844 846 865 875 883 888 900 911 923 948 986 994 1007 1024 1032 1041 1058 1081 1085 1089 1094 1098 1100 1102 1109 1110 1111 1117 1118 1124 1125 1139 1149 1162 1193 1197 1202 1220 1221 1222 1252 1260 1273 1283 1294 1315 1324 1332 1333 1354 
4 5 26 27 30 33 45 46 68 82 91 92 97 98 107 121 122 130 133 134 141 152 161 166 179 180 193 194 213 214 243 244 253 254 271 279 289 290 292 301 302 323 324 336 376 397 400 413 423 426 427 451 452 453 454 464 470 474 485 494 498 511 520 556 572 577 581 590 598 610 619 628 637 639 652 655 658 669 687 693 704 712 717 744 778 795 802 818 820 821 827 835 845 856 891 910 925 931 932 944 957 972 985 1030 1040 1044 1045 1049 1071 1072 1211 1212 1231 1238 1239 1312 1328 1329 1348 
10 16 56 57 69 70 103 104 120 125 126 135 150 151 156 158 160 172 173 196 197 236 237 238 248 251 268 288 294 352 356 359 377 378 428 429 430 432 434 455 456 461 463 472 495 496 501 534 541 552 595 636 640 648 653 670 672 676 697 703 705 706 727 737 742 746 747 752 763 785 801 815 841 851 861 863 897 904 905 922 933 941 943 951 971 976 982 992 996 1008 1020 1031 1060 1064 1073 1088 1103 1141 1170 1173 1177 1194 1195 1210 1214 1223 1233 1243 1289 1300 
8 9 20 101 102 124 146 187 188 202 203 211 216 217 221 229 230 246 247 252 262 263 276 319 320 332 333 334 345 354 357 365 399 431 435 440 441 476 491 492 505 550 551 558 560 561 592 622 632 635 698 733 735 753 754 756 766 783 823 860 862 870 935 975 981 987 995 1029 1036 1038 1067 1087 1121 1129 1281 
38 39 44 49 50 60 117 129 131 181 182 185 186 316 317 370 371 372 373 404 405 436 444 445 479 481 532 587 618 659 666 671 683 699 755 764 782 790 810 822 849 916 919 937 964 965 983 984 988 1005 1017 1019 1034 1053 1054 1062 1066 1074 1091 1092 1099 1104 1123 1161 1181 1199 1200 1207 1216 1224 1225 1278 1280 1314 1342 
2 3 21 105 106 109 110 176 223 224 233 260 261 347 348 393 419 420 437 512 571 597 634 715 771 809 819 901 915 974 1068 1083 1112 1135 1142 1143 1183 1208 1275 1290 1302 1347 
11 118 119 140 167 207 391 392 395 447 448 499 500 570 589 615 621 714 726 797 800 804 889 946 947 1039 1042 1079 1140 
258 293 318 338 350 367 383 525 540 548 549 582 583 602 604 609 689 696 711 842 869 893 940 978 1026 1027 1178 1189 1269 
127 128 136 137 170 171 191 192 264 265 460 477 478 486 487 542 564 616 623 624 691 692 710 721 1107 1108 1241 
153 154 225 226 273 369 386 387 509 510 536 537 600 601 871 872 903 1003 1037 1056 1057 1148 1258 1265 1301 1319 
61 62 266 646 651 805 806 826 868 876 877 896 990 1001 1011 1134 1158 1203 1259 1263 1286 1318 1330 1336 
77 144 145 175 201 209 210 281 282 343 344 569 591 645 898 914 1046 1051 1052 1063 1075 1097 1105 1293 
14 15 267 396 513 565 596 647 743 913 968 1004 1025 1050 1090 1153 1230 1242 1266 1276 1303 1326 1335 
299 300 368 506 685 702 749 750 765 781 799 817 828 998 1154 1169 1264 1307 1308 1321 1346 
164 165 414 576 580 630 631 814 816 836 878 1012 1192 1244 1245 1261 
312 313 469 521 522 554 633 690 761 789 1014 1016 1055 1128 1163 1285 
567 568 739 740 741 854 884 885 956 977 1013 1059 1078 1152 1157 1277 
47 99 100 275 295 326 358 394 462 471 523 665 757 794 1021 
215 310 311 325 342 362 438 439 459 562 654 882 894 895 1028 
31 231 280 409 425 527 528 539 638 718 840 969 1096 1271 
206 249 514 643 644 732 811 848 857 1122 1145 1182 1198 1349 
41 515 524 657 675 774 961 1166 1229 1232 1236 1350 1351 
71 72 239 446 497 605 748 855 892 979 991 1175 1217 
116 480 620 716 730 831 949 950 962 963 1015 1047 1228 
364 411 614 731 808 864 879 880 1065 1082 1235 1287 
351 422 535 575 758 767 902 993 1113 1240 1345 
482 483 641 642 734 829 830 924 928 1084 1144 
198 199 270 297 298 335 533 958 959 973 
51 52 227 228 442 1006 1022 1023 1048 
183 184 337 611 709 759 1069 1130 1204 
283 529 530 664 694 695 930 999 1035 
673 674 701 722 723 921 938 1043 1196 
650 725 796 824 912 1119 1120 1201 
679 680 1155 1164 1165 1288 1305 1331 
138 139 375 881 934 967 1171 
769 939 1179 1190 1274 1284 1316 
18 19 553 559 566 787 
78 661 662 970 989 1101 
163 389 417 538 707 1186 
286 287 682 858 908 1249 
330 331 517 518 1018 1184 
450 1000 1086 1116 1156 1255 
738 772 833 834 1151 1257 
1009 1010 1185 1191 1296 1297 
28 465 960 1132 1282 
159 773 927 1176 1253 
390 418 708 945 1093 
406 407 617 1205 1272 
852 874 886 887 1131 
17 410 850 1291 
24 929 1279 1298 
240 241 274 385 
449 1226 1227 1320 
677 678 776 777 
684 729 1172 1215 
713 1295 1299 1344 
768 917 918 1304 
784 954 1076 1077 
853 1033 1262 1292 
89 222 1311 
114 813 909 
162 719 720 
178 1080 1237 
232 507 1209 
363 380 966 
839 859 1317 
906 907 1246 
955 1327 1338 
1115 1254 1343 
1126 1127 1174 
