1 12 13 15 22 23 31 32 34 36 37 40 42 43 44 53 55 59 62 63 64 66 79 83 86 87 89 93 94 111 148 149 153 165 174 178 189 195 208 212 219 220 224 234 235 238 245 250 255 257 259 269 277 278 285 296 303 304 305 306 307 308 309 320 322 325 327 339 340 341 349 350 353 354 355 360 361 362 366 374 375 381 388 392 394 403 406 414 421 422 430 438 442 467 468 475 501 502 503 515 516 526 535 573 588 594 599 601 608 619 626 627 631 649 650 676 688 724 736 743 758 770 781 787 793 814 817 821 845 867 871 872 875 877 899 909 936 943 948 953 955 970 979 997 998 1011 1024 1029 1037 1066 1070 1071 1106 1147 1148 1154 1162 1172 1187 1198 1205 1213 1217 1247 1260 1265 1266 1271 1272 1273 1301 1307 1309 1330 1332 1334 1348 
4 5 7 10 11 20 26 28 30 33 52 54 65 70 71 72 88 97 108 110 112 117 118 119 124 126 131 133 135 158 169 172 173 180 204 206 207 222 226 239 244 249 256 263 286 288 291 294 301 302 321 323 334 346 352 368 379 380 395 397 410 429 436 448 453 454 458 461 465 474 497 500 532 570 577 579 580 581 589 598 607 615 644 670 681 687 693 694 704 711 712 721 728 732 748 765 773 782 784 792 800 802 804 811 812 841 848 850 857 889 895 919 922 944 945 946 947 949 951 958 967 984 985 1032 1067 1069 1073 1114 1136 1145 1158 1175 1182 1189 1195 1206 1244 1245 1256 1261 1278 1279 1291 1305 1308 1325 1342 
3 17 41 80 82 98 99 101 115 134 152 154 156 157 198 199 215 225 230 243 252 270 297 299 310 311 335 345 369 382 384 385 386 407 435 439 459 476 494 522 523 533 552 558 561 562 572 590 654 655 658 665 735 744 749 750 756 757 778 794 795 843 858 864 866 883 894 904 931 973 982 991 1003 1007 1021 1028 1036 1056 1085 1088 1089 1168 1181 1214 1218 1219 1258 1259 1277 1281 1312 1346 
48 56 57 103 109 162 175 176 188 191 233 260 264 265 330 347 348 390 393 418 419 447 460 485 487 512 517 518 530 539 542 553 556 595 600 624 648 656 673 715 722 723 742 771 803 809 818 826 827 876 910 920 932 933 969 974 996 1018 1060 1068 1079 1124 1135 1170 1177 1208 1223 1233 1234 1275 1290 1302 1306 1313 1328 1339 
16 39 51 102 132 192 205 221 223 227 228 240 241 247 273 274 315 405 411 415 457 488 489 492 567 568 586 625 635 643 677 678 700 740 777 779 780 790 828 837 838 861 884 885 890 912 929 956 961 1006 1013 1033 1035 1041 1048 1059 1072 1078 1087 1095 1118 1146 1152 1155 1157 1180 1199 1235 1283 1315 1327 1338 1347 
27 60 100 121 127 181 182 185 271 290 312 313 331 333 357 372 469 472 511 524 543 547 551 587 605 666 683 690 696 731 747 755 768 769 789 822 849 855 916 917 918 938 939 941 965 972 975 1000 1005 1014 1016 1049 1053 1123 1128 1163 1165 1176 1179 1190 1200 1212 1229 1274 1288 1318 1351 
38 106 128 137 144 145 171 210 237 248 272 317 318 389 417 426 437 445 478 486 510 564 566 569 616 623 632 692 707 708 710 739 820 914 915 987 1031 1034 1046 1050 1052 1063 1105 1107 1108 1115 1142 1186 1194 1241 1254 1270 1289 1299 1300 1310 1343 
19 46 67 122 140 141 163 164 166 167 179 231 236 251 268 316 324 371 391 400 423 425 427 434 470 499 520 528 545 563 606 652 653 663 672 698 718 726 785 835 839 840 906 907 908 957 1044 1045 1096 1122 1141 1220 1349 
0 68 69 104 146 155 161 190 194 242 258 275 287 293 338 356 358 367 383 440 463 498 508 544 548 549 557 582 583 604 609 640 682 691 697 786 854 893 897 971 978 1012 1039 1093 1117 1159 1178 1211 1231 1320 
24 73 136 292 351 404 443 452 480 529 574 575 645 651 657 664 684 767 856 902 903 930 935 952 954 977 988 999 1008 1055 1076 1077 1091 1133 1215 1232 1298 1345 1350 
50 74 95 123 151 196 479 554 593 612 613 660 727 791 860 862 873 881 911 927 976 983 1002 1042 1092 1109 1132 1153 1171 1197 1216 1252 1255 1284 1316 1340 1341 1354 
25 91 213 214 280 328 387 433 525 536 537 602 603 610 629 685 729 776 801 807 846 847 853 859 869 888 898 1038 1081 1097 1169 1192 1202 1262 1292 1317 1319 
14 107 183 184 187 203 217 267 284 332 336 337 396 550 565 611 709 733 734 754 759 913 960 968 981 1019 1025 1090 1130 1204 1230 1236 1303 1304 1329 
129 130 150 254 482 483 507 509 555 578 641 642 725 796 797 799 824 829 830 851 870 924 928 994 1020 1084 1119 1120 1144 1184 1201 1238 1239 
6 35 81 177 193 209 246 314 373 424 491 519 560 585 686 689 783 813 852 886 887 900 934 959 1051 1074 1131 1188 1324 
92 105 116 266 398 455 456 466 490 559 680 741 775 844 896 990 1040 1099 1137 1164 1203 1253 1267 1268 1286 1331 1333 
9 76 125 261 279 401 413 450 495 630 674 810 816 842 863 878 921 940 964 1027 1043 1086 1167 1196 
139 295 326 370 591 636 638 639 699 737 764 937 1004 1009 1010 1023 1026 1104 1116 1185 1191 1282 1296 1297 
75 159 202 262 319 342 359 464 477 504 576 766 772 926 966 993 1102 1111 1125 1129 1138 1222 1248 
45 120 378 446 496 622 746 752 763 815 891 892 992 1062 1113 1160 1173 1193 1210 1224 1225 1243 
77 78 142 143 493 614 661 662 706 774 986 989 1080 1101 1207 1264 1293 1337 1344 
84 85 201 300 412 473 506 531 617 618 702 942 962 963 1047 1075 1269 1294 1321 
2 21 49 197 451 540 541 705 761 762 882 901 1143 1166 1183 1226 1276 1285 
47 90 147 298 471 798 808 879 880 980 1065 1082 1083 1094 1110 1311 
8 289 364 399 420 513 874 1017 1022 1064 1149 1227 1240 1280 
18 232 521 546 633 679 713 714 719 788 1098 1156 1295 
58 200 329 484 514 667 703 745 819 865 1139 1237 1249 
211 216 229 253 283 441 449 584 592 753 1054 1061 1103 
343 344 481 538 675 738 751 833 834 1150 1151 1257 
365 408 431 432 571 596 597 659 701 905 1161 1242 
620 621 695 716 717 730 831 832 950 1015 1057 1228 
646 647 805 806 868 1112 1134 1246 1263 1326 1335 1336 
29 186 281 428 444 534 634 671 825 1314 
61 96 376 377 416 823 925 1001 1100 1209 
113 114 276 282 760 836 1221 1287 
160 402 409 505 527 923 1030 
168 637 1058 1121 1140 1322 1323 
138 218 628 669 720 995 
170 363 462 668 
