6 7 22 34 36 40 58 67 73 74 81 88 119 148 165 208 220 227 255 277 284 324 329 364 376 381 382 388 401 412 421 433 464 475 484 503 513 516 526 545 573 584 585 599 600 627 663 686 695 716 749 781 792 832 865 875 900 908 957 1054 1097 1106 1129 1149 1240 1273 1324 1332 1348 
48 105 127 128 137 170 171 176 191 223 233 244 260 261 264 348 366 393 408 410 446 460 477 486 487 512 542 564 571 616 623 624 656 692 715 775 809 898 966 969 1067 1107 1108 1124 1135 1202 1234 1241 1272 1275 1290 1302 1306 1347 
44 47 99 100 149 199 238 275 358 359 394 432 462 466 471 490 514 515 523 543 608 618 665 784 790 794 916 933 952 954 976 988 1053 1076 1091 1123 1141 1147 1200 1333 
9 102 125 187 203 211 217 229 241 262 276 319 332 345 435 440 441 492 505 550 560 622 735 753 754 766 783 852 981 
154 225 299 300 312 313 328 369 386 521 537 601 685 690 729 750 903 1003 1014 1016 1056 1057 1163 1215 1258 1319 1346 
8 56 57 93 202 237 248 318 378 389 420 437 476 478 566 595 827 915 941 987 996 1082 1177 1206 1289 1300 
46 118 140 167 206 281 391 395 400 499 500 589 714 726 796 797 800 835 946 947 977 1042 1079 1092 
141 214 231 236 268 295 425 434 496 528 552 675 718 801 884 943 1021 1233 1247 1277 
0 52 68 126 293 442 609 610 640 670 697 971 992 1022 1023 1048 1145 1214 
13 75 79 83 111 235 285 304 340 375 397 530 556 574 652 795 1044 1317 
14 15 115 267 326 565 596 597 743 913 968 1004 1025 1090 1230 1242 1303 
103 104 107 156 196 197 472 525 603 667 712 733 904 905 982 
198 270 297 298 335 533 535 536 871 958 973 1148 1265 1301 
509 568 739 740 799 854 885 956 1059 1078 1152 1157 1343 
49 50 218 350 413 495 588 812 1040 1086 1197 1260 
160 161 190 215 239 602 709 756 855 1069 1130 1204 
254 482 554 641 642 829 830 924 928 1084 1105 1144 
21 98 279 423 439 454 901 944 1028 1143 1252 
91 92 287 343 654 682 906 907 1045 1246 1249 
110 473 474 541 557 570 581 615 710 951 1103 
426 572 590 658 669 778 845 856 931 936 1142 
25 53 63 272 306 360 467 872 1037 1189 
28 29 379 465 732 734 927 1001 1019 1176 
61 109 646 647 826 876 1134 1259 1326 1335 
78 96 493 661 662 986 989 1101 1136 1209 
121 136 193 323 377 402 456 470 1030 1049 
315 586 587 837 838 1074 1217 1256 1283 1293 
1 65 195 347 569 688 980 1029 1050 
35 373 374 519 689 700 926 1024 1096 
51 95 555 578 579 632 727 1114 1146 
132 205 224 354 488 625 815 1201 1208 
317 334 445 532 631 703 746 1005 1034 
368 387 506 520 620 717 776 846 1169 
3 591 638 645 737 1017 1173 1183 
18 123 152 174 221 406 407 867 
32 232 613 679 713 1115 1254 1299 
135 204 325 687 889 912 1175 1305 
183 184 336 337 396 611 759 1329 
769 917 918 939 1179 1190 1274 1284 
777 791 862 873 1033 1153 1292 1316 
11 547 607 621 694 767 1345 
24 117 242 517 671 1232 1350 
38 522 738 833 834 1151 1257 
59 212 504 575 635 724 803 
113 114 458 606 752 1222 1248 
157 576 593 612 878 911 1128 
162 163 417 418 538 708 763 
182 282 725 824 914 1119 1120 
259 296 341 383 649 1038 1178 
310 311 483 655 882 887 1031 
371 436 636 698 984 1104 1342 
10 461 683 1122 1216 1349 
20 180 342 511 1198 1325 
23 85 86 744 942 1195 
26 459 497 848 859 1304 
31 634 899 953 970 1271 
42 64 234 309 457 861 
89 90 222 1110 1140 1311 
101 314 363 480 770 813 
116 741 1071 1203 1266 1286 
146 250 786 787 995 1168 
147 166 880 1065 1083 1093 
151 772 949 950 1111 1255 
186 428 444 534 659 810 
188 339 416 696 721 1068 
207 249 643 644 728 1060 
209 247 558 808 999 1036 
246 681 811 857 1182 1281 
330 331 518 920 1018 1184 
333 539 823 897 932 985 
390 731 755 774 1212 1229 
449 450 719 1156 1227 1320 
524 660 1236 1243 1351 1354 
673 674 723 788 938 1196 
680 879 1155 1164 1235 1288 
850 851 863 1073 1113 1133 
4 45 70 129 158 
12 144 263 563 821 
19 179 553 559 562 
55 403 945 1186 1213 
66 280 847 888 1192 
94 650 1070 1088 1089 
112 169 226 1058 1294 
134 427 619 653 742 
139 164 1026 1116 1185 
145 411 452 479 782 
219 269 443 508 1075 
253 283 529 664 930 
399 974 1064 1172 1228 
404 651 843 1013 1055 
424 771 891 1012 1162 
451 761 762 870 1276 
463 691 940 994 1020 
468 617 736 1137 1138 
498 549 582 807 1159 
704 779 825 1118 1314 
1009 1010 1191 1296 1297 
1098 1102 1125 1237 1295 
1181 1207 1218 1223 1328 
5 133 289 820 
17 243 491 1291 
30 978 1187 1205 
33 301 302 577 
60 527 614 747 
62 874 1011 1330 
71 72 748 892 
87 108 352 1331 
120 320 357 1160 
130 507 1238 1239 
153 201 307 869 
159 192 975 1000 
175 321 489 546 
189 305 322 362 
194 469 657 1231 
228 531 594 967 
240 273 274 929 
258 684 1279 1298 
266 414 896 990 
290 294 760 1210 
291 292 922 1043 
316 839 840 1161 
327 349 798 1094 
361 909 1081 1262 
422 831 955 1338 
430 705 890 1072 
453 768 910 1066 
501 960 1041 1109 
540 1170 1226 1285 
626 948 1117 1253 
630 836 921 1171 
707 780 814 1035 
765 866 1007 1061 
816 1244 1245 1261 
998 1154 1167 1321 
2 819 1139 
16 251 405 
39 1224 1225 
41 757 1087 
43 730 993 
54 1002 1188 
69 308 419 
76 925 972 
77 1046 1085 
82 398 1077 
84 672 877 
97 1008 1032 
124 502 722 
138 720 789 
150 346 1150 
155 392 702 
210 1052 1063 
230 858 965 
245 278 604 
252 438 979 
257 338 548 
303 355 367 
344 849 1166 
356 751 893 
370 380 676 
372 551 648 
384 701 1100 
409 561 991 
429 693 961 
447 485 1039 
455 592 844 
567 785 1211 
580 583 1278 
666 964 1199 
668 841 959 
677 678 828 
804 997 1310 
805 806 1336 
864 883 1327 
868 1112 1263 
881 923 934 
894 895 1006 
962 963 1269 
1220 1221 1287 
