1 12 13 15 22 23 31 32 34 36 37 40 42 43 44 53 55 59 62 63 64 66 86 87 89 93 94 148 149 165 174 189 195 208 212 219 220 224 234 235 238 245 250 257 269 277 278 296 303 305 306 309 320 322 325 327 339 340 341 349 350 353 354 355 360 361 362 366 374 381 388 392 394 403 406 414 421 422 430 438 442 467 468 475 501 502 503 515 516 526 535 573 588 594 599 608 619 626 627 631 649 650 676 688 724 743 758 770 781 787 793 814 817 845 867 871 872 875 877 899 909 936 943 948 953 955 970 979 997 998 1011 1024 1029 1037 1070 1071 1106 1147 1148 1154 1162 1172 1187 1198 1205 1213 1217 1247 1260 1265 1266 1271 1273 1301 1307 1330 1332 1348 
5 7 20 26 30 33 70 72 88 97 108 110 118 119 126 133 135 158 172 173 180 204 207 244 256 286 294 301 302 321 334 352 395 410 429 453 454 474 497 570 577 579 581 598 615 687 693 704 748 765 784 800 804 944 945 951 967 985 1073 1114 1175 1195 1256 1305 1308 1325 
128 137 144 171 237 248 272 317 318 426 437 445 478 486 510 564 566 616 623 632 692 710 739 914 915 987 1031 1034 1046 1107 1108 1115 1142 1194 1241 1254 1289 1299 1300 1310 1343 
48 56 57 103 162 191 233 393 460 542 595 600 624 648 656 673 715 723 742 803 809 827 969 996 1060 1079 1124 1135 1170 1177 1223 1233 1234 1290 1302 1306 1328 
0 68 69 104 146 155 190 194 258 275 287 293 338 356 358 367 383 440 498 548 549 557 582 583 604 609 682 786 854 893 978 1012 1039 1093 1159 1178 
17 98 101 134 215 243 252 310 311 345 382 384 435 439 459 494 558 561 562 572 590 654 655 658 735 744 756 778 894 931 991 1028 1036 1085 1281 
19 122 140 164 166 167 179 324 391 400 423 427 470 499 520 563 606 652 726 835 906 907 957 1044 1045 
16 39 132 192 223 405 411 457 488 489 568 625 635 700 779 780 861 1033 1035 1041 1118 1347 
3 115 154 225 299 369 385 386 749 750 843 883 1003 1056 1088 1089 1258 1259 1346 
99 152 198 199 270 297 335 407 523 533 665 757 794 973 1181 1218 1219 1312 
46 141 231 268 425 434 528 545 653 672 718 785 839 840 1096 
84 85 201 412 473 506 531 617 618 702 942 1075 1294 1321 
54 249 644 681 711 712 811 812 848 857 1158 1182 1189 
176 188 260 264 347 348 419 512 771 974 1068 1208 1275 
14 336 337 396 565 611 709 759 913 1204 1236 1329 
25 91 213 214 328 536 537 610 685 729 1169 1319 
83 111 153 178 255 259 285 307 308 375 601 736 
105 116 266 398 466 490 775 896 990 1203 1286 1333 
254 482 483 641 642 829 830 924 928 1084 1144 
11 206 222 448 500 607 694 946 947 1145 
38 106 145 210 569 1050 1052 1063 1105 1270 
45 378 496 622 746 752 763 815 1173 1210 
433 525 602 603 853 859 1081 1262 1292 1317 
472 547 768 769 917 918 939 1179 1190 1274 
24 136 452 480 657 856 1008 1232 1350 
51 221 227 961 1006 1048 1087 1146 1199 
75 202 319 464 477 766 1102 1125 1129 
107 187 203 284 332 550 733 754 981 
127 181 185 524 683 755 849 1229 1351 
147 298 471 808 879 880 1065 1082 1083 
791 860 862 873 881 976 1153 1284 1316 
2 21 451 761 901 1143 1183 1276 
58 200 329 484 667 703 745 1237 
150 509 555 725 799 994 1020 1184 
211 216 229 253 283 441 753 1103 
351 902 903 935 954 988 1076 1091 
364 399 420 513 1064 1149 1227 1240 
620 621 695 716 717 831 832 1228 
629 801 807 869 888 898 1038 1202 
18 546 713 714 788 1098 1295 
76 279 630 816 863 878 940 
131 436 461 670 841 895 1206 
139 295 764 937 1026 1116 1282 
236 371 663 698 1122 1141 1349 
280 387 776 846 847 1097 1192 
292 443 574 575 767 1133 1345 
315 586 643 790 837 838 1283 
370 591 636 638 737 1023 1104 
401 450 674 921 964 1043 1196 
529 645 664 930 952 977 999 
796 797 824 851 1119 1120 1201 
4 10 288 368 802 889 
52 112 169 226 949 1067 
65 124 263 379 589 732 
113 114 282 836 1221 1287 
175 330 517 518 920 1018 
182 313 690 789 941 1163 
240 273 274 929 1155 1235 
261 413 495 842 1027 1167 
267 968 1025 1090 1230 1303 
346 792 1032 1244 1245 1261 
389 417 707 708 820 1186 
463 640 691 697 971 1117 
479 593 612 613 911 1171 
491 560 783 852 934 1051 
493 661 662 774 989 1101 
567 677 678 777 828 912 
646 647 806 1134 1326 1335 
660 1092 1197 1216 1252 1354 
740 884 885 956 1078 1157 
1009 1010 1185 1191 1296 1297 
27 60 100 271 747 
29 186 671 825 1314 
35 314 373 519 689 
41 522 904 1021 1214 
61 96 1001 1100 1209 
73 404 651 1055 1077 
80 230 476 858 1168 
120 1062 1113 1160 1193 
129 130 578 870 1239 
156 157 552 982 1277 
177 424 585 686 959 
197 540 541 1226 1285 
217 734 960 1019 1304 
239 323 782 958 1069 
281 428 444 534 634 
290 331 605 696 975 
300 962 963 1047 1269 
357 372 551 666 965 
397 458 728 773 1136 
833 834 1150 1151 1257 
28 71 465 532 
47 798 980 1094 
67 251 908 1220 
74 123 727 1002 
77 78 142 1293 
81 886 887 1131 
95 151 1109 1255 
109 487 826 876 
161 897 1231 1320 
196 554 927 1042 
232 521 633 679 
241 492 1013 1152 
242 508 544 1211 
326 639 699 1004 
342 504 1138 1248 
343 344 481 751 
359 966 993 1222 
380 721 984 1342 
409 505 527 923 
418 539 932 933 
455 456 741 1040 
469 511 972 1049 
543 1053 1123 1200 
571 596 597 1242 
580 919 1278 1279 
587 731 916 1212 
680 1164 1253 1331 
730 950 1015 1057 
855 1128 1165 1288 
868 1112 1246 1263 
992 1224 1225 1243 
6 246 813 
8 289 1022 
50 983 1132 
82 866 1007 
90 1110 1311 
92 559 1099 
117 291 922 
121 1005 1318 
138 628 720 
159 262 926 
160 402 1030 
168 1058 1121 
183 184 1130 
205 1327 1338 
218 669 995 
265 818 910 
304 821 1272 
333 822 1016 
365 659 1161 
390 530 556 
408 701 905 
416 823 925 
446 891 892 
449 592 1061 
514 819 1139 
538 675 738 
576 772 1111 
684 1215 1298 
705 882 1166 
706 1264 1344 
874 1017 1280 
1000 1014 1176 
