1 6 7 12 22 24 25 34 36 40 58 66 73 74 81 88 99 111 119 120 148 154 155 165 169 189 199 208 212 220 225 226 227 242 245 255 272 277 280 284 299 300 305 306 314 315 320 321 324 328 329 360 362 374 376 381 386 387 388 401 412 415 421 433 464 467 468 475 484 489 500 503 513 515 516 517 519 524 526 537 545 546 547 570 573 585 599 600 601 607 617 627 628 629 630 650 663 671 686 695 702 711 712 729 736 749 781 790 792 803 805 806 816 824 832 847 854 861 865 875 888 900 903 908 926 936 951 957 988 995 1003 1014 1056 1057 1058 1078 1095 1096 1097 1106 1119 1120 1129 1137 1138 1149 1157 1158 1160 1169 1171 1179 1180 1192 1215 1240 1243 1244 1245 1258 1261 1271 1273 1294 1319 1332 1348 1351 
41 80 102 103 104 107 108 113 114 156 158 167 168 173 182 185 186 196 197 198 202 214 228 240 251 257 266 270 273 282 297 298 322 335 338 341 371 385 389 392 404 444 451 472 525 531 533 535 536 548 550 551 589 594 603 615 636 648 651 653 666 667 668 698 723 725 733 737 752 757 762 800 802 841 843 860 870 871 902 904 905 919 929 958 959 964 967 973 982 983 996 1002 1013 1017 1042 1046 1047 1054 1055 1062 1085 1087 1103 1104 1139 1148 1188 1199 1202 1276 1301 1324 1342 1344 
0 10 27 31 44 46 47 100 124 140 141 149 238 265 268 275 291 292 295 358 359 409 425 428 432 461 462 466 471 490 496 514 523 527 528 534 541 543 552 608 618 626 634 665 673 718 722 726 748 773 784 794 801 818 862 892 899 916 933 938 943 948 952 953 954 970 976 1021 1043 1053 1064 1091 1122 1123 1141 1147 1196 1200 1247 1333 1349 
16 48 105 118 127 128 137 142 143 159 170 171 191 206 223 244 264 274 281 339 366 391 393 408 410 416 446 460 477 486 487 494 499 542 564 571 616 623 624 633 656 691 692 696 714 715 721 775 796 797 804 809 836 898 914 946 947 966 969 977 986 997 1000 1067 1107 1108 1124 1135 1177 1234 1235 1241 1264 1272 1290 1302 1306 1337 1347 
5 9 54 57 72 93 135 144 146 147 166 187 203 204 211 229 230 248 250 262 263 276 287 318 319 378 394 395 400 420 431 435 440 441 449 450 476 492 530 540 558 560 563 566 595 622 753 754 764 766 783 821 852 855 866 880 889 915 921 981 987 1065 1079 1082 1083 1093 1168 1170 1206 1226 1249 1285 1289 1305 1317 
3 11 29 51 76 153 201 210 217 231 232 365 369 382 384 478 482 507 509 510 555 579 597 632 641 642 679 680 694 727 734 739 740 741 799 830 833 834 869 924 927 928 1019 1051 1059 1063 1084 1088 1089 1092 1114 1144 1146 1150 1151 1152 1155 1164 1176 1183 1257 1265 1288 1299 1343 
4 23 70 85 86 87 129 130 219 254 259 269 296 325 327 349 352 356 379 383 424 443 506 554 591 606 638 645 744 751 780 798 814 817 891 893 942 956 1012 1035 1038 1075 1094 1102 1105 1125 1162 1173 1178 1181 1195 1207 1218 1219 1223 1238 1239 1312 1315 1328 1331 
14 15 115 116 157 164 236 267 326 501 565 567 576 593 596 611 612 647 675 743 758 761 785 793 822 826 878 911 913 960 968 1004 1025 1041 1050 1070 1071 1090 1109 1128 1134 1203 1211 1220 1221 1222 1230 1236 1242 1248 1259 1266 1287 1303 1309 1326 1334 
30 42 49 50 59 64 71 79 96 218 234 235 241 309 350 413 430 457 493 504 574 575 580 588 635 661 662 705 724 777 810 812 873 890 918 978 989 1033 1040 1086 1101 1136 1153 1187 1197 1205 1209 1224 1292 1310 1316 1340 1341 
19 95 117 122 179 183 253 316 345 372 373 426 445 453 553 557 562 572 590 639 658 669 745 755 765 768 769 778 845 856 910 917 931 939 1005 1007 1034 1061 1066 1142 1190 1274 1284 1307 1308 
33 45 160 161 180 184 188 190 215 224 239 243 279 301 302 313 353 437 454 491 602 637 649 659 660 683 709 747 756 767 884 885 944 1068 1069 1130 1204 1208 1216 1277 1320 1322 1323 1345 1354 
32 38 52 56 125 126 290 293 294 312 405 434 442 495 521 522 613 640 690 697 713 738 760 789 941 971 992 1016 1018 1023 1048 1052 1099 1115 1117 1163 1210 1253 1254 1267 1268 1278 1280 1300 
20 21 28 61 62 69 112 134 195 207 249 308 340 342 419 427 465 502 511 584 619 643 644 701 728 735 742 786 787 876 896 901 990 1001 1100 1143 1198 1286 1325 1330 
75 82 83 132 200 256 285 288 304 307 347 354 375 396 397 398 458 473 474 488 508 556 561 569 578 581 582 625 652 688 707 710 795 980 1044 1060 1077 1131 
145 209 258 310 311 336 337 411 448 479 483 655 684 706 759 782 808 858 879 882 883 887 963 965 1015 1031 1165 1269 1279 1298 1327 1329 
26 55 60 67 98 162 163 181 289 332 390 403 417 418 459 497 538 614 708 763 820 848 859 945 1080 1186 1213 1304 1318 
2 106 109 110 175 176 233 260 261 323 330 348 414 463 512 549 583 771 819 940 994 1193 1194 1260 1270 1275 1313 1339 
35 177 178 237 283 333 351 455 481 529 539 592 598 664 674 788 823 897 922 930 932 985 991 1076 1098 1132 1237 1295 
68 121 136 138 193 331 377 402 456 470 518 670 791 815 881 920 923 925 934 972 1022 1030 1049 1072 1145 1156 1184 1214 
77 317 334 357 532 631 703 746 844 850 851 863 868 961 1073 1112 1113 1133 1263 1336 
101 151 246 363 364 480 621 681 770 772 811 813 857 949 950 1111 1182 1255 1281 
13 63 133 252 344 438 577 849 872 979 1037 1159 1166 1175 1189 1229 1232 1350 
53 139 192 370 380 676 842 975 984 1009 1010 1026 1027 1116 1185 1191 1296 1297 
150 346 700 704 719 720 779 825 827 835 864 962 998 1118 1154 1167 1314 1321 
18 65 123 152 172 174 221 271 406 407 429 447 693 732 867 912 1029 
91 92 213 343 452 559 568 605 654 682 731 774 906 907 1045 1212 1246 
43 89 90 94 222 278 361 604 730 909 993 1081 1110 1140 1262 1311 
84 368 520 620 672 677 678 716 717 750 776 828 846 877 1024 1346 
422 586 587 831 837 838 955 1074 1217 1256 1283 1293 1338 
8 399 505 839 840 853 935 974 1161 1172 1227 1228 
37 78 216 303 355 367 544 609 610 937 1282 
205 436 485 689 894 895 1006 1039 1201 
17 39 194 469 657 1225 1231 1291 
97 423 439 699 1008 1028 1032 1252 
131 286 646 874 886 1011 1233 1335 
247 685 829 999 1036 1121 
498 687 807 1020 
