0 6 7 22 34 36 40 58 67 73 74 80 81 88 119 120 148 154 165 169 173 208 212 220 225 226 227 255 272 273 277 283 284 299 300 315 320 324 328 329 356 360 376 381 386 388 401 412 421 433 464 468 475 484 503 513 515 516 524 526 537 545 573 585 599 600 601 617 627 628 629 647 650 663 666 667 686 695 711 712 729 736 749 750 781 790 803 805 806 816 832 861 865 875 886 900 903 908 936 957 964 983 1003 1014 1016 1050 1054 1056 1057 1058 1095 1106 1125 1129 1131 1134 1137 1138 1158 1160 1162 1171 1180 1199 1215 1236 1237 1240 1243 1258 1271 1273 1294 1319 1326 1332 1336 1346 1348 1351 
41 103 104 107 108 112 113 114 129 130 158 164 182 186 196 197 198 199 214 228 257 266 270 282 297 298 335 338 371 385 389 392 399 404 424 458 472 525 529 531 533 548 551 589 591 594 603 606 615 630 636 638 648 651 653 664 668 698 707 723 725 733 737 752 757 780 800 814 824 841 843 854 860 891 904 905 919 930 958 959 960 967 973 974 982 1002 1012 1013 1017 1035 1042 1055 1062 1087 1098 1102 1103 1104 1119 1120 1132 1139 1163 1172 1173 1188 1225 1227 1238 1239 1282 1324 1342 
4 10 31 44 46 47 99 100 132 140 141 149 155 160 161 183 215 236 238 243 254 268 275 295 354 358 359 373 394 395 409 425 428 432 461 462 466 471 481 483 488 490 491 496 514 519 521 523 528 543 552 554 561 584 598 618 625 626 634 659 660 665 675 683 702 718 756 784 786 787 794 801 802 884 889 899 916 933 943 948 952 953 954 970 976 995 1021 1053 1064 1076 1091 1096 1105 1122 1123 1141 1147 1200 1216 1231 1233 1247 1277 1320 1333 1349 1354 
27 48 56 59 105 127 128 137 142 143 167 170 171 191 206 223 233 244 264 281 366 391 393 408 410 446 460 477 486 487 499 500 504 542 564 571 575 616 623 624 635 656 691 692 714 715 726 744 773 775 796 797 804 809 835 898 914 946 947 951 966 969 997 1067 1079 1107 1108 1124 1135 1177 1234 1241 1272 1290 1302 1306 1310 1337 1347 
12 57 71 72 93 96 102 144 187 202 203 211 213 217 229 237 240 241 248 262 263 276 318 319 332 345 378 420 431 435 437 440 441 476 492 505 530 550 560 563 566 592 605 622 735 748 753 754 764 766 783 789 821 836 852 855 892 915 941 981 987 996 1082 1114 1206 1209 1228 1289 1300 1317 
18 33 45 54 70 123 124 133 135 146 147 152 166 172 174 181 204 221 230 271 287 301 302 325 406 407 429 430 447 449 450 455 502 687 693 722 770 792 823 858 867 880 912 921 961 998 1065 1083 1088 1093 1154 1168 1196 1244 1245 1249 1255 1261 1305 1312 1321 
1 5 13 20 69 75 82 83 110 111 195 200 250 285 288 304 307 308 340 347 374 375 396 397 398 414 419 473 474 508 511 540 541 556 569 570 581 595 619 643 644 652 688 710 728 795 980 1029 1044 1077 1170 1198 1226 1285 1325 
3 11 51 76 84 153 201 357 365 368 369 382 384 387 478 506 509 520 547 555 579 597 607 620 632 672 694 717 727 739 740 741 776 799 846 869 877 885 956 1024 1051 1059 1063 1078 1089 1146 1152 1157 1169 1183 1299 1343 
16 17 38 39 136 138 145 193 194 209 210 251 274 330 331 336 337 405 411 469 518 522 568 700 709 720 738 759 782 808 827 833 834 883 920 926 972 988 1018 1052 1099 1151 1184 1204 1235 1257 1280 1291 1327 1329 
19 61 62 95 117 122 134 179 253 291 292 312 426 427 470 553 557 562 572 590 646 658 669 673 701 742 745 765 778 845 856 866 874 876 896 922 931 938 990 1001 1007 1011 1043 1061 1100 1142 1307 1308 1330 1335 
65 106 139 176 184 188 216 224 239 260 313 348 353 512 602 611 637 674 767 788 937 1009 1010 1026 1027 1068 1069 1116 1130 1185 1191 1208 1270 1275 1295 1296 1297 1313 1322 1323 1339 1345 
14 15 109 115 116 267 326 501 565 567 593 596 608 612 639 699 743 785 826 911 913 968 1004 1025 1041 1070 1071 1090 1109 1203 1211 1230 1242 1259 1266 1286 1303 1309 1334 
8 77 258 316 317 334 372 445 479 532 631 684 703 746 755 839 840 844 853 862 868 935 963 1005 1034 1112 1161 1263 1269 1279 1298 
24 25 68 121 242 306 377 402 452 456 467 517 657 670 671 704 779 791 815 825 881 923 925 929 934 1022 1030 1049 1145 1214 1314 
32 52 125 126 219 269 290 293 294 400 434 442 443 495 613 640 697 713 971 992 1023 1048 1075 1115 1117 1156 1210 1253 1254 1267 1268 
55 162 163 189 265 289 305 322 362 403 418 453 538 708 719 763 768 769 818 820 910 917 918 939 945 1066 1179 1186 1190 1213 1274 
35 66 101 205 246 280 314 351 363 364 436 480 485 621 689 716 811 813 847 888 894 895 1006 1039 1097 1149 1182 1192 1201 1281 
30 42 49 50 64 218 234 261 309 350 413 415 457 588 724 810 812 842 978 1040 1086 1167 1187 1205 1224 1260 1315 
23 85 86 87 310 311 327 349 352 379 510 645 655 732 798 817 882 887 942 965 1031 1094 1195 1331 
151 534 677 678 772 777 828 873 949 950 1033 1046 1085 1092 1111 1153 1197 1202 1284 1292 1316 1340 1341 
2 9 21 97 98 207 249 279 423 439 448 454 901 944 1008 1015 1028 1032 1143 1252 
26 60 390 417 459 497 527 614 731 774 848 859 879 986 1080 1212 1221 1304 1318 
91 92 177 178 333 343 539 559 654 682 897 906 907 932 985 991 1045 1246 
28 29 159 231 232 465 507 679 680 734 927 1000 1019 1155 1164 1176 1288 
43 89 90 94 222 245 278 361 604 730 909 993 1081 1110 1140 1262 1311 
168 247 482 558 641 642 685 829 830 924 928 999 1036 1084 1121 1144 
79 235 493 574 580 850 851 863 902 1047 1073 1113 1133 1136 1278 
63 252 342 344 355 438 577 681 857 872 979 1037 1189 
422 586 587 831 837 838 955 1074 1217 1256 1283 1293 1338 
751 760 793 822 893 1181 1207 1218 1219 1222 1223 1248 1328 
131 180 190 256 286 498 549 582 747 807 1020 1159 
370 380 463 676 706 940 984 994 1193 1194 1264 1344 
37 78 303 367 544 609 610 661 662 989 1101 
156 157 185 576 758 878 1128 1165 1220 1287 
341 494 535 536 633 690 871 1148 1265 1301 
705 849 890 1060 1072 1166 1175 1229 1232 1350 
53 192 259 296 383 649 975 1038 1178 
118 323 339 416 583 696 721 977 
444 451 578 761 762 870 1276 
150 346 864 962 1118 1150 
175 321 489 546 771 819 
