48 56 57 105 127 128 137 170 171 191 233 264 393 398 446 460 477 486 487 512 542 564 571 616 623 624 656 691 692 715 775 809 867 966 969 1107 1108 1124 1135 1177 1234 1241 1272 1290 1302 1306 
10 44 97 100 131 155 160 161 215 237 243 265 432 461 515 543 552 608 618 683 737 756 784 790 802 818 897 916 932 933 952 954 976 983 1053 1064 1091 1122 1123 1141 1147 1200 1233 1320 1349 
8 72 93 144 202 211 248 263 318 319 378 420 435 476 509 510 558 563 566 602 739 766 783 799 821 855 915 987 1031 1082 1194 1289 1299 1343 
14 15 109 115 267 326 565 596 611 646 647 699 743 826 868 913 968 1004 1025 1090 1109 1112 1134 1230 1236 1242 1259 1263 1303 1326 1335 
0 1 12 22 34 36 129 130 208 212 220 272 360 381 421 475 573 606 627 674 726 803 891 957 1238 1239 1240 1332 
6 148 149 180 190 376 401 503 585 607 686 749 781 875 899 1106 1247 1273 1348 
18 47 123 152 221 295 358 359 407 425 447 462 485 523 665 794 862 946 1021 
20 31 46 189 275 409 428 511 528 539 634 718 839 840 935 943 953 970 1325 
347 396 397 530 556 561 569 578 581 582 688 707 710 980 1050 1159 1211 1317 
24 43 242 277 345 426 452 517 590 658 669 778 845 856 936 1142 
4 33 45 70 254 301 302 483 622 747 763 829 892 1105 1312 
5 75 82 83 111 132 285 307 375 595 625 652 795 1044 1077 
11 547 555 694 740 741 854 1059 1078 1145 1152 1157 1184 
32 38 405 522 713 919 1018 1052 1062 1115 1254 1278 1280 
126 268 290 293 294 434 495 640 697 941 971 1117 1210 
182 186 209 298 370 371 636 638 698 782 984 1104 1342 
299 300 328 537 600 601 729 814 903 1016 1057 1215 1319 
91 92 343 559 654 682 906 907 1045 1099 1246 
103 104 156 196 197 472 727 904 905 951 992 
214 392 451 589 594 615 800 967 1042 1103 1276 
21 98 279 453 454 901 910 944 1028 1143 
40 412 471 584 994 1054 1081 1149 1193 1260 
49 50 261 350 413 588 810 812 842 1086 
140 141 238 496 501 534 567 785 960 1041 
7 58 73 74 329 484 545 865 900 
16 78 138 274 661 662 989 1101 1235 
52 68 670 815 1022 1023 1048 1206 1214 
88 236 468 617 663 736 861 1137 1138 
99 628 629 711 712 805 806 1158 1336 
117 121 253 372 445 755 931 1005 1034 
153 201 210 491 869 1051 1056 1063 1258 
183 262 373 374 519 702 926 1074 1096 
184 239 709 767 1069 1130 1204 1277 1345 
188 224 260 313 437 771 1068 1208 1275 
198 199 270 297 335 533 958 959 973 
3 325 591 780 1001 1035 1173 1183 
27 288 354 458 474 676 748 773 
66 280 504 847 888 898 1097 1192 
106 110 145 175 176 348 914 1270 
107 108 167 203 389 531 667 733 
185 666 822 964 1161 1199 1222 1248 
244 366 388 406 410 599 836 986 
482 641 642 830 924 928 1084 1144 
769 917 918 939 1179 1190 1274 1284 
23 85 86 744 942 1195 1300 
26 67 459 497 848 859 1304 
54 147 166 880 1065 1083 1093 
76 369 513 807 1020 1202 1265 
87 327 349 352 798 1094 1331 
113 114 282 322 525 653 752 
133 849 1166 1175 1229 1232 1350 
134 304 342 427 619 742 1198 
193 377 402 621 1030 1049 1156 
312 521 690 789 1014 1055 1163 
368 382 387 520 846 1024 1089 
679 680 1155 1164 1165 1288 1305 
60 163 332 390 417 527 
61 62 701 1100 1196 1330 
89 90 222 278 1140 1311 
95 151 450 772 1111 1255 
120 816 1160 1171 1244 1245 
154 225 226 386 1003 1169 
158 394 395 400 889 1079 
165 516 695 832 908 1162 
177 178 788 1076 1237 1295 
206 207 499 714 797 947 
229 283 529 664 922 930 
246 681 811 857 1182 1281 
258 498 549 684 1279 1298 
317 334 631 703 746 844 
336 337 411 759 887 1329 
341 535 536 871 1148 1301 
384 478 579 632 1114 1256 
404 651 723 843 996 1013 
677 678 750 776 828 1346 
725 796 824 1119 1120 1201 
777 873 1033 1088 1153 1316 
1009 1010 1185 1191 1296 1297 
19 179 553 562 722 
30 978 1187 1205 1310 
35 351 660 1216 1354 
69 195 308 340 419 
79 235 574 580 1110 
84 672 876 877 1011 
101 314 480 770 813 
116 1071 1203 1266 1286 
118 645 884 885 977 
135 200 204 687 912 
162 418 538 708 820 
164 603 761 762 793 
172 271 429 693 961 
174 219 234 442 443 
187 276 560 754 852 
216 361 909 937 1282 
227 305 362 792 1261 
240 273 385 860 929 
310 311 655 882 965 
315 586 837 838 1283 
422 587 831 955 1338 
436 894 895 1006 1039 
441 592 753 1132 1197 
479 593 612 613 911 
550 949 950 981 1067 
827 998 1154 1167 1321 
833 834 1150 1151 1257 
851 863 1073 1113 1133 
2 514 819 1139 
17 39 469 470 
28 71 465 735 
29 927 1092 1176 
41 982 1102 1125 
42 64 218 457 
51 356 597 1146 
59 575 635 724 
63 872 1037 1189 
81 284 598 995 
94 440 604 1070 
96 231 507 1209 
112 169 1058 1294 
119 324 433 650 
139 1026 1027 1116 
146 250 287 1249 
157 576 878 1128 
217 232 734 1019 
249 643 644 728 
255 500 524 1351 
259 296 383 1038 
266 414 896 990 
289 403 945 1213 
320 526 801 1271 
330 331 518 920 
430 705 890 1072 
455 456 1040 1253 
568 731 774 1212 
758 1220 1221 1287 
874 886 1017 1131 
893 1181 1218 1219 
962 963 1047 1269 
13 252 438 
25 306 467 
53 192 975 
55 181 1186 
65 732 1029 
77 532 1293 
102 168 251 
136 473 557 
142 223 1347 
194 657 1231 
228 247 1036 
230 921 1168 
245 808 858 
256 286 1060 
257 338 548 
269 508 1075 
281 391 835 
292 464 1129 
303 355 367 
316 572 639 
321 489 546 
333 985 991 
339 416 696 
346 864 879 
357 551 648 
379 380 721 
399 974 1172 
423 439 1252 
424 506 956 
466 490 1333 
481 823 1098 
493 614 1136 
494 633 1012 
620 716 717 
668 841 902 
671 825 1314 
685 999 1121 
700 719 720 
706 1264 1344 
757 1002 1087 
765 1007 1061 
791 925 972 
853 1262 1292 
881 923 934 
1207 1223 1328 
1224 1225 1243 
