0 1 12 13 22 23 32 36 37 42 43 48 53 55 59 63 64 65 66 75 79 86 87 88 93 94 108 111 112 155 174 189 195 200 208 212 218 219 220 234 235 242 245 250 255 256 257 259 269 272 277 278 296 303 304 305 306 308 309 321 322 327 339 340 341 349 353 355 360 361 374 379 381 388 403 415 416 421 433 443 467 468 473 475 502 503 504 508 526 557 573 588 594 599 603 608 619 625 626 627 656 681 724 728 736 751 770 786 798 803 812 866 867 873 890 899 923 926 936 942 952 953 980 1061 1070 1081 1106 1136 1137 1138 1147 1159 1160 1167 1168 1187 1206 1213 1234 1247 1248 1270 1306 1310 1325 
6 7 25 29 34 35 40 58 67 73 74 76 80 81 83 84 85 113 115 123 132 142 147 148 157 168 169 177 190 285 291 307 314 315 328 329 366 382 384 398 401 402 408 412 424 457 458 466 484 488 489 516 519 531 545 546 547 574 584 585 586 593 607 612 613 629 649 660 663 667 668 686 688 700 745 775 779 788 791 792 807 832 837 838 843 844 846 865 875 883 888 900 911 948 986 994 1007 1024 1032 1041 1058 1085 1089 1094 1098 1100 1102 1109 1110 1111 1117 1118 1124 1139 1149 1193 1197 1202 1220 1221 1252 1260 1273 1283 1294 1315 1324 1332 1333 1354 
10 31 47 69 70 71 72 120 126 135 158 160 172 173 231 236 238 239 248 268 280 288 294 295 352 356 378 394 409 428 429 430 432 434 446 455 461 463 496 497 501 527 528 534 539 552 595 605 636 638 640 653 672 697 718 737 742 746 747 748 752 764 773 785 801 815 840 841 851 855 861 863 892 905 943 951 969 976 979 991 992 1008 1020 1021 1064 1073 1088 1096 1103 1141 1173 1186 1194 1210 1223 1233 
8 9 20 101 102 146 187 188 202 203 211 216 217 221 229 230 246 247 252 262 263 276 319 320 332 333 334 345 354 357 365 399 431 435 440 441 476 491 492 505 550 551 558 560 561 592 622 632 635 698 733 735 753 754 756 766 783 823 860 862 870 935 975 981 987 995 1029 1036 1038 1067 1087 1121 1129 1281 
11 44 117 118 119 129 140 167 182 207 292 316 317 372 391 392 395 404 445 447 448 464 481 499 500 570 589 615 621 666 683 714 726 755 760 790 797 800 804 822 849 889 916 946 947 964 965 988 1005 1034 1039 1042 1053 1054 1066 1079 1091 1123 1140 1181 1199 1200 1207 1216 1222 1271 
27 46 68 82 92 121 122 134 141 166 179 194 253 289 324 400 426 427 451 452 494 520 572 590 637 639 652 655 658 669 704 744 778 795 827 835 845 856 931 957 1044 1045 1211 1231 
2 3 21 105 106 109 110 176 223 224 233 260 261 347 348 393 419 420 437 512 571 597 634 715 771 809 819 901 915 974 1068 1083 1112 1142 1143 1183 1208 1275 1290 1302 1347 
4 5 26 30 33 45 97 98 130 133 152 161 180 243 244 254 271 279 301 302 453 454 485 498 577 598 606 687 693 802 818 820 891 910 932 944 985 1071 1238 1239 
38 39 49 50 60 181 185 186 370 373 405 444 479 532 587 659 671 782 810 919 1017 1019 1062 1074 1092 1099 1161 1217 1224 1225 1256 1278 1280 1293 1314 
14 15 267 513 565 596 647 805 806 868 906 907 913 968 1004 1025 1050 1090 1153 1158 1230 1242 1246 1263 1266 1276 1303 1326 1336 
127 128 136 137 170 171 191 192 264 265 460 477 478 486 487 542 564 616 623 624 691 692 710 721 1107 1108 1135 1241 
153 154 225 226 273 369 386 387 509 510 536 537 600 601 799 871 872 903 1003 1037 1056 1057 1148 1258 1265 1301 1319 
164 165 414 575 576 580 630 631 762 767 793 814 816 825 836 878 1012 1113 1133 1192 1244 1245 1261 1345 
77 144 145 175 201 209 210 281 282 343 344 569 591 645 898 914 1046 1051 1052 1063 1075 1097 1105 
258 293 318 338 350 367 383 540 548 549 582 583 602 604 609 696 869 893 940 978 1178 1189 1269 
515 524 555 567 568 657 739 740 741 854 886 956 977 1013 1059 1078 1152 1157 1236 1351 
16 99 100 159 275 326 358 359 425 462 471 523 665 757 794 927 1175 1176 1253 
61 62 266 646 651 826 876 877 896 990 1001 1011 1134 1203 1259 1286 1318 1330 1335 
103 104 156 196 197 251 472 541 676 703 705 706 727 904 922 982 1031 1060 1170 
17 162 163 389 390 410 417 418 538 707 708 719 720 763 850 945 1093 1291 
54 95 96 149 204 205 490 563 578 579 689 997 1002 1114 1146 1188 
91 213 214 336 397 474 556 581 610 713 1040 1295 1299 1328 1329 1344 
312 313 469 521 522 554 633 690 761 789 1014 1016 1055 1128 1163 1285 
215 310 311 325 362 438 439 459 562 654 699 848 882 894 1028 
206 249 514 643 644 732 811 857 1122 1145 1182 1198 1349 
364 411 614 731 808 864 879 880 962 1065 1082 1235 1287 
56 57 495 648 941 971 996 1177 1195 1243 1289 1300 
116 480 620 716 730 831 949 950 963 1015 1047 1228 
283 529 530 664 694 695 839 859 930 999 1035 1317 
107 284 290 413 423 525 628 712 717 1212 1348 
183 184 337 396 611 709 743 759 1069 1130 1204 
193 323 376 470 511 821 925 972 1030 1049 1072 
482 483 641 642 734 829 830 924 928 1084 1144 
51 52 227 228 442 895 1006 1022 1023 1048 
198 199 270 297 298 335 533 958 959 973 
24 684 685 729 929 1172 1215 1279 1298 
300 368 506 702 749 765 781 817 1321 
673 674 701 722 723 921 938 1043 1196 
41 675 774 961 1166 1229 1232 1350 
90 330 331 517 518 920 1018 1184 
124 750 828 998 1154 1169 1264 1346 
650 725 796 824 912 1119 1120 1201 
679 680 1155 1164 1165 1288 1305 1331 
18 19 299 553 559 566 787 
131 286 287 682 858 908 1249 
138 139 375 881 934 967 1171 
351 422 535 758 902 993 1240 
371 436 937 983 984 1104 1342 
769 939 1179 1190 1274 1284 1316 
78 661 662 970 989 1101 
450 1000 1086 1116 1156 1255 
738 772 833 834 1151 1257 
1009 1010 1185 1191 1296 1297 
28 465 960 1132 1282 
125 150 151 377 
240 241 274 385 
342 363 380 966 
449 1226 1227 1320 
617 618 1205 1272 
677 678 776 777 
711 842 1026 1027 
784 1076 1077 1237 
852 874 887 1131 
853 1033 1262 1292 
89 222 1311 
114 813 909 
178 954 1080 
232 507 1209 
237 897 933 
456 670 1214 
493 847 918 
768 917 1304 
780 1125 1162 
884 885 1277 
955 1327 1338 
1115 1254 1343 
1126 1127 1174 
1218 1219 1312 
