1 9 12 13 15 22 23 24 31 32 34 36 37 40 42 43 44 53 55 59 63 64 66 86 87 89 90 93 94 125 129 139 148 149 165 174 189 195 208 212 219 220 234 235 245 250 257 265 269 277 278 279 296 303 305 306 309 320 322 325 327 339 340 341 349 350 353 355 360 361 366 368 374 381 388 392 403 406 414 421 422 438 442 468 475 501 502 503 515 516 526 535 567 570 573 586 588 591 594 599 608 619 626 627 630 631 645 649 674 743 758 765 770 777 781 787 793 814 816 817 818 845 856 863 867 871 872 875 877 878 899 908 909 910 912 936 937 940 943 948 953 955 970 979 997 998 1008 1011 1023 1024 1026 1027 1029 1032 1037 1071 1078 1106 1116 1125 1147 1148 1154 1162 1172 1187 1205 1213 1217 1220 1247 1252 1260 1266 1271 1273 1301 1307 1308 1309 1332 1334 1348 
4 7 10 11 26 30 33 48 56 57 73 97 115 126 133 158 161 162 172 173 180 191 206 207 237 243 244 271 288 294 301 302 334 352 354 357 390 393 395 396 397 404 407 410 418 429 436 447 448 453 454 458 460 461 474 485 500 539 542 551 556 578 579 581 582 598 600 614 624 648 651 656 657 666 687 693 694 704 707 714 715 721 723 728 742 748 768 773 778 779 784 796 797 802 803 809 820 824 841 850 851 855 889 897 932 933 944 945 947 965 969 985 996 1020 1028 1055 1073 1077 1112 1119 1120 1124 1128 1135 1136 1145 1159 1165 1177 1195 1207 1223 1233 1234 1256 1288 1290 1291 1302 1306 1310 1315 1320 1328 
3 25 41 67 76 79 91 98 101 102 113 114 156 157 168 202 213 214 215 242 251 252 276 280 282 293 299 310 311 328 369 382 384 385 433 435 443 459 463 467 478 493 494 495 504 508 521 522 525 536 537 544 552 558 561 562 574 580 602 603 610 620 629 632 640 654 655 677 678 690 691 697 729 744 749 756 760 774 776 799 801 807 836 843 846 847 853 854 859 869 883 888 898 904 967 971 982 1012 1036 1038 1058 1059 1066 1081 1085 1088 1089 1097 1117 1192 1202 1211 1214 1221 1262 1265 1281 1287 1292 1317 1319 
20 47 52 54 65 70 80 88 112 118 119 124 130 135 147 152 155 169 194 204 226 239 249 254 263 286 295 298 321 323 326 359 370 379 380 394 425 462 471 476 482 483 523 589 615 636 641 642 644 665 681 699 711 732 737 757 764 767 794 795 798 800 804 808 811 812 825 827 830 848 857 858 864 879 880 893 924 928 946 949 951 958 980 984 1000 1004 1014 1021 1054 1065 1067 1069 1079 1082 1083 1084 1093 1094 1104 1105 1110 1114 1133 1144 1176 1181 1182 1189 1218 1219 1239 1277 1305 1312 1325 1345 
17 27 29 39 49 60 100 117 121 127 128 137 163 171 181 182 185 186 192 193 223 253 264 281 290 312 316 331 332 333 345 372 383 405 411 417 444 445 452 469 470 472 480 486 511 524 543 547 553 564 568 572 587 590 605 616 623 639 658 671 673 683 692 696 722 731 755 762 789 822 849 870 887 916 931 938 941 972 975 991 1005 1016 1034 1049 1053 1072 1074 1107 1108 1123 1156 1163 1179 1186 1200 1212 1229 1300 1318 1347 1351 
2 21 72 103 144 150 170 205 230 248 314 317 318 363 376 377 426 451 497 507 530 540 541 555 563 566 606 607 668 689 705 706 708 710 725 739 740 761 833 834 866 882 894 895 901 914 915 987 994 1031 1046 1115 1118 1142 1143 1150 1151 1157 1166 1168 1170 1175 1183 1184 1194 1201 1226 1232 1238 1241 1254 1257 1276 1285 1289 1299 1327 1338 1343 1350 
5 16 75 81 82 83 96 111 131 132 138 159 218 255 256 259 262 285 292 304 307 308 342 347 362 375 430 439 457 464 477 488 489 529 569 575 576 595 601 625 635 664 669 670 676 688 736 772 780 792 821 890 926 930 966 993 995 1033 1035 1041 1060 1100 1102 1111 1129 1131 1138 1206 1209 1222 1244 1245 1248 1261 1272 
8 14 46 141 160 211 238 267 268 275 289 364 399 402 409 416 420 428 434 455 456 505 513 527 528 534 545 565 634 646 647 653 672 712 718 741 785 791 805 806 823 839 840 862 868 874 913 919 923 925 935 968 1017 1022 1025 1030 1040 1050 1064 1090 1096 1134 1149 1158 1227 1228 1230 1240 1242 1246 1263 1303 1326 1335 1336 
18 51 58 95 109 151 178 200 221 227 228 247 315 329 365 401 408 431 432 450 484 487 546 571 596 597 643 659 667 701 703 713 745 788 790 826 837 838 865 905 921 961 964 983 1006 1043 1076 1087 1095 1098 1109 1113 1139 1146 1161 1180 1196 1199 1237 1249 1255 1283 1295 1342 
28 50 61 62 71 74 123 134 183 184 196 373 449 465 479 554 592 593 612 613 660 680 727 735 769 873 876 881 896 911 927 939 976 990 1001 1002 1042 1061 1092 1130 1132 1153 1164 1171 1178 1190 1197 1198 1216 1231 1253 1259 1267 1268 1274 1284 1286 1314 1316 1330 1331 1340 1341 1354 
0 19 68 69 104 122 140 146 164 166 167 179 190 236 258 272 287 324 338 343 356 358 367 371 391 400 415 423 427 440 498 499 520 548 549 557 583 584 604 609 650 652 663 682 698 726 786 835 906 907 957 978 1007 1039 1044 1045 1122 1141 1349 
38 106 110 145 175 176 188 222 224 233 260 313 330 348 419 437 512 514 517 518 637 684 685 771 819 829 884 885 920 952 974 977 988 999 1018 1052 1068 1091 1121 1140 1208 1215 1270 1275 1280 1298 1311 1313 1322 1323 1339 
45 120 217 231 232 240 241 261 273 378 413 446 492 496 622 633 638 679 724 734 746 747 752 763 810 815 842 891 892 917 918 929 992 1013 1019 1048 1062 1070 1086 1152 1155 1160 1167 1173 1193 1210 1224 1225 1243 1304 
92 105 107 108 116 187 203 266 284 291 336 337 346 389 398 466 490 550 559 611 700 709 717 719 720 733 754 759 775 844 860 960 981 986 1080 1099 1137 1203 1204 1236 1278 1279 1282 1329 1333 
84 85 99 136 177 198 199 201 210 270 297 300 335 412 424 473 506 519 531 533 585 617 618 628 686 702 861 942 956 959 962 963 973 1047 1063 1075 1269 1294 1321 
6 35 197 209 216 229 246 283 351 441 621 695 716 730 753 782 813 831 832 900 902 903 922 950 954 1015 1057 1103 1169 1188 1324 
153 154 225 319 386 387 491 509 510 560 750 766 783 828 852 886 934 1003 1051 1056 1258 1264 1344 1346 
77 78 142 143 274 344 481 532 538 577 661 662 675 738 751 989 1101 1235 1293 1337 
1009 1010 1185 1191 1296 1297 
