1 13 15 23 34 40 42 43 53 63 66 79 82 83 86 87 89 93 94 111 148 153 174 195 224 235 250 255 257 258 269 277 278 285 296 303 306 307 308 309 320 339 340 347 349 353 354 374 375 388 392 394 403 406 414 421 422 430 467 468 501 503 516 588 594 599 619 631 649 688 736 758 765 781 845 867 871 872 875 877 909 936 955 997 1029 1037 1106 1125 1162 1178 1187 1193 1198 1260 1266 1273 1301 1307 1308 1332 1348 
12 22 31 32 36 37 44 55 59 64 149 178 189 208 212 220 234 238 305 322 325 327 341 355 360 361 362 381 438 502 514 515 526 535 573 608 626 627 743 770 787 793 899 943 948 953 970 998 1024 1066 1147 1148 1154 1213 1247 1265 1271 
80 98 101 215 252 286 310 311 345 382 435 439 459 476 493 494 552 558 561 562 572 590 654 655 658 744 756 774 856 866 894 931 967 979 991 1007 1036 1085 1217 1281 
48 56 103 162 191 219 393 407 460 542 600 624 648 656 673 715 723 742 803 809 890 969 996 1060 1079 1124 1135 1170 1177 1223 1233 1234 1290 1302 1306 1328 
0 68 104 146 287 293 338 356 358 367 383 440 498 548 549 557 582 583 604 609 640 893 971 978 1039 1133 1145 1159 
19 118 122 140 164 166 167 179 324 391 395 400 423 427 470 485 499 520 652 726 800 835 889 906 907 957 1044 1045 
7 26 30 110 126 158 172 173 294 334 429 436 474 579 598 687 693 820 951 985 992 1020 1073 1205 1243 1256 
14 107 187 203 332 336 337 396 525 550 565 603 611 709 733 754 759 913 981 1204 1236 1329 
16 119 132 218 245 350 415 457 475 488 489 625 635 779 780 861 1033 1035 1041 1071 1118 1172 
57 237 248 272 317 318 389 426 437 445 530 566 710 817 915 987 1034 1142 1194 1241 1310 
20 65 70 88 124 155 263 379 380 589 711 712 732 804 825 980 984 1094 1158 1325 
75 76 81 128 137 171 284 357 464 477 478 486 564 616 623 632 692 1107 1108 1129 
84 85 201 300 412 473 506 531 617 618 702 942 962 963 1047 1075 1269 1294 1321 
46 141 231 268 275 409 425 428 434 527 528 539 545 634 718 839 840 1096 
28 61 62 96 465 646 874 876 896 990 1001 1011 1100 1209 1286 1330 
129 130 254 482 483 641 642 829 830 924 928 1084 1105 1144 1239 
25 91 213 214 328 536 537 610 684 685 729 1215 1298 1319 
45 120 378 446 496 622 746 752 763 815 1062 1160 1173 1210 
3 299 369 384 385 650 749 750 843 883 1088 1089 1346 
33 133 180 288 301 302 368 461 577 802 841 983 1175 
106 109 176 188 260 348 419 512 974 1068 1208 1270 1275 
29 186 217 444 534 671 734 810 927 1019 1086 1304 
47 147 298 471 676 798 808 879 880 1065 1082 1083 
139 295 370 636 639 699 764 937 1026 1028 1104 1116 
2 90 175 233 321 330 517 518 819 920 1018 
160 323 402 456 505 653 785 923 925 1030 1049 
312 313 469 511 521 690 789 938 941 1289 1300 
51 221 227 228 961 1006 1048 1087 1146 1199 
54 249 644 681 811 812 848 857 1182 1189 
113 114 458 760 960 1132 1197 1222 1248 1282 
152 523 665 757 794 946 1181 1218 1219 1312 
154 225 386 730 950 1003 1015 1056 1057 1169 
211 216 229 253 262 283 441 753 1054 1103 
11 206 207 222 279 448 500 694 947 
58 200 329 484 667 703 745 1139 1237 
77 78 142 661 662 738 989 1101 1293 
99 177 424 519 585 607 663 686 959 
115 868 1004 1112 1134 1246 1259 1263 1336 
135 204 570 581 601 615 1114 1168 1305 
181 185 524 683 696 755 849 1229 1351 
281 282 326 591 638 737 914 1023 1046 
509 510 739 799 828 1115 1254 1299 1343 
21 451 761 901 1143 1166 1183 1276 
105 116 398 466 490 775 1203 1333 
127 629 801 807 869 898 1038 1202 
183 184 373 660 1092 1130 1216 1354 
261 413 495 724 842 1027 1070 1167 
364 399 420 513 1064 1149 1227 1240 
417 418 704 707 932 933 945 1186 
529 645 664 930 952 977 999 1091 
620 621 695 716 717 831 832 1228 
18 546 713 714 788 1098 1295 
69 190 256 682 786 908 1220 
102 740 854 956 1059 1078 1157 
198 199 270 297 335 533 973 
236 371 698 1122 1141 1342 1349 
240 241 273 492 929 1013 1152 
387 776 846 847 888 1097 1192 
453 768 769 939 1190 1274 1284 
463 680 691 697 1117 1253 1331 
705 706 882 886 887 1031 1131 
860 862 873 881 976 1153 1316 
27 60 100 271 747 778 
73 266 404 651 1055 1077 
97 244 410 454 944 1032 
108 259 352 532 784 1315 
267 968 1025 1090 1230 1303 
280 433 853 859 1292 1317 
443 574 767 1110 1311 1345 
1009 1010 1185 1191 1296 1297 
38 145 210 1052 1063 
41 522 904 1021 1214 
197 540 541 1226 1285 
239 602 958 1069 1277 
290 331 605 975 1005 
346 792 1244 1245 1261 
408 431 432 701 905 
491 560 783 852 934 
567 677 678 777 912 
647 805 806 1326 1335 
833 834 1150 1151 1257 
9 125 319 766 
24 657 1232 1350 
35 314 689 895 
39 223 1072 1347 
71 72 497 748 
74 123 727 1002 
112 169 226 1067 
136 193 972 1074 
159 342 926 1138 
165 442 814 816 
192 411 568 700 
205 1201 1327 1338 
242 508 544 1211 
264 265 818 910 
274 1155 1235 1288 
333 472 547 1179 
343 344 481 751 
351 954 988 1076 
365 659 1051 1161 
372 551 666 965 
397 728 773 1136 
401 674 921 964 
543 1053 1123 1200 
571 596 597 1242 
593 612 791 911 
796 824 1119 1120 
855 1128 1164 1165 
891 892 1224 1225 
902 903 935 1258 
5 595 827 
6 246 813 
8 289 1022 
10 366 504 
17 243 1291 
92 559 1099 
95 151 1255 
117 553 722 
134 735 1231 
138 670 1184 
144 563 606 
156 157 982 
161 897 1320 
168 202 1058 
196 554 1042 
209 247 900 
232 633 679 
304 821 1272 
315 643 790 
359 966 993 
376 377 584 
390 447 556 
405 822 1016 
416 721 823 
449 592 1061 
450 1043 1196 
455 741 1040 
479 613 1171 
507 555 1238 
576 772 1111 
580 1278 1279 
637 1121 1140 
669 995 1102 
731 916 1212 
797 850 851 
837 838 1283 
919 1017 1280 
1000 1014 1176 
