6 7 25 28 29 34 35 40 58 67 73 74 76 80 83 84 85 113 115 123 132 142 147 148 157 168 169 177 190 285 291 307 314 315 328 329 366 375 382 384 398 401 402 408 412 424 457 458 465 466 484 488 489 515 516 519 524 531 545 546 547 555 567 568 584 585 586 593 606 607 612 613 629 649 660 663 667 668 686 688 700 739 740 741 745 760 775 779 780 788 791 792 807 832 836 837 838 843 844 846 854 865 875 883 885 900 911 948 956 986 994 1007 1013 1024 1032 1041 1058 1059 1078 1081 1085 1088 1089 1094 1100 1102 1109 1111 1117 1118 1124 1125 1132 1139 1152 1157 1162 1193 1197 1202 1220 1221 1222 1252 1260 1273 1282 1283 1294 1315 1332 1333 1351 1354 
0 1 12 13 22 23 32 36 37 42 43 48 53 55 59 63 64 65 66 75 79 86 87 88 93 94 108 111 112 155 174 189 195 200 205 208 212 218 219 220 234 235 242 245 250 255 256 257 259 269 272 277 278 296 303 304 305 306 308 309 321 322 327 339 340 341 349 353 355 360 361 374 379 381 388 403 415 416 421 433 443 467 468 473 475 502 503 504 508 526 573 588 594 599 603 608 619 625 626 627 656 681 724 728 736 751 770 786 798 803 812 866 867 873 890 899 926 936 942 952 953 980 1061 1070 1106 1136 1137 1138 1147 1159 1160 1167 1168 1187 1206 1213 1234 1247 1248 1270 1306 1325 
10 16 31 47 56 57 69 99 100 103 104 120 125 126 135 156 158 159 160 172 173 196 197 236 237 248 251 268 275 280 288 294 295 326 352 358 359 378 394 409 410 425 428 429 430 434 442 456 461 462 463 471 495 523 527 528 534 539 541 595 636 638 640 648 665 683 697 703 718 727 737 742 757 794 840 841 851 861 863 897 904 905 922 927 933 941 943 951 969 971 976 982 992 996 1008 1020 1021 1031 1064 1073 1096 1103 1141 1177 1194 1216 1223 1243 
8 9 20 101 102 124 146 187 188 202 203 211 216 217 221 229 230 246 247 252 262 263 276 319 320 332 333 334 345 354 357 365 399 431 435 440 441 476 491 492 505 550 551 558 560 561 592 622 632 635 698 733 735 753 754 756 766 783 823 860 862 870 923 935 975 981 987 995 1029 1036 1038 1067 1087 1121 1129 1281 
4 27 30 46 68 82 107 121 122 134 141 166 179 193 194 253 289 290 323 324 376 400 423 426 427 451 452 464 470 494 511 520 525 572 590 628 637 639 652 655 658 669 704 712 744 778 795 821 835 845 856 925 931 957 972 1030 1044 1045 1049 1071 1072 1211 1231 1238 
11 44 118 119 131 140 167 207 391 392 395 448 481 499 500 570 589 615 618 621 666 689 714 726 790 797 800 804 889 895 916 946 947 988 1006 1039 1042 1053 1079 1091 1123 1140 1200 1271 
5 26 33 45 97 98 130 133 152 161 180 243 244 254 271 279 301 302 453 454 485 498 577 598 687 693 802 818 820 891 910 932 944 985 1239 
127 128 136 137 170 171 191 192 223 264 265 460 477 478 486 487 542 564 616 623 624 691 692 710 721 1068 1083 1107 1108 1112 1135 1241 1290 1302 1347 
258 287 293 318 338 350 356 367 383 540 548 549 557 582 583 602 604 609 696 713 869 881 893 940 978 1098 1115 1178 1254 1269 1295 1299 1310 1343 1344 
2 3 21 105 106 109 110 176 224 233 260 261 347 348 393 419 420 437 512 571 597 634 715 771 809 819 901 915 974 1142 1143 1183 1208 1275 
38 39 49 50 370 373 404 405 444 532 574 659 671 810 919 960 1017 1019 1062 1092 1099 1110 1176 1224 1225 1278 1280 1304 1314 
70 71 72 238 239 446 496 497 501 552 605 653 672 748 785 801 855 892 979 991 1175 1195 1217 1289 1300 
77 144 145 175 201 209 210 281 282 343 344 569 591 898 914 1046 1050 1051 1052 1063 1075 1097 1105 1293 
164 165 292 414 575 576 580 630 631 767 814 816 825 878 1012 1055 1113 1133 1192 1244 1245 1261 1345 
17 162 163 389 390 417 418 538 707 708 719 720 763 850 945 1093 1186 1291 
60 181 182 185 186 479 587 782 822 964 965 1054 1074 1161 1181 1199 1207 
54 95 96 129 149 204 490 563 578 579 997 1002 1114 1146 1256 
61 62 266 651 876 877 896 990 1001 1011 1203 1259 1286 1318 1330 
206 249 514 643 644 732 811 848 857 1122 1145 1182 1189 1198 1349 
346 364 411 614 731 808 864 879 880 962 1065 1082 1150 1235 1287 
153 154 225 226 369 386 387 600 903 1003 1056 1057 1148 1258 
312 313 469 521 522 554 633 690 789 1014 1016 1128 1163 1285 
15 267 396 565 743 968 1025 1090 1153 1230 1236 1242 1303 
91 92 213 214 336 397 474 556 581 610 1040 1328 1329 
215 310 311 325 362 438 439 459 562 654 882 894 1028 
116 480 620 716 730 831 949 950 963 1015 1047 1228 
283 529 530 664 694 695 839 859 930 999 1035 1317 
536 537 601 827 871 872 998 1154 1169 1301 1319 1321 
300 368 506 702 749 765 781 817 1264 1307 1308 
432 673 674 701 705 722 723 921 938 1043 1196 
482 483 641 642 734 829 830 924 928 1084 1144 
646 805 806 826 868 906 907 1158 1246 1263 1336 
198 199 270 297 298 335 533 958 959 973 
78 493 661 662 847 918 970 989 1101 
117 316 317 372 445 755 1005 1034 1066 
183 184 337 611 709 759 1069 1130 1204 
768 769 917 939 1179 1190 1274 1284 1316 
24 684 685 729 1172 1215 1279 1298 
41 675 774 961 1166 1229 1232 1350 
81 284 657 852 874 886 887 1131 
90 330 331 517 518 920 1018 1184 
650 725 796 824 912 1119 1120 1201 
679 680 1155 1164 1165 1288 1305 1331 
18 19 299 553 559 566 787 
51 52 227 228 1022 1023 1048 
351 422 535 758 902 993 1240 
677 678 750 776 777 828 1346 
746 747 752 773 815 1173 1210 
14 513 596 913 1004 1335 
138 139 934 967 1171 1185 
240 241 273 274 385 929 
371 436 447 984 1104 1342 
406 407 617 983 1205 1272 
450 1000 1086 1116 1156 1255 
472 676 706 1060 1170 1233 
738 772 833 834 1151 1257 
286 682 858 908 1249 
647 1134 1266 1276 1326 
1009 1010 1191 1296 1297 
178 954 1080 1237 
231 232 507 1209 
342 363 380 966 
413 717 1212 1348 
449 1226 1227 1320 
455 670 1214 1253 
645 884 977 1277 
699 764 849 937 
711 842 1026 1027 
853 1033 1262 1292 
89 222 1311 
114 813 909 
150 151 377 
509 510 799 
761 762 793 
784 1076 1077 
955 1327 1338 
1126 1127 1174 
1218 1219 1312 
