0 1 6 12 22 34 36 40 65 76 88 119 148 165 169 208 220 227 239 291 292 324 360 376 381 382 401 412 421 433 464 475 503 513 516 526 570 573 585 593 600 607 627 630 663 686 695 749 781 792 814 816 832 854 875 878 908 956 957 988 994 1011 1029 1058 1059 1078 1081 1106 1129 1149 1157 1162 1193 1202 1240 1244 1245 1260 1261 1273 1277 1294 1332 1348 
10 44 46 100 149 160 161 215 237 243 265 275 295 301 358 359 394 395 425 432 461 462 471 523 539 541 543 552 608 618 665 674 683 784 794 802 818 889 897 916 932 933 952 954 976 983 1021 1043 1053 1064 1091 1122 1123 1141 1147 1196 1200 1231 1320 1349 
48 56 57 105 127 128 137 167 170 171 191 233 264 393 398 460 477 486 487 530 542 564 571 616 623 624 656 691 692 715 775 809 966 969 1079 1107 1108 1124 1135 1177 1234 1241 1272 1290 1302 1306 1317 
5 75 81 82 83 111 138 155 256 259 285 347 362 396 397 473 474 556 561 569 578 581 582 595 652 676 688 707 710 748 795 995 1038 1050 1060 1077 1131 1159 1206 1211 
54 72 93 135 144 147 166 230 248 318 420 431 476 566 602 687 764 817 855 880 912 915 987 1031 1065 1082 1083 1093 1168 1194 1252 1289 1305 
24 43 136 242 245 277 345 426 452 517 572 590 658 669 684 704 778 779 845 856 931 936 1142 1172 1215 1298 
9 124 203 211 217 229 262 319 320 332 365 435 440 441 502 550 560 659 753 754 756 766 783 981 
4 33 45 70 120 254 302 378 446 454 622 747 763 892 944 1105 1160 1171 1312 
109 115 596 646 647 805 806 826 868 1112 1134 1158 1259 1263 1326 1335 1336 
182 185 186 209 298 371 636 666 698 782 964 984 1054 1104 1199 1342 
13 20 21 112 195 200 204 205 255 349 409 511 901 1143 1325 
14 15 267 326 565 611 743 913 968 1025 1090 1230 1236 1242 1303 
125 126 290 293 294 400 434 495 640 697 941 971 1023 1117 
299 328 537 601 729 750 903 1014 1016 1055 1057 1264 1319 1346 
32 232 405 613 679 713 919 1018 1062 1115 1254 1278 
91 92 343 559 654 682 774 906 907 1045 1099 1246 
176 188 224 260 313 437 512 771 974 1068 1208 1275 
214 392 451 589 594 615 761 800 967 1042 1103 1276 
453 768 769 910 917 918 939 1066 1179 1190 1274 1284 
107 108 164 284 389 525 531 603 667 733 762 
8 428 528 718 839 840 862 935 943 1247 
154 225 226 369 386 1003 1056 1169 1258 1265 
482 483 641 642 829 830 924 928 1084 1144 
509 510 677 678 739 776 799 828 1299 1343 
7 58 73 74 329 484 545 865 900 
17 39 193 194 469 470 1049 1156 1225 
18 123 152 221 406 407 447 485 946 
27 118 458 645 726 773 884 885 977 
116 266 896 990 1070 1071 1203 1266 1286 
156 196 197 727 905 951 992 1048 1243 
198 199 270 297 335 533 958 959 973 
3 325 591 780 1001 1035 1173 1183 
41 103 104 472 904 982 1102 1125 
53 261 413 620 716 717 810 842 
66 280 504 847 888 898 1097 1192 
78 493 614 661 662 989 1101 1136 
150 346 833 834 1118 1150 1151 1257 
162 163 181 418 538 708 820 1186 
172 271 429 638 693 737 851 1073 
317 334 631 703 746 844 961 1044 
11 547 694 741 767 1145 1345 
26 67 459 497 848 859 1304 
49 50 350 479 588 812 1086 
89 90 222 278 1110 1140 1311 
113 114 202 282 322 653 752 
117 121 253 372 445 1005 1034 
132 305 307 354 375 488 625 
133 849 1166 1175 1229 1232 1350 
134 304 342 427 619 742 1198 
140 141 236 238 496 534 675 
153 201 210 491 869 1051 1063 
192 370 568 731 755 975 1212 
336 337 411 759 879 887 1329 
893 1181 1207 1218 1219 1223 1328 
23 85 86 942 1195 1300 
30 436 978 1187 1205 1310 
31 634 899 953 970 1271 
38 522 690 738 1052 1280 
59 212 575 635 724 803 
129 130 606 891 1238 1239 
146 250 287 808 858 1249 
177 178 788 1076 1237 1295 
240 241 273 274 492 929 
246 681 811 857 1182 1281 
310 311 655 882 965 1161 
315 586 790 837 838 1283 
374 519 702 926 1074 1096 
402 621 791 925 972 1030 
404 651 723 843 996 1013 
422 587 831 955 1293 1338 
468 500 515 524 1152 1351 
725 796 824 1119 1120 1201 
827 864 998 1154 1167 1321 
1009 1010 1185 1191 1296 1297 
19 179 553 562 722 
28 465 592 735 1132 
35 351 660 1216 1354 
42 64 218 309 457 
47 327 798 980 1094 
55 289 403 945 1213 
61 62 701 1100 1330 
68 670 815 1022 1214 
71 777 873 1153 1316 
94 272 650 1088 1089 
96 231 507 1209 1224 
99 628 629 711 712 
101 314 480 770 813 
174 219 234 442 443 
184 709 1069 1130 1204 
206 499 714 797 947 
283 529 664 922 930 
300 962 963 1047 1269 
368 387 520 846 1024 
377 657 881 923 934 
521 554 789 1163 1178 
535 536 871 1148 1301 
555 579 740 1184 1256 
617 736 861 1137 1138 
680 734 960 1019 1155 
765 1007 1061 1307 1308 
2 514 819 1139 
16 836 986 1235 
25 306 415 467 
29 927 1092 1176 
37 303 367 544 
60 390 417 527 
63 872 1037 1189 
69 308 340 419 
79 235 574 580 
84 672 876 877 
87 352 1315 1331 
95 151 1111 1255 
98 423 439 1028 
139 1026 1027 1116 
142 223 1067 1347 
157 576 772 1128 
180 190 424 506 
207 279 448 1015 
216 288 937 1282 
228 247 558 1036 
249 643 644 728 
269 508 914 1075 
330 331 518 920 
366 388 599 744 
379 380 721 732 
384 478 632 1114 
430 705 890 1072 
455 456 1040 1253 
501 567 785 1041 
612 911 1109 1197 
758 1220 1221 1287 
793 822 1222 1248 
853 1033 1262 1292 
863 1012 1113 1133 
894 895 1006 1039 
1164 1165 1279 1288 
51 597 1146 
52 949 950 
80 173 286 
97 158 356 
106 145 1270 
110 175 348 
187 276 852 
252 355 438 
257 338 548 
258 498 549 
263 563 821 
281 391 835 
296 383 557 
312 673 938 
321 489 546 
333 985 991 
339 416 696 
341 408 649 
357 551 648 
361 604 909 
399 505 1228 
414 463 940 
449 450 921 
466 490 1333 
540 1226 1227 
584 786 787 
668 841 902 
671 825 1314 
700 719 720 
757 1002 1087 
801 807 1020 
874 886 1017 
