0 6 22 34 36 40 67 80 81 88 119 148 165 169 173 208 212 220 227 255 272 277 283 284 315 324 356 360 376 381 388 401 412 421 433 464 475 503 513 516 526 573 585 599 600 627 650 663 666 686 695 749 781 790 803 832 875 908 936 957 964 1054 1058 1106 1125 1129 1162 1199 1240 1271 1273 1294 1332 1348 
4 10 44 47 100 149 155 160 161 215 238 243 275 295 358 359 394 395 432 461 462 466 471 490 491 514 523 543 618 665 683 756 784 794 802 889 916 933 952 954 976 995 1021 1053 1064 1076 1091 1122 1123 1141 1147 1200 1320 1333 1349 
48 56 105 127 128 137 170 171 191 233 264 393 408 446 460 477 486 487 542 564 571 616 623 624 656 691 692 715 775 809 898 966 969 1107 1108 1124 1135 1177 1234 1241 1272 1290 1302 1306 
1 5 13 20 69 75 83 110 111 195 250 285 304 307 308 340 347 396 397 414 419 473 474 511 541 556 569 570 581 595 619 643 644 652 688 710 728 795 980 1029 1198 1325 
57 93 96 202 237 248 318 378 420 437 476 530 566 783 789 855 915 941 987 996 1082 1206 1209 1289 1300 1317 
154 225 226 273 299 300 328 386 537 601 729 750 903 1003 1014 1016 1056 1057 1215 1258 1319 1346 
102 203 211 217 229 262 319 332 345 435 440 441 550 560 592 622 735 753 754 766 981 
14 15 115 267 326 565 596 639 699 743 913 968 1004 1025 1090 1230 1242 1259 1303 
52 125 126 290 293 294 400 434 442 495 640 697 971 992 1023 1048 1117 1210 1253 
141 236 268 425 428 496 528 552 675 718 801 884 943 1233 1247 1277 
134 253 426 427 470 572 590 658 669 742 778 845 856 931 1142 
317 334 372 445 479 631 703 746 755 844 868 1005 1034 1112 1263 
61 62 646 701 874 876 896 990 1001 1011 1100 1330 1335 
106 176 188 224 260 313 348 512 1068 1208 1270 1275 
18 123 152 174 221 406 407 447 867 912 1312 
33 133 172 301 302 429 430 687 693 961 1088 
38 145 210 522 738 833 834 988 1052 1151 1257 
129 130 591 606 638 854 891 1012 1173 1238 1239 
91 92 343 559 654 682 906 907 1045 1246 
135 146 204 230 287 325 858 1168 1249 1305 
214 228 392 531 589 594 800 967 1042 1062 
231 232 507 679 680 734 1019 1155 1164 1288 
368 387 506 520 620 717 776 846 1024 1169 
17 39 136 193 194 469 827 972 1291 
49 50 218 350 588 812 1040 1086 1260 
65 184 239 602 611 767 1069 1130 1345 
79 235 493 574 580 902 1047 1136 1278 
107 108 164 196 389 603 630 733 982 
162 163 418 538 708 719 763 820 1186 
206 499 500 714 796 797 946 947 1079 
453 768 769 917 918 939 1179 1190 1274 
2 9 21 207 249 279 901 1143 
7 73 74 329 484 545 865 900 
8 316 839 840 853 862 935 1161 
11 547 555 607 694 727 741 1152 
24 242 452 517 657 704 779 929 
31 46 140 634 899 953 970 1231 
97 98 423 439 454 944 1028 1032 
113 114 158 282 525 653 752 1139 
116 608 1070 1071 1203 1211 1266 1286 
124 502 722 792 1196 1244 1245 1261 
198 199 270 297 335 533 958 973 
336 337 411 568 709 759 1204 1329 
482 641 642 830 924 928 1084 1144 
628 629 711 712 805 806 1158 1336 
28 29 159 465 927 1000 1176 
54 147 166 880 1065 1083 1093 
63 342 681 857 872 1037 1189 
78 303 367 661 662 989 1101 
89 90 222 278 1110 1140 1311 
139 216 937 1026 1027 1116 1185 
182 725 824 1119 1120 1163 1225 
261 413 724 810 842 1167 1224 
266 404 651 723 843 1013 1055 
310 311 655 882 887 965 1031 
341 535 536 871 1148 1265 1301 
377 402 456 791 925 1030 1049 
515 524 886 1131 1236 1243 1351 
529 664 707 780 814 930 1035 
777 873 1033 1153 1284 1292 1316 
3 76 369 382 1089 1183 
26 459 497 848 859 1304 
32 613 713 1115 1156 1254 
68 670 815 1022 1145 1214 
99 183 373 519 702 1096 
103 104 197 472 904 905 
109 593 612 826 911 1109 
153 201 365 869 1051 1063 
247 558 685 829 999 1036 
258 684 963 1269 1279 1298 
259 296 383 649 1038 1178 
298 371 636 698 1104 1342 
327 349 379 732 798 1094 
333 539 897 932 985 991 
399 919 974 1017 1172 1227 
436 485 894 895 1006 1039 
468 617 736 861 1137 1138 
586 587 1074 1217 1256 1293 
740 885 956 1059 1078 1157 
849 1166 1175 1229 1232 1350 
850 851 863 1073 1113 1133 
16 251 274 405 1235 
23 85 86 942 1195 
42 64 234 309 457 
60 390 417 527 614 
117 291 292 922 1043 
120 320 816 1160 1171 
151 772 949 950 1111 
254 483 521 554 1105 
330 331 518 920 1018 
357 384 478 579 632 
509 739 799 1299 1343 
557 765 866 1007 1061 
751 893 1181 1218 1219 
1009 1010 1191 1296 1297 
19 179 553 562 
25 121 306 467 
30 978 1187 1205 
35 205 689 1201 
41 757 1002 1087 
43 94 730 993 
45 70 455 823 
58 667 983 1237 
59 504 575 635 
71 72 748 892 
87 352 645 1331 
101 314 480 813 
112 615 737 1103 
132 354 488 625 
142 223 1067 1347 
144 263 563 1114 
156 157 576 878 
187 276 836 852 
189 305 322 362 
219 269 443 1075 
244 366 410 744 
246 811 1182 1281 
252 355 438 979 
281 391 835 914 
289 403 945 1213 
339 416 696 721 
346 864 962 1150 
361 909 1081 1262 
370 380 676 984 
422 831 955 1338 
449 450 921 1255 
451 761 762 1276 
458 960 1132 1282 
498 549 582 1159 
501 567 785 1041 
534 1046 1085 1202 
540 1170 1226 1285 
647 1050 1134 1326 
659 660 1216 1354 
705 890 1060 1072 
731 774 879 1212 
770 998 1154 1321 
847 888 1097 1149 
986 1080 1221 1318 
27 726 773 
51 597 1146 
53 192 975 
66 280 1192 
82 398 1077 
84 672 877 
95 122 745 
131 256 286 
138 720 1184 
175 771 819 
180 190 747 
185 1128 1165 
186 385 860 
200 288 508 
209 782 808 
240 241 492 
257 338 548 
265 818 910 
312 673 938 
321 489 546 
351 621 716 
374 375 1044 
444 578 870 
463 940 994 
494 633 690 
584 786 787 
671 825 1314 
674 788 1295 
677 678 828 
706 1264 1344 
758 1220 1287 
760 1222 1248 
804 997 1310 
837 838 1283 
881 923 934 
1207 1223 1328 
