0 4 5 10 18 30 31 33 44 45 46 47 48 65 70 97 100 105 123 127 128 131 133 135 137 141 149 152 158 160 170 171 172 174 180 184 189 190 191 215 221 238 239 243 244 254 264 265 271 275 281 291 292 295 301 302 325 339 358 359 391 393 394 395 398 400 406 407 408 416 423 425 428 429 432 439 446 447 454 460 461 462 466 471 486 487 490 496 497 514 523 528 534 541 542 543 552 564 567 571 584 602 608 616 618 623 624 626 634 649 656 659 660 665 673 674 683 687 691 692 693 696 701 709 715 718 722 732 747 748 756 767 775 784 785 794 801 809 824 827 835 841 864 867 889 892 899 912 914 916 933 938 943 944 946 948 952 953 954 961 962 966 969 970 976 978 998 1008 1020 1021 1028 1029 1032 1043 1053 1064 1069 1079 1081 1091 1107 1108 1119 1120 1122 1123 1124 1130 1135 1141 1147 1154 1167 1177 1187 1196 1200 1204 1205 1211 1216 1233 1234 1241 1247 1252 1272 1277 1290 1302 1305 1306 1310 1312 1321 1333 1345 1349 1354 
1 6 7 12 22 24 25 34 36 40 58 66 67 73 74 88 119 121 148 150 154 165 169 208 212 220 225 226 227 242 277 280 299 300 306 314 315 321 324 328 329 346 374 376 381 386 387 388 401 412 421 433 464 467 475 477 484 489 491 503 513 516 517 519 526 537 545 546 570 573 585 586 599 600 601 627 630 671 684 686 695 700 702 704 719 720 729 749 765 779 781 790 792 803 814 825 832 837 838 865 875 888 900 903 908 926 957 988 1003 1014 1016 1055 1056 1057 1058 1074 1078 1095 1096 1097 1106 1118 1129 1149 1169 1180 1192 1215 1240 1258 1261 1271 1273 1283 1294 1307 1308 1314 1319 1332 1348 
41 80 85 86 102 103 104 107 108 113 114 156 164 167 168 173 182 186 196 197 198 202 206 214 228 240 251 257 258 266 270 273 282 286 297 298 322 335 338 341 371 385 389 392 404 409 451 472 494 498 499 525 531 533 535 536 548 550 551 558 561 589 594 603 615 636 648 651 653 667 668 698 699 714 723 725 733 737 744 752 757 761 762 796 797 800 802 807 843 860 871 902 904 905 929 942 947 951 958 959 963 967 973 982 983 984 996 1002 1013 1017 1042 1046 1047 1054 1085 1087 1103 1104 1139 1148 1188 1202 1222 1225 1269 1276 1279 1298 1301 1324 1342 
13 19 20 21 23 37 42 43 61 63 64 69 82 87 94 112 124 134 155 161 179 195 200 204 205 207 216 218 219 234 245 249 252 255 259 269 272 279 303 308 309 319 320 327 340 342 344 349 352 355 356 360 361 365 367 379 415 419 424 427 438 443 457 502 506 508 511 544 553 557 562 577 604 619 643 644 645 650 728 730 742 758 766 798 817 866 872 901 909 937 956 979 980 993 1007 1037 1038 1061 1075 1077 1094 1100 1143 1189 1195 1198 1201 1220 1221 1248 1282 1287 1300 1315 1320 1325 1331 
14 15 28 32 38 62 77 109 115 116 145 157 210 236 267 312 317 326 334 405 465 501 521 522 532 565 576 593 596 611 612 613 631 633 646 647 663 675 690 703 713 735 738 743 746 789 826 844 850 851 863 868 878 896 911 913 919 960 968 990 1001 1004 1018 1025 1041 1050 1052 1062 1063 1070 1071 1073 1090 1099 1105 1109 1112 1113 1115 1128 1133 1134 1163 1203 1230 1236 1242 1254 1259 1263 1266 1278 1280 1286 1303 1309 1326 1330 1334 1335 
8 9 29 35 177 178 203 211 217 229 231 232 237 262 283 333 351 399 435 440 441 455 482 492 505 507 529 539 592 622 641 642 664 679 680 734 753 783 788 823 830 839 840 853 862 897 922 924 927 928 930 932 935 974 981 985 991 1019 1076 1084 1092 1098 1132 1144 1155 1161 1164 1172 1176 1224 1227 1228 1237 1288 1295 
16 52 56 68 78 125 126 129 130 138 139 140 268 274 290 293 294 434 442 495 591 606 609 610 638 640 670 697 726 751 760 780 815 836 879 891 893 941 971 986 992 1009 1010 1012 1022 1023 1026 1027 1035 1048 1102 1116 1117 1125 1162 1173 1181 1185 1191 1207 1210 1214 1218 1219 1223 1235 1238 1239 1253 1267 1268 1296 1297 1328 
27 75 81 83 96 111 132 136 256 284 285 288 304 305 307 347 354 362 370 375 380 396 397 414 422 458 463 473 474 481 488 493 556 569 578 581 582 587 595 598 625 652 661 662 676 688 707 710 721 773 786 787 795 831 847 886 940 955 989 994 995 1044 1060 1101 1131 1136 1159 1209 1217 1293 1338 
54 57 72 93 101 144 147 151 166 187 246 248 263 276 318 363 364 378 420 431 436 476 480 485 530 540 560 563 566 621 681 689 754 764 770 772 811 813 821 852 855 857 880 894 895 915 949 950 987 1006 1039 1065 1082 1083 1093 1111 1170 1182 1206 1226 1255 1281 1285 1289 1317 
3 17 39 49 50 71 76 153 193 194 201 241 261 350 369 377 382 402 413 456 469 470 549 588 657 769 777 791 810 812 842 869 873 881 923 925 934 939 972 1030 1033 1040 1049 1051 1086 1088 1089 1153 1156 1183 1190 1197 1231 1260 1262 1265 1274 1284 1291 1292 1316 1340 1341 
26 53 55 60 91 92 98 162 163 181 192 213 289 296 332 343 383 390 403 417 418 444 452 459 527 538 554 559 568 605 614 654 682 708 731 763 774 820 848 859 870 906 907 917 918 945 975 1045 1080 1178 1186 1212 1213 1246 1304 1318 
11 51 84 357 368 384 478 479 509 510 520 547 555 579 597 607 620 632 672 677 678 694 716 717 727 739 740 741 750 776 799 828 833 834 846 854 874 876 877 1011 1024 1059 1114 1145 1146 1150 1151 1152 1157 1179 1256 1257 1299 1343 1346 
146 185 209 230 247 250 287 310 311 336 337 411 448 449 450 483 655 666 685 706 759 782 793 808 822 829 858 882 883 887 921 964 965 999 1015 1031 1036 1121 1165 1168 1199 1249 1264 1327 1329 1344 
89 90 99 120 199 222 278 468 500 515 524 617 628 629 711 712 736 805 806 816 849 861 1110 1137 1138 1140 1158 1160 1166 1171 1175 1193 1194 1229 1232 1243 1244 1245 1311 1336 1350 1351 
95 117 122 183 253 316 345 353 372 373 426 445 453 572 590 637 639 658 669 745 755 768 778 818 845 856 910 931 936 1005 1034 1066 1142 1322 1323 
59 79 118 142 143 159 223 235 323 366 410 430 504 574 575 580 583 635 705 724 804 884 885 890 898 977 997 1000 1067 1072 1337 1347 
2 106 110 175 176 188 224 233 260 313 330 331 348 437 512 518 771 819 920 1068 1184 1208 1270 1275 1313 1339 
