1 12 13 15 22 23 24 32 34 36 37 40 42 43 44 53 55 59 66 86 87 89 90 93 94 148 149 165 174 195 208 212 219 220 222 234 235 245 250 257 269 277 278 279 296 303 305 306 309 320 322 325 327 339 340 341 349 350 353 360 361 366 368 374 381 388 392 403 406 414 421 422 438 442 468 475 501 502 503 515 516 526 535 573 588 594 599 600 608 619 626 627 630 631 649 743 758 765 781 787 793 814 816 817 845 856 863 875 877 878 899 908 909 936 940 948 955 979 997 998 1008 1011 1024 1029 1032 1071 1106 1147 1148 1154 1172 1187 1217 1220 1244 1245 1252 1260 1266 1271 1273 1311 1332 1348 
7 16 75 79 81 82 83 111 115 119 126 132 138 180 218 255 256 259 285 288 307 308 347 352 354 362 375 390 396 397 457 458 474 488 489 556 569 578 580 581 582 595 601 625 669 676 688 704 707 721 728 736 748 773 779 784 792 886 945 951 995 1041 1060 1131 1136 1159 1261 
48 56 57 73 162 191 393 404 460 542 624 648 651 656 715 723 742 803 809 841 969 996 1055 1077 1100 1124 1135 1177 1233 1234 1241 1290 1302 1306 1310 
4 10 30 33 97 158 172 173 207 243 271 294 301 302 334 394 395 429 454 461 598 687 693 802 889 944 1020 1028 1073 1079 1195 
80 98 101 215 252 286 310 311 319 435 439 459 476 494 552 558 561 562 654 655 744 756 766 894 967 1036 1054 1085 1281 
106 110 175 176 188 224 233 260 313 330 348 419 437 512 514 517 518 771 819 920 974 1018 1068 1208 1270 1275 
19 118 122 140 164 166 167 179 324 343 391 400 423 427 499 520 652 726 800 835 906 907 957 1044 1045 
20 65 70 88 112 124 135 155 204 263 321 379 380 570 589 615 732 804 984 1114 1189 1305 1325 
0 68 69 104 146 190 287 338 367 440 498 548 549 583 604 609 682 786 978 
129 295 326 355 370 591 636 638 645 699 737 764 937 983 1004 1023 1104 1342 
45 130 378 446 496 622 746 747 752 763 815 891 892 1173 1210 1239 
248 317 318 530 540 566 710 915 987 1046 1170 1194 1289 
3 76 369 382 384 385 478 632 843 883 1088 1089 
84 85 201 412 473 506 531 702 942 956 1075 1321 
107 108 187 203 284 389 550 733 754 860 960 981 
280 433 504 525 602 603 853 859 1081 1262 1292 1317 
25 91 213 214 328 467 536 537 610 729 1319 
31 64 189 770 867 943 953 970 1205 1213 1247 
54 249 644 681 711 811 812 848 857 1158 1182 
128 137 171 264 486 564 616 623 692 1107 1108 
141 160 238 268 434 528 534 545 653 672 785 
2 21 49 451 761 762 901 1143 1183 1276 
58 95 200 329 484 667 703 745 1139 1237 
117 121 253 372 445 590 778 931 1005 1034 
127 181 182 186 666 683 755 822 849 1229 
152 358 359 407 425 462 523 665 757 794 
629 801 807 869 888 898 1038 1097 1192 1202 
11 206 448 500 694 714 946 947 1145 
14 336 337 565 611 759 913 1236 1329 
147 298 471 808 879 880 1065 1082 1083 
51 221 227 961 1006 1087 1146 1199 
136 193 376 377 607 972 1074 1156 
211 216 229 283 441 753 922 1103 
293 463 495 640 691 697 971 1117 
364 399 420 513 1064 1149 1227 1240 
401 450 673 674 921 964 1043 1196 
482 641 642 830 924 928 1084 1144 
8 505 839 840 862 935 1228 
18 178 546 713 788 1098 1295 
41 103 197 904 982 1021 1214 
46 275 409 527 718 923 1096 
177 424 519 585 668 686 959 
205 314 689 866 1201 1327 1338 
236 371 663 698 1122 1141 1349 
27 60 100 163 332 417 
63 871 872 1037 1265 1301 
72 497 1166 1175 1232 1350 
198 270 297 335 533 973 
237 418 539 897 932 933 
239 767 958 1069 1277 1345 
261 413 724 842 1070 1167 
267 968 1025 1090 1230 1303 
272 356 415 443 650 1315 
351 621 695 716 831 832 
646 647 1050 1134 1326 1335 
1009 1010 1185 1191 1296 1297 
17 469 470 511 1049 
26 290 331 383 975 
61 62 876 1259 1330 
105 116 266 775 1203 
154 386 1003 1056 1258 
185 855 1128 1165 1288 
217 734 1019 1155 1304 
225 387 509 510 828 
291 346 700 719 720 
299 749 750 799 1346 
300 962 963 1047 1269 
402 712 791 925 1030 
408 431 432 701 905 
436 447 485 895 1039 
491 560 783 852 934 
541 705 706 882 1031 
739 1115 1254 1299 1343 
740 884 885 1078 1157 
769 939 1190 1274 1284 
873 881 976 1153 1316 
992 1048 1224 1225 1243 
1000 1014 1176 1226 1285 
6 35 246 813 
28 465 735 1001 
38 145 522 1052 
39 223 1072 1347 
47 798 980 1094 
67 102 251 1059 
74 123 727 1002 
77 78 532 1293 
120 1062 1160 1193 
139 1026 1027 1116 
144 563 606 914 
151 1109 1113 1255 
153 210 1051 1063 
159 262 926 1138 
169 226 1058 1169 
192 411 887 1287 
194 657 827 1093 
196 554 1042 1178 
209 900 1188 1324 
231 232 633 679 
241 492 1013 1152 
242 508 544 1211 
254 483 829 1105 
292 464 477 1129 
342 576 1222 1248 
344 481 577 751 
430 575 635 890 
452 480 605 1186 
455 456 741 1040 
472 547 1163 1179 
543 1053 1123 1200 
568 731 916 1212 
571 596 597 1242 
617 618 861 1294 
620 717 776 846 
637 685 1121 1140 
660 1092 1216 1354 
661 662 989 1101 
680 1164 1253 1331 
730 950 1015 1057 
772 966 993 1111 
833 834 1151 1257 
868 1112 1246 1263 
874 919 1017 1280 
902 903 954 1076 
927 1132 1197 1282 
952 977 988 1091 
986 1080 1221 1318 
1012 1102 1125 1162 
5 133 820 
52 949 1067 
92 559 1099 
99 199 628 
109 487 826 
113 114 282 
131 670 1206 
134 1198 1231 
150 994 1118 
228 247 999 
240 273 929 
258 1278 1279 
265 818 910 
276 760 836 
281 444 870 
304 821 1272 
312 690 938 
315 643 790 
316 572 639 
333 985 991 
357 551 965 
365 659 1161 
398 844 1137 
405 521 1016 
449 592 1061 
453 768 1066 
466 490 1333 
479 613 1171 
493 774 847 
524 696 1351 
529 664 930 
555 1150 1184 
557 584 1007 
567 777 912 
574 854 1110 
593 612 911 
684 1215 1298 
780 1033 1035 
789 941 1300 
795 858 864 
796 797 851 
805 806 1336 
824 1119 1120 
825 1133 1314 
837 838 1283 
893 1181 1218 
896 990 1286 
