1 12 13 15 22 23 31 32 34 36 37 40 42 43 44 53 55 59 63 64 66 79 83 86 87 89 93 94 111 120 148 149 153 174 178 189 195 208 212 218 219 220 224 234 235 238 245 250 255 257 258 269 277 278 285 296 303 304 305 306 307 308 309 320 322 325 327 339 340 341 349 350 353 354 355 360 361 362 374 375 381 388 392 403 406 414 421 422 430 438 467 468 475 501 502 503 514 515 516 526 535 573 588 594 599 608 619 626 627 649 669 688 736 743 758 765 770 787 793 821 845 871 872 875 877 899 909 936 943 948 953 955 970 979 995 997 998 1024 1029 1037 1040 1066 1071 1102 1106 1125 1147 1148 1154 1162 1172 1178 1187 1193 1205 1213 1247 1260 1265 1266 1271 1272 1273 1301 1309 1332 1334 1348 
4 5 26 28 30 33 38 45 57 71 72 97 108 118 126 128 133 137 145 158 161 171 172 173 180 207 210 213 237 244 248 259 288 294 301 302 317 318 334 352 357 368 378 389 410 417 426 429 437 445 446 449 453 454 465 478 485 486 496 497 532 564 566 577 579 580 592 598 616 622 623 632 687 692 693 704 707 710 746 748 752 763 768 784 802 815 817 820 889 891 892 915 944 951 985 987 992 1020 1028 1032 1034 1052 1061 1063 1107 1142 1173 1175 1194 1195 1210 1224 1225 1241 1256 1278 1310 1320 
7 10 11 48 56 61 103 110 162 188 191 206 222 260 348 366 376 377 390 393 397 407 416 418 419 447 448 460 474 500 530 539 542 543 556 584 595 600 607 624 648 656 657 694 715 721 723 728 731 742 773 803 809 823 827 876 890 896 897 916 932 933 945 946 947 969 972 990 996 1001 1053 1060 1068 1100 1123 1124 1135 1136 1170 1177 1200 1206 1208 1212 1223 1233 1234 1270 1286 1290 1302 1306 1328 
0 19 67 68 69 101 104 122 140 146 164 166 167 179 190 236 251 275 287 293 324 338 356 358 367 371 391 400 423 427 440 463 470 498 499 520 548 549 557 582 583 604 609 640 652 663 680 682 691 697 698 726 786 800 835 893 906 907 908 957 971 978 1039 1044 1045 1085 1117 1122 1141 1145 1159 1164 1168 1220 1253 1267 1268 1331 1349 
20 54 65 70 84 85 88 112 124 135 155 169 194 201 204 226 249 256 263 300 321 379 395 412 473 506 531 550 570 581 589 601 615 617 618 644 681 702 711 712 732 804 811 812 825 848 857 942 949 956 962 963 980 981 1067 1093 1094 1114 1158 1160 1182 1189 1198 1269 1294 1305 1321 1325 
3 76 82 98 115 168 196 202 215 241 252 261 310 311 319 345 369 382 384 385 413 435 459 494 495 552 554 558 561 562 590 654 655 658 724 744 749 756 766 842 843 866 883 884 885 894 925 927 967 974 986 991 1004 1007 1027 1036 1042 1058 1062 1070 1080 1088 1089 1167 1259 1277 1281 
14 29 107 139 183 184 186 187 203 267 281 282 295 326 336 337 370 380 396 444 534 565 591 611 636 638 639 671 699 709 733 737 754 759 764 810 913 914 937 968 984 1009 1010 1023 1025 1026 1046 1086 1090 1104 1116 1130 1185 1191 1204 1230 1236 1296 1297 1303 1329 
24 47 62 92 147 152 264 265 286 298 394 471 523 559 646 665 676 684 685 729 757 781 794 798 807 808 818 856 867 874 879 880 910 929 1011 1065 1079 1082 1083 1181 1215 1218 1219 1279 1298 1307 1308 1312 1330 1335 
90 102 106 175 176 233 242 330 347 492 508 512 517 518 544 567 677 678 739 740 771 777 819 854 912 919 920 994 1012 1013 1017 1018 1059 1078 1099 1110 1115 1152 1157 1211 1254 1275 1280 1299 1311 1313 1339 1343 
25 46 91 121 131 141 160 214 239 268 272 299 323 328 402 409 425 434 436 456 461 505 527 528 536 537 545 602 610 653 672 718 782 785 801 839 840 841 923 958 1030 1069 1096 1169 1318 1319 
50 73 266 292 351 404 529 574 575 614 645 651 664 767 796 797 850 851 902 903 930 952 954 977 988 999 1047 1055 1076 1077 1091 1133 1207 1232 1314 1345 1350 
9 125 156 157 165 279 428 442 593 612 613 630 631 634 719 791 805 806 814 816 863 868 878 911 940 982 1073 1112 1156 1171 1197 1246 1263 1336 
27 60 100 163 182 271 312 313 316 332 333 405 469 472 511 521 547 572 586 587 690 747 778 789 822 938 941 1014 1016 1163 1176 1179 1289 1300 
6 35 99 177 198 199 205 209 246 247 270 297 314 335 383 424 519 533 585 686 689 813 895 900 959 973 1188 1201 1324 1327 1338 
181 185 290 331 373 439 524 637 659 660 683 696 755 849 975 1000 1005 1008 1092 1121 1140 1216 1229 1243 1252 1322 1323 1351 1354 
16 119 132 136 192 193 411 415 457 488 489 504 568 625 635 650 700 779 780 824 861 1035 1041 1074 1118 1119 1120 1315 
18 365 401 408 431 432 450 546 571 596 597 673 674 701 713 714 722 788 905 921 964 1043 1051 1098 1161 1196 1242 1295 
75 81 159 262 284 342 464 477 569 576 647 738 772 833 834 926 966 993 1050 1111 1129 1134 1138 1151 1222 1248 1257 1326 
96 109 151 359 487 769 826 860 862 873 881 939 976 1033 1109 1113 1153 1190 1209 1255 1274 1284 1316 1340 1341 
41 51 52 221 227 228 315 522 643 790 837 838 904 961 1006 1021 1048 1087 1095 1146 1180 1199 1214 1283 
74 123 150 452 479 480 493 507 509 510 555 605 708 725 727 750 774 799 828 1002 1150 1186 1238 1346 
2 21 49 129 130 254 451 490 578 603 761 762 829 870 901 1105 1143 1166 1183 1239 1276 
77 78 142 143 240 273 274 661 662 989 1101 1155 1217 1235 1264 1288 1293 1337 1344 
217 231 232 482 633 641 642 679 734 830 917 918 924 928 1019 1084 1144 1304 
154 225 386 621 695 716 730 831 832 950 1003 1015 1056 1057 1228 1258 
80 211 216 229 230 253 283 441 476 753 795 858 864 1054 1103 
113 114 144 276 458 525 563 606 760 836 960 1132 1221 1282 1287 
280 387 433 620 717 776 846 847 853 859 888 935 1097 1192 1317 
39 127 223 443 629 869 898 1038 1049 1072 1075 1108 1202 1347 
105 116 398 455 466 741 775 844 1081 1137 1203 1262 1292 1333 
58 95 200 329 667 703 745 865 983 1139 1237 1249 1342 
197 483 540 541 705 706 882 886 887 1031 1131 1226 1285 
8 289 364 399 420 484 513 1022 1064 1149 1227 1240 
17 134 243 491 560 735 783 852 934 1231 1291 
117 291 346 553 792 922 931 1244 1245 1261 
372 551 666 855 965 1128 1165 
343 344 481 538 675 751 
138 628 670 720 1184 
170 363 462 668 
