1 12 13 15 22 23 24 31 32 34 36 37 40 42 43 44 53 55 59 63 64 66 86 87 89 93 94 148 149 165 174 189 195 208 212 219 220 224 234 235 245 250 257 265 269 277 278 279 296 303 305 306 308 309 320 322 325 327 339 340 341 349 350 353 354 360 361 366 374 381 388 392 403 406 414 421 422 438 442 443 467 468 475 488 501 502 503 515 516 526 535 570 573 588 591 594 599 608 619 626 627 630 631 645 649 674 676 696 724 743 758 765 770 781 787 793 800 814 816 817 845 856 863 867 871 872 875 877 878 899 909 936 940 943 948 953 955 960 970 979 997 998 1008 1011 1023 1024 1029 1032 1037 1070 1071 1106 1147 1148 1154 1172 1187 1205 1213 1217 1247 1260 1266 1271 1273 1301 1307 1308 1309 1332 1334 1348 
4 7 10 11 26 30 33 38 48 56 57 73 97 108 118 126 129 131 133 138 158 162 172 173 180 188 191 206 207 222 237 244 256 260 271 288 294 301 302 334 351 352 368 389 390 393 395 397 404 407 410 416 417 418 419 429 434 436 437 447 448 453 454 458 460 461 474 485 512 530 532 539 542 556 578 579 582 598 600 614 624 648 651 656 657 670 693 694 704 707 714 715 721 723 728 742 748 771 773 778 784 796 797 802 803 809 818 820 823 824 841 850 851 889 932 933 944 945 947 951 969 974 985 996 1000 1052 1055 1060 1068 1073 1077 1079 1119 1120 1124 1135 1136 1145 1159 1177 1195 1206 1207 1223 1233 1234 1256 1275 1290 1291 1300 1302 1306 1310 1313 1315 1328 1339 
20 46 47 54 65 70 88 90 112 124 135 139 141 147 152 155 160 161 194 204 238 239 249 263 268 275 295 298 321 323 326 355 358 359 370 379 380 394 402 409 425 428 462 471 505 523 527 528 534 545 589 615 634 636 644 653 665 672 681 699 709 711 712 718 732 737 757 764 767 782 785 794 798 804 808 811 812 827 839 840 848 857 879 880 897 910 923 937 946 958 980 983 984 1004 1026 1027 1028 1030 1049 1065 1069 1082 1083 1093 1094 1096 1104 1110 1114 1116 1146 1158 1181 1182 1185 1189 1204 1218 1231 1277 1305 1311 1320 1325 1342 1345 
5 16 39 75 79 81 83 111 119 128 137 159 171 217 218 223 255 259 262 274 285 292 304 307 342 347 362 375 430 457 464 477 486 489 564 569 574 575 576 595 616 617 618 623 625 635 669 688 692 736 768 772 779 780 821 854 861 890 917 926 966 993 995 1019 1033 1035 1041 1066 1072 1102 1107 1108 1111 1118 1125 1129 1131 1138 1155 1222 1225 1235 1248 1272 1294 1304 1347 
0 19 68 69 104 122 140 146 164 166 167 179 190 236 258 264 287 293 324 338 343 356 367 371 383 391 400 423 427 440 463 498 499 520 548 549 557 563 583 604 606 609 640 652 663 682 691 697 698 726 786 835 893 906 907 908 957 971 978 1039 1044 1045 1117 1122 1133 1141 1220 1221 1241 1287 1349 
41 80 82 96 98 101 156 157 215 242 252 286 310 311 319 435 439 459 476 493 494 508 522 544 552 558 561 562 590 654 655 661 662 744 756 766 774 836 858 904 918 967 982 986 989 991 1007 1012 1021 1036 1054 1080 1085 1100 1101 1162 1209 1211 1214 1281 
74 99 123 177 192 193 198 199 270 297 314 335 411 479 519 533 585 628 686 700 719 720 727 769 862 873 874 881 886 887 919 959 973 976 1002 1017 1018 1074 1153 1156 1190 1274 1280 1284 1316 1340 1341 
2 21 72 205 230 248 317 318 426 451 497 540 566 689 705 710 739 761 866 901 915 987 1031 1046 1115 1142 1143 1166 1168 1170 1175 1183 1194 1201 1226 1232 1254 1276 1285 1289 1299 1327 1338 1343 1350 
14 58 107 187 200 203 267 284 329 336 337 396 484 546 550 565 611 667 703 733 745 754 759 860 865 913 968 981 1025 1050 1090 1165 1230 1236 1249 1278 1279 1288 1303 1329 
3 76 109 115 369 382 384 385 478 487 632 646 647 749 791 795 799 805 806 826 843 864 868 883 925 1088 1089 1112 1134 1246 1259 1263 1265 1326 1335 1336 
25 91 213 214 272 299 328 415 529 536 537 610 650 664 684 685 729 884 885 930 952 977 988 999 1014 1091 1176 1215 1298 1319 
121 182 290 313 331 452 469 470 480 511 521 543 568 587 605 690 731 755 789 916 941 972 975 1005 1053 1123 1186 1200 1212 1318 
280 433 504 525 580 602 603 629 677 678 776 801 807 846 847 853 859 869 888 898 1038 1081 1097 1192 1202 1262 1292 1317 
117 163 183 184 253 312 316 345 357 372 373 445 551 553 572 639 658 666 673 722 855 931 938 965 1034 1128 1130 
45 130 231 232 378 446 496 507 622 633 638 679 746 747 752 763 815 891 892 992 1173 1210 1224 1238 1239 1243 
84 85 136 144 201 210 300 412 424 473 506 531 581 601 702 914 942 956 962 963 1047 1063 1075 1269 1321 
92 105 116 266 291 346 398 455 456 466 490 559 740 741 775 825 844 1040 1078 1099 1137 1157 1203 1314 1333 
127 181 185 492 500 524 567 637 660 683 777 849 912 1013 1092 1121 1140 1152 1216 1229 1252 1322 1323 1351 1354 
51 132 221 227 228 247 315 586 643 790 837 838 894 895 961 1006 1048 1087 1095 1180 1199 1283 
8 170 289 363 364 399 420 513 668 687 792 1020 1022 1064 1149 1227 1240 1244 1245 1261 
18 178 365 408 431 432 571 596 597 659 701 713 788 905 1076 1098 1161 1237 1242 1295 
103 150 376 377 541 555 584 607 706 708 725 833 834 882 994 1150 1151 1184 1257 
196 449 554 592 680 927 1042 1061 1132 1164 1178 1197 1253 1267 1268 1282 1331 
620 621 695 716 717 730 831 832 902 903 935 950 954 1015 1057 1228 
28 50 61 62 71 134 465 735 876 896 990 1001 1198 1286 1330 
106 110 145 175 176 233 330 348 514 517 518 819 1139 1208 1270 
254 482 483 641 642 734 829 830 924 928 1084 1105 1144 1219 1312 
27 29 49 60 100 186 281 332 444 671 762 870 920 
153 154 386 491 560 783 852 934 1003 1051 1056 1258 
9 125 197 211 216 229 283 441 753 922 1103 
17 120 243 593 612 613 911 1062 1160 1171 1193 
77 78 142 143 538 675 738 1264 1293 1337 1344 
240 241 261 273 413 495 810 842 929 1086 1167 
67 102 113 114 168 202 251 282 1058 1059 
333 405 472 547 822 939 1016 1163 1179 
6 35 209 246 813 900 1188 1324 
225 387 509 510 750 828 1346 
52 169 226 949 1067 1169 
276 344 481 577 751 760 
401 450 921 964 1043 1196 
95 151 1109 1113 1255 
1009 1010 1191 1296 1297 
