1 12 22 34 36 40 88 119 148 155 165 189 208 212 220 227 272 305 320 324 360 362 381 388 412 421 433 464 475 503 513 516 526 570 573 599 600 627 630 650 695 749 781 792 803 824 832 854 908 936 951 957 988 1078 1097 1119 1120 1129 1149 1157 1240 1244 1245 1261 1271 1273 1332 1348 
0 10 44 46 47 100 149 275 295 358 359 409 425 428 432 461 462 466 471 490 514 523 527 528 541 543 608 618 626 665 718 784 794 862 916 933 943 948 952 954 976 1021 1053 1064 1091 1122 1123 1141 1147 1200 1247 1333 1349 
48 105 127 128 137 170 171 191 264 393 408 446 460 477 486 487 542 564 571 616 623 624 656 691 692 715 775 809 898 966 969 1107 1108 1124 1135 1177 1234 1241 1272 1290 1302 1306 
75 83 132 256 285 304 307 347 354 375 396 397 458 473 474 488 556 561 569 578 581 582 625 652 688 707 710 795 980 1044 1060 1131 
20 21 61 62 112 134 195 342 427 502 511 619 701 742 876 896 901 990 1001 1100 1143 1198 1286 1325 1330 
9 187 203 211 229 262 276 319 435 440 441 492 558 560 622 753 754 766 783 852 981 
52 56 125 126 290 293 294 434 442 495 640 697 941 971 992 1023 1048 1117 1210 1253 1300 
5 57 72 93 248 318 378 420 476 530 566 595 855 866 915 987 1082 1206 1289 1317 
14 15 115 267 326 565 596 611 743 826 913 968 1004 1025 1090 1230 1236 1242 1259 1303 
154 225 299 300 328 386 387 537 601 729 903 1003 1014 1056 1057 1169 1215 1258 1319 
217 231 232 482 507 641 642 679 680 734 830 924 928 1019 1084 1144 1155 1164 1288 
2 106 109 110 175 176 233 260 261 330 348 512 771 819 1270 1275 
102 103 104 113 114 156 158 196 197 251 322 472 653 904 905 1139 
6 81 284 314 315 376 401 585 607 663 686 790 875 1106 
11 555 579 694 727 740 741 833 834 1059 1150 1151 1152 1257 
198 270 297 298 335 341 533 535 536 871 958 973 1148 1301 
184 239 602 649 709 767 884 885 1069 1130 1204 1277 1345 
368 520 620 677 678 716 717 750 776 828 846 1024 1346 
3 76 369 382 384 478 632 1088 1089 1114 1183 1265 
4 70 129 130 254 554 606 891 1105 1238 1239 1312 
38 312 405 521 522 690 738 760 789 1016 1052 1163 
145 209 336 337 411 479 759 782 808 879 1329 
214 228 392 589 594 615 800 967 1042 1062 1103 
18 123 152 174 221 406 407 447 867 912 
91 92 343 559 654 682 906 907 1045 1246 
107 108 167 389 525 531 733 752 982 1344 
117 183 253 372 373 445 755 931 1005 1034 
140 141 238 268 496 534 552 748 801 892 
7 58 73 74 329 484 545 865 900 
49 50 218 350 588 812 1040 1086 1197 
71 96 777 873 1033 1153 1209 1292 1316 
120 711 712 805 806 816 1158 1160 1171 
160 161 215 243 454 491 756 944 1320 
182 186 282 371 636 698 725 1054 1104 
345 426 590 658 669 778 845 856 1142 
16 244 274 366 410 836 986 1235 
33 45 180 190 279 301 302 747 
121 402 470 791 925 1030 1049 1072 
135 204 394 395 400 889 1079 1305 
177 237 333 539 897 932 985 991 
259 296 356 383 751 893 1038 1178 
266 404 651 723 843 996 1013 1055 
310 311 483 655 706 882 887 1031 
317 334 357 631 703 746 844 961 
26 67 459 497 848 859 1304 
54 147 166 880 1065 1083 1093 
89 90 222 278 1110 1140 1311 
133 849 1166 1175 1229 1232 1350 
138 377 456 881 923 934 1184 
153 201 210 365 869 1051 1063 
157 576 593 612 878 911 1128 
162 163 418 538 708 763 820 
178 674 788 1076 1098 1237 1295 
206 499 714 796 797 946 947 
246 681 811 813 857 1182 1281 
258 684 963 1165 1269 1279 1298 
436 485 689 894 895 1006 1039 
493 661 662 918 989 1101 1136 
23 352 817 1195 1315 1331 
24 242 245 277 517 671 
32 613 713 1115 1254 1278 
68 670 815 1022 1145 1214 
87 325 591 638 645 1173 
116 1070 1071 1203 1211 1266 
151 772 949 950 1111 1255 
188 224 313 437 1068 1208 
255 500 515 524 1243 1351 
399 505 974 1172 1227 1228 
468 617 736 861 1137 1138 
509 510 739 799 1299 1343 
586 587 1074 1217 1256 1293 
850 851 863 1073 1113 1133 
1009 1010 1185 1191 1296 1297 
1181 1207 1218 1219 1223 1328 
17 39 469 1225 1291 
30 978 1187 1205 1310 
31 634 899 953 970 
42 64 234 309 457 
59 504 575 635 724 
60 332 390 417 614 
63 872 1037 1159 1189 
66 280 847 888 1192 
139 842 1026 1027 1116 
142 223 1067 1264 1347 
207 249 643 644 728 
240 273 385 860 929 
283 529 664 922 930 
327 349 379 798 1094 
361 604 909 1081 1262 
374 519 702 926 1096 
453 768 910 917 1066 
646 874 886 1011 1335 
659 660 683 1216 1354 
704 779 825 835 1314 
761 793 822 1222 1248 
769 939 1190 1274 1284 
827 998 1154 1167 1321 
8 839 840 1161 
13 252 438 979 
19 179 553 562 
25 306 415 467 
29 927 1092 1176 
37 303 367 544 
41 757 1002 1087 
43 94 730 993 
69 308 340 419 
79 235 574 580 
85 86 744 942 
97 1008 1032 1252 
99 199 628 629 
101 480 621 770 
136 193 972 1156 
144 263 563 821 
169 226 1058 1294 
172 271 429 693 
185 666 964 1199 
216 355 937 1282 
219 269 443 1075 
230 449 450 921 
241 413 810 1224 
289 403 945 1213 
339 416 696 721 
370 380 676 984 
422 831 955 1338 
423 439 699 1028 
444 451 870 1276 
463 549 940 994 
501 960 1041 1109 
540 1170 1226 1285 
557 765 1007 1061 
568 731 774 1212 
647 1050 1134 1326 
667 802 983 1342 
758 1220 1221 1287 
868 1112 1263 1336 
1012 1102 1125 1162 
27 726 773 
28 465 735 
51 597 1146 
53 192 975 
55 181 1186 
65 732 1029 
78 609 610 
82 398 1077 
84 672 877 
95 122 745 
98 1080 1318 
124 722 1196 
131 286 1233 
146 250 1168 
164 236 675 
194 657 1231 
200 288 508 
213 452 605 
247 999 1036 
257 338 548 
281 391 914 
291 292 1043 
316 572 639 
321 489 546 
323 414 583 
331 518 920 
346 864 962 
424 506 956 
430 705 890 
455 592 1132 
481 598 823 
550 551 648 
584 786 787 
668 841 959 
685 829 1121 
700 719 720 
737 919 1017 
780 814 1035 
837 838 1283 
1018 1099 1280 
1046 1085 1202 
1193 1194 1260 
