0 1 12 13 22 23 32 36 37 42 43 48 53 54 55 59 63 64 65 66 75 79 86 87 88 93 94 95 96 108 111 112 149 155 174 189 195 200 204 205 208 212 218 219 220 234 235 242 245 250 255 256 257 259 269 272 277 278 296 303 304 305 306 308 309 321 322 327 339 340 341 349 353 355 360 361 374 379 381 388 403 415 416 421 433 443 467 468 473 475 490 502 503 504 508 526 557 563 573 578 579 588 594 599 608 619 625 626 627 656 681 724 728 736 751 770 786 798 803 812 866 867 873 890 899 926 936 952 953 980 997 1002 1061 1070 1097 1106 1114 1136 1137 1138 1146 1147 1159 1160 1167 1168 1187 1206 1213 1234 1247 1248 1256 1270 1306 1325 
6 7 25 29 34 35 40 58 67 73 74 76 80 83 84 85 113 115 123 132 142 147 148 157 168 169 177 190 285 291 307 314 315 328 329 346 366 375 382 384 401 402 408 412 424 457 458 466 484 516 519 531 545 546 547 584 585 586 593 607 612 613 629 649 660 663 667 668 686 688 700 745 775 788 791 792 807 832 836 837 838 843 844 846 865 875 883 888 900 911 923 942 948 986 994 1007 1024 1032 1058 1085 1089 1094 1100 1102 1109 1111 1117 1124 1131 1139 1149 1179 1193 1197 1202 1221 1260 1271 1273 1283 1294 1315 1332 1333 1354 
10 31 47 56 57 69 70 99 100 120 125 126 135 150 151 158 159 160 172 173 236 237 248 268 275 280 288 294 295 352 358 359 377 378 394 409 425 428 429 430 434 455 456 461 462 463 471 495 523 527 528 534 539 595 636 638 640 648 665 670 697 718 719 737 742 747 757 763 773 794 840 841 851 861 863 897 927 933 941 943 969 971 976 996 1008 1020 1021 1064 1073 1088 1096 1103 1141 1173 1177 1194 1210 1214 1223 1233 1243 1253 
8 9 20 101 102 124 146 187 188 202 203 211 216 217 221 229 230 246 247 252 262 263 276 319 320 332 333 334 345 354 357 365 399 431 435 440 441 476 491 492 505 550 551 558 560 561 592 622 632 635 698 733 735 753 754 756 766 783 823 860 862 870 935 975 981 987 995 1029 1036 1038 1067 1087 1098 1121 1129 1281 
4 27 30 46 68 82 97 98 107 121 122 134 141 152 166 179 194 253 289 290 323 324 400 423 426 427 451 452 464 470 485 494 498 520 525 572 590 628 637 639 652 655 658 669 704 744 778 795 818 835 845 856 910 931 932 957 1044 1045 1071 1211 1231 1312 
11 44 118 119 131 140 167 207 391 392 395 447 448 499 500 570 589 615 621 666 689 714 726 790 797 800 804 822 889 895 916 946 947 964 1006 1034 1039 1042 1053 1054 1079 1123 1140 1199 1200 1222 
2 3 21 105 106 109 110 176 223 224 233 260 261 347 348 393 419 420 437 512 571 597 634 715 771 809 819 901 915 974 1068 1083 1142 1143 1183 1208 1275 1290 1302 1347 
165 292 351 414 422 535 574 575 576 580 630 631 758 767 814 816 825 878 902 954 988 993 1012 1076 1077 1091 1110 1113 1133 1192 1240 1244 1245 1261 1345 
127 128 136 137 170 171 191 192 264 265 460 477 478 486 487 542 564 616 623 624 691 692 710 721 1107 1108 1112 1135 1241 
71 72 238 239 446 496 497 501 552 605 653 672 746 748 752 785 801 815 855 892 979 991 1195 1217 1289 1300 
5 26 33 45 133 161 180 243 244 254 271 279 301 302 453 454 577 598 687 693 802 820 944 985 1175 
28 60 117 182 185 316 317 372 373 445 465 479 532 587 671 755 782 810 960 965 1005 1019 1066 1074 1161 
14 15 267 396 513 565 596 647 743 759 913 968 1004 1025 1090 1153 1230 1236 1242 1266 1276 1303 1326 1335 
258 293 318 338 350 356 367 383 540 548 549 582 583 602 604 609 696 869 893 940 978 1178 1269 1310 
77 144 145 175 201 209 210 281 282 326 344 569 591 898 914 1046 1050 1051 1052 1063 1075 1105 1293 
509 510 515 524 555 567 568 645 739 740 741 799 854 956 977 1013 1059 1078 1152 1157 1220 1252 1351 
38 39 50 404 405 713 760 919 1017 1018 1062 1099 1181 1207 1224 1225 1278 1280 1295 1314 1344 
103 104 156 196 197 251 472 541 676 703 706 727 904 905 922 951 982 992 1031 1060 1170 
164 312 313 469 521 522 554 603 633 690 761 762 789 793 1014 1016 1055 1128 1163 1285 
225 273 300 368 369 387 506 600 702 749 750 765 781 817 903 1264 1307 1308 1321 1346 
61 62 266 646 651 826 876 877 896 990 1001 1011 1203 1259 1286 1318 1330 
78 493 661 662 769 847 918 939 970 989 1101 1190 1274 1284 1316 
206 249 514 643 644 732 811 848 857 1122 1145 1182 1189 1198 1349 
215 310 311 325 342 362 438 439 459 562 654 882 894 1028 
91 92 213 214 336 397 474 556 581 610 1040 1328 1329 
364 411 614 731 808 864 879 880 962 1065 1082 1235 1287 
116 480 620 716 730 831 949 950 963 1015 1047 1228 
283 529 530 664 694 695 839 859 930 999 1035 1317 
536 537 601 827 871 872 998 1057 1154 1169 1301 1319 
432 673 674 701 705 722 723 921 938 1043 1196 
482 483 641 642 734 829 830 924 928 1084 1144 
193 376 511 712 821 925 972 1030 1049 1072 
198 199 270 297 298 335 533 958 959 973 
371 436 849 937 983 984 1104 1132 1282 1342 
805 806 868 906 907 1134 1158 1246 1263 1336 
16 488 489 779 780 1041 1118 1125 1162 
24 684 685 729 929 1172 1215 1279 1298 
49 181 186 370 444 659 683 699 1216 
41 675 774 961 1166 1229 1232 1350 
51 52 227 228 442 1022 1023 1048 
183 184 337 611 709 1069 1130 1204 
650 725 796 824 912 1119 1120 1201 
679 680 1155 1164 1165 1288 1305 1331 
18 19 299 553 559 566 787 
81 284 657 852 874 886 887 
153 154 226 386 1003 1056 1258 
163 389 417 538 707 708 1186 
129 130 606 891 1238 1239 
138 881 934 967 1171 1184 
162 390 418 720 945 1093 
286 287 682 858 908 1249 
406 407 617 618 1205 1272 
450 1000 1086 1116 1156 1255 
1009 1010 1185 1191 1296 1297 
677 678 776 777 828 
833 834 1150 1151 1257 
17 410 850 1291 
139 764 1026 1027 
178 784 1080 1237 
231 232 507 1209 
240 241 274 385 
330 331 517 518 
413 717 1212 1348 
449 1226 1227 1320 
853 1033 1262 1292 
1115 1254 1299 1343 
89 222 1311 
114 813 909 
363 380 966 
768 917 1304 
884 885 1277 
955 1327 1338 
1037 1148 1265 
1126 1127 1174 
