0 6 7 11 22 34 36 40 67 73 74 79 81 88 112 120 148 154 155 165 169 208 212 220 225 226 227 235 238 255 272 277 284 299 300 315 320 323 328 329 360 364 369 376 381 382 384 386 388 392 401 412 421 464 468 475 477 484 493 503 513 516 521 524 526 537 545 547 573 574 580 583 585 599 600 601 607 617 627 628 629 647 663 686 690 694 695 711 712 729 736 741 749 750 767 781 803 805 806 816 832 851 861 863 865 875 886 900 903 908 957 1003 1014 1016 1050 1056 1057 1058 1073 1106 1113 1125 1129 1131 1133 1134 1136 1137 1138 1149 1152 1158 1160 1162 1215 1236 1240 1243 1258 1271 1273 1278 1294 1319 1326 1332 1336 1345 1346 1348 1351 
27 31 46 48 71 72 105 106 127 128 137 140 141 142 143 170 171 176 188 191 206 223 224 231 233 236 260 264 268 281 313 348 358 366 391 393 408 409 410 425 434 446 460 486 487 494 496 499 500 501 512 528 542 552 564 567 571 616 623 624 633 634 656 675 691 692 714 715 718 726 748 773 775 785 796 797 801 809 835 884 892 898 899 943 946 947 953 966 969 970 1041 1067 1068 1107 1108 1124 1135 1177 1208 1233 1234 1241 1247 1270 1272 1275 1277 1290 1302 1306 1313 1337 1339 1347 
4 8 44 45 47 70 96 99 100 117 124 132 149 158 189 199 205 250 254 275 291 292 305 316 322 354 359 362 432 455 462 466 471 481 483 488 490 502 514 515 523 543 554 584 598 618 625 626 665 722 784 786 787 790 792 794 798 823 839 840 853 862 916 922 933 935 948 952 954 976 995 1021 1043 1053 1076 1091 1095 1123 1141 1147 1161 1180 1200 1201 1209 1244 1245 1261 1333 
5 9 18 20 21 33 97 98 123 131 133 152 160 161 174 180 190 200 215 221 243 244 256 259 279 286 288 301 302 310 311 342 356 406 407 423 439 443 447 454 491 511 577 693 747 751 756 766 867 893 901 944 1008 1028 1032 1038 1139 1143 1181 1198 1207 1218 1219 1223 1252 1312 1320 1325 1328 
80 103 104 107 108 113 114 173 196 197 198 214 228 257 266 270 297 298 335 338 341 389 404 424 458 472 525 531 533 535 536 548 594 603 615 651 668 733 737 752 760 841 843 871 896 902 904 905 919 958 959 960 967 973 982 990 1013 1017 1047 1055 1062 1103 1132 1148 1222 1248 1282 1301 
43 87 94 119 135 167 172 204 207 249 295 324 325 394 395 400 429 430 433 540 541 570 589 639 643 644 645 650 687 699 705 728 730 765 800 889 890 912 951 961 993 998 1042 1060 1079 1088 1089 1154 1167 1170 1226 1285 1305 1307 1308 1321 
102 146 187 203 211 217 229 230 241 262 276 287 319 332 345 435 440 441 448 449 450 492 505 550 558 560 592 622 630 655 735 753 754 836 852 858 882 887 921 965 981 1015 1031 1168 1171 1228 1249 1255 
17 24 25 39 68 121 136 193 194 242 306 330 331 377 402 456 467 469 470 517 518 657 670 671 704 779 815 825 850 881 920 923 925 934 972 1018 1022 1030 1049 1072 1145 1184 1214 1232 1291 1314 1350 
1 13 65 69 75 76 82 83 110 111 153 195 201 285 304 307 308 340 347 365 374 375 396 397 398 414 419 473 474 556 581 652 688 710 795 869 980 1029 1044 1051 1077 
38 145 209 210 336 337 411 509 522 568 569 611 709 738 739 740 759 782 799 808 833 834 883 885 956 988 1052 1059 1063 1078 1099 1105 1151 1157 1204 1257 1280 1299 1327 1329 1343 
12 54 57 93 144 202 213 237 248 263 318 378 420 431 437 476 478 530 563 566 595 605 764 783 821 827 855 915 987 996 1082 1206 1317 
19 61 95 122 134 179 426 427 553 557 559 562 572 590 619 653 658 669 701 742 745 778 845 856 866 931 936 1001 1007 1061 1100 1142 1231 
35 66 101 151 246 280 314 351 363 436 480 485 621 681 689 770 772 811 813 847 857 888 894 895 949 950 1006 1039 1097 1111 1182 1192 1281 
2 3 129 130 139 164 399 591 606 638 707 780 814 854 891 974 1009 1010 1012 1035 1098 1102 1116 1172 1173 1183 1185 1191 1227 1238 1239 1295 
32 52 56 125 126 290 293 294 442 495 613 640 697 706 713 941 971 992 1023 1048 1115 1117 1156 1210 1253 1254 1264 1267 1268 1289 1300 1344 
49 50 53 218 219 261 350 413 588 677 678 777 791 810 812 828 842 873 1026 1027 1033 1040 1086 1092 1153 1197 1224 1260 1292 1316 1340 1341 
182 186 253 282 283 371 385 529 551 636 648 664 666 698 725 793 822 824 860 930 964 1054 1104 1119 1120 1163 1199 1225 1342 
14 15 115 116 267 326 565 596 608 743 913 968 1004 1025 1070 1071 1090 1203 1211 1230 1242 1259 1266 1286 1303 1309 1334 
62 118 147 166 247 482 641 642 646 685 829 830 874 880 924 928 977 999 1011 1036 1065 1083 1084 1093 1144 1330 1335 
51 258 357 451 452 479 507 555 578 579 597 632 684 727 761 762 870 962 963 1114 1146 1269 1276 1279 1298 
26 60 181 271 390 417 459 497 527 614 731 755 774 848 859 986 1080 1212 1221 1229 1287 1304 1318 
16 78 138 240 251 273 274 405 609 610 661 662 720 789 879 929 989 1101 1175 1235 
109 192 296 339 370 380 383 416 593 612 676 696 721 826 876 911 975 984 1109 1178 
37 216 269 303 327 349 352 355 367 508 510 544 817 937 1075 1094 1331 
91 92 177 178 333 343 539 654 682 897 906 907 932 985 991 1045 1246 
184 239 312 353 602 637 649 673 674 723 788 938 1069 1130 1196 1322 1323 
84 368 379 387 506 520 620 672 716 717 732 776 846 877 1024 1169 
28 29 159 232 465 679 680 734 927 1000 1019 1155 1164 1176 1288 
77 317 334 372 445 532 631 703 746 844 868 1005 1034 1112 1263 
55 162 163 289 403 418 538 708 763 820 945 1066 1186 1213 
89 90 222 245 278 361 604 909 1081 1110 1140 1262 1311 
265 453 768 769 818 910 917 918 939 1179 1190 1274 1284 
422 586 587 831 837 838 955 1074 1217 1256 1283 1293 1338 
30 59 504 575 635 724 804 978 997 1187 1205 1310 
63 252 344 438 849 872 979 1037 1166 1189 1265 
168 183 373 519 561 700 702 719 926 1096 1121 
463 498 549 582 807 940 994 1020 1159 1193 1194 
10 461 659 660 683 1064 1122 1216 1349 1354 
156 157 185 576 758 878 1128 1165 1220 
42 64 234 309 415 457 1315 
175 321 489 546 771 819 914 
23 85 86 744 942 1195 
41 757 1002 1087 1188 1324 
428 444 534 1046 1085 1202 
58 667 802 983 1237 
150 346 864 1118 1150 
