1 9 12 13 15 22 23 24 31 32 34 36 37 40 42 43 44 53 55 59 63 64 66 86 87 89 90 93 94 125 129 139 148 149 165 174 189 195 208 212 219 220 234 235 245 250 257 265 269 277 278 279 296 303 305 306 309 320 322 325 327 339 340 341 349 350 353 355 360 361 366 368 374 381 388 392 403 406 414 421 422 438 442 468 475 501 502 503 515 516 526 535 567 570 573 586 588 591 594 599 608 619 626 627 630 631 645 649 674 743 758 765 770 777 781 787 793 814 816 817 818 845 856 863 867 871 872 875 877 878 899 908 909 910 912 936 937 940 943 948 953 955 970 979 997 998 1008 1011 1023 1024 1026 1027 1029 1032 1037 1071 1078 1106 1116 1125 1147 1148 1154 1162 1172 1187 1205 1213 1217 1220 1247 1252 1260 1266 1271 1273 1301 1307 1308 1309 1332 1334 1348 
4 7 10 11 26 30 33 48 56 57 73 97 115 126 133 158 161 162 172 173 180 191 206 207 237 243 244 271 288 294 301 302 334 352 354 357 390 393 395 396 397 404 407 410 418 429 436 447 448 453 454 458 460 461 474 485 500 539 542 551 556 578 579 581 582 598 600 614 624 648 651 656 657 666 687 693 694 704 707 714 715 721 723 728 742 748 768 773 778 779 784 796 797 802 803 809 820 824 841 850 851 855 889 897 932 933 944 945 947 965 969 985 996 1020 1028 1055 1073 1077 1112 1119 1120 1124 1128 1135 1136 1145 1159 1165 1177 1195 1207 1223 1233 1234 1256 1288 1290 1291 1302 1306 1310 1315 1320 1328 
3 41 67 76 79 98 102 113 114 156 157 168 202 215 242 251 252 276 282 310 311 369 382 384 385 435 443 459 478 493 494 508 521 522 544 552 558 561 562 574 580 632 654 655 690 744 749 756 760 774 799 836 843 847 854 883 904 967 982 1012 1036 1058 1059 1066 1085 1088 1089 1211 1214 1221 1265 1281 1287 
5 16 75 81 82 83 96 111 131 132 138 218 255 256 259 285 292 304 307 308 347 362 375 430 439 457 464 477 488 489 529 569 575 576 595 601 625 635 664 669 670 676 688 736 772 780 792 821 890 930 966 993 995 1033 1035 1041 1060 1100 1102 1111 1129 1131 1206 1209 1222 1244 1245 1261 1272 
20 52 54 65 70 88 112 118 119 124 130 135 155 169 194 204 226 249 254 263 321 323 379 380 482 483 589 615 641 642 644 681 711 732 737 800 804 811 812 825 827 830 848 857 924 928 949 951 980 984 1000 1014 1067 1084 1093 1094 1105 1114 1133 1144 1176 1182 1189 1239 1305 1325 
28 50 61 62 71 74 123 134 183 184 196 373 449 465 479 554 592 593 612 613 660 680 727 735 769 873 876 881 896 911 927 939 976 990 1001 1002 1042 1061 1092 1130 1132 1153 1164 1171 1178 1190 1197 1198 1216 1231 1253 1259 1267 1268 1274 1284 1286 1314 1316 1330 1331 1340 1341 1354 
2 21 72 103 144 170 205 230 248 314 317 318 363 426 451 497 530 540 541 563 566 606 668 689 705 706 710 739 761 866 882 894 895 901 914 915 987 1031 1046 1115 1142 1143 1166 1168 1170 1175 1183 1194 1201 1226 1232 1241 1254 1276 1285 1289 1299 1327 1338 1343 1350 
0 19 68 69 104 122 140 146 164 166 167 179 190 236 258 272 287 324 338 343 356 358 367 371 391 400 415 423 427 440 498 499 520 548 549 557 583 584 604 609 650 652 663 682 698 726 786 835 906 907 957 978 1007 1039 1044 1045 1122 1141 1349 
17 39 127 128 137 171 181 185 192 193 223 264 290 331 383 411 452 469 470 480 486 511 524 543 564 568 587 605 616 623 683 692 696 731 755 849 887 916 972 975 1049 1053 1072 1074 1107 1108 1123 1156 1186 1200 1212 1229 1347 1351 
47 80 147 152 239 286 295 298 326 359 370 394 425 462 471 476 523 636 665 699 757 764 767 794 795 798 808 858 864 879 880 893 946 958 1004 1021 1054 1065 1069 1079 1082 1083 1104 1110 1181 1218 1219 1277 1312 1345 
25 91 101 213 214 280 293 299 328 433 463 467 495 504 525 536 537 602 603 610 620 629 640 677 678 691 697 729 776 801 807 846 853 859 869 888 898 971 1038 1081 1097 1117 1192 1202 1262 1292 1317 1319 
92 105 107 108 116 187 203 266 284 291 336 337 346 389 398 466 490 550 559 611 700 709 717 719 720 733 754 759 775 844 860 960 981 986 1080 1099 1137 1203 1204 1236 1278 1279 1282 1329 1333 
84 85 99 136 177 198 199 201 210 270 297 300 335 412 424 473 506 519 531 533 585 617 618 628 686 702 861 942 956 959 962 963 973 1047 1063 1075 1269 1294 1321 
8 46 141 160 211 238 268 275 402 409 416 428 434 455 456 505 527 528 534 545 634 653 672 712 718 741 785 791 823 839 840 862 923 925 935 1030 1040 1096 
14 267 289 364 399 420 513 565 646 647 805 806 868 874 913 919 968 1017 1022 1025 1050 1064 1090 1134 1149 1158 1227 1228 1230 1240 1242 1246 1263 1303 1326 1335 1336 
45 120 217 231 232 378 446 496 622 633 638 679 734 746 747 752 763 815 891 892 917 918 992 1019 1048 1062 1155 1160 1173 1193 1210 1224 1225 1243 1304 
106 110 145 175 176 188 224 233 260 313 330 348 419 437 512 514 517 518 771 819 920 974 1018 1068 1208 1270 1275 1280 1313 1339 
153 154 225 319 386 387 491 509 510 560 750 766 783 828 852 886 934 1003 1051 1056 1258 1264 1344 1346 
18 58 95 178 200 329 484 546 667 703 713 745 788 865 983 1076 1098 1139 1161 1237 1249 1295 1342 
150 376 377 507 555 607 708 725 740 833 834 994 1118 1150 1151 1157 1184 1238 1257 
51 221 227 228 247 315 643 790 837 838 961 1006 1087 1095 1146 1180 1199 1283 
6 35 197 209 216 229 246 283 441 753 782 813 900 922 1103 1188 1324 
27 29 49 60 100 163 186 281 316 332 417 444 572 639 671 762 870 
117 121 253 312 345 372 445 553 590 658 673 722 931 938 1005 1034 1318 
365 401 408 431 432 450 571 596 597 659 701 905 921 964 1043 1196 
240 241 261 273 413 492 724 810 842 929 1013 1070 1086 1152 1167 
77 78 142 143 274 532 661 662 738 989 1101 1235 1293 1337 
351 621 695 716 730 831 832 902 903 950 954 1015 1057 1169 
182 333 405 472 547 789 822 941 991 1016 1163 1179 1300 
222 637 684 685 829 999 1121 1140 1215 1298 1311 1322 1323 
38 884 885 952 977 988 1052 1091 
109 151 487 826 1109 1113 1255 
159 262 342 926 1138 1248 
344 481 538 577 675 751 
1009 1010 1185 1191 1296 1297 
