0 2 4 9 10 18 21 30 31 33 44 45 46 47 65 70 97 98 100 123 131 135 146 149 152 158 160 161 172 180 184 190 204 207 215 221 239 243 254 265 271 275 279 291 292 295 301 302 325 358 359 394 395 406 407 423 425 429 432 439 454 461 462 466 471 490 523 528 541 543 554 608 618 622 626 634 659 660 665 673 674 683 687 693 709 718 722 732 747 756 784 790 794 802 817 818 839 840 841 853 862 889 899 901 912 916 933 935 938 943 944 948 952 953 954 970 976 978 1021 1028 1029 1043 1053 1064 1069 1079 1091 1095 1122 1123 1130 1141 1143 1147 1178 1180 1200 1204 1205 1216 1233 1247 1252 1305 1310 1312 1320 1333 1349 1354 
1 6 7 11 12 22 34 36 40 58 67 73 74 88 119 129 130 148 154 165 169 208 220 225 226 227 299 300 321 324 328 329 376 381 386 387 401 412 421 464 475 477 489 491 503 513 516 526 537 545 546 547 570 573 585 591 600 601 606 607 611 627 630 638 686 694 695 729 741 749 767 780 781 792 814 832 865 874 875 891 900 903 908 957 988 1001 1003 1011 1012 1014 1016 1035 1055 1056 1057 1058 1078 1081 1102 1106 1125 1129 1145 1162 1169 1173 1179 1187 1215 1238 1239 1240 1249 1258 1261 1271 1273 1294 1319 1332 1335 1345 1348 
41 80 102 103 104 107 108 113 114 156 164 168 173 182 185 186 196 197 198 203 214 228 240 251 257 270 273 274 282 297 298 335 338 357 371 385 389 392 399 404 451 472 505 525 531 533 535 536 548 551 589 594 603 615 636 648 651 653 666 667 668 698 699 723 725 727 733 737 752 757 761 762 793 800 822 824 843 860 871 902 904 905 929 951 958 959 964 967 973 974 982 983 984 992 996 1002 1013 1017 1042 1046 1047 1054 1085 1087 1103 1104 1119 1120 1148 1165 1172 1188 1199 1202 1225 1227 1228 1276 1288 1301 1324 1342 
27 48 56 57 68 105 127 128 137 140 141 167 170 171 189 191 206 233 238 264 281 312 391 393 398 446 460 486 487 494 496 497 499 501 512 521 530 534 542 552 564 571 584 616 623 624 633 656 670 690 691 692 714 715 726 748 773 775 785 789 796 797 801 809 815 867 892 946 947 960 966 969 1022 1041 1107 1108 1124 1135 1163 1177 1206 1214 1234 1241 1272 1277 1290 1302 1306 1317 
8 54 72 93 144 147 151 166 187 202 211 229 230 248 263 276 318 319 322 378 420 431 435 440 441 449 450 476 492 540 558 560 563 566 602 689 753 754 764 766 783 821 852 855 866 880 915 921 949 950 980 987 1031 1065 1082 1083 1093 1168 1170 1226 1255 1285 1289 
5 75 81 83 111 132 136 205 256 259 284 285 296 304 305 307 341 347 354 362 375 380 383 396 397 409 458 473 474 481 488 556 561 569 578 581 582 595 598 625 649 652 676 688 707 710 721 786 787 795 886 995 1038 1044 1050 1060 1131 1159 1201 
42 52 64 77 125 126 157 174 218 219 234 268 290 293 294 309 317 334 400 434 442 457 495 532 576 593 612 631 640 697 703 746 758 844 868 878 911 941 961 971 1023 1048 1112 1117 1128 1210 1220 1263 1287 
17 32 38 39 139 193 370 377 402 405 469 470 522 613 713 791 850 851 863 919 925 972 1009 1010 1018 1026 1027 1030 1049 1052 1062 1073 1099 1109 1113 1115 1116 1133 1156 1185 1191 1254 1278 1280 1291 1296 1297 
13 20 69 82 94 112 134 195 200 216 249 250 272 288 303 308 340 342 356 361 415 419 427 504 511 604 619 643 644 650 728 742 835 909 937 1070 1077 1198 1248 1282 1315 1325 
14 15 109 115 116 266 267 326 565 567 596 646 647 743 826 896 913 968 990 1004 1025 1071 1090 1134 1203 1211 1230 1236 1242 1259 1266 1286 1303 1309 1326 1334 
19 87 179 310 311 327 349 352 353 483 553 557 562 637 655 765 798 845 882 936 965 1007 1061 1094 1253 1267 1268 1307 1308 1322 1323 1331 
24 43 117 183 242 245 253 277 287 372 373 445 448 453 517 671 730 755 768 808 858 910 917 931 993 1005 1008 1015 1032 1034 1066 1222 
26 55 60 162 163 181 289 332 390 403 417 418 428 444 459 527 538 614 704 708 763 779 820 848 859 870 945 1080 1186 1213 1304 1318 
37 63 124 155 252 320 344 355 365 367 438 502 544 550 577 827 864 872 898 962 979 981 998 1037 1154 1167 1189 1321 
35 177 178 237 283 333 351 455 529 539 592 664 788 823 897 922 930 932 985 991 1076 1098 1132 1161 1237 1295 
331 384 478 509 510 518 555 579 632 739 740 799 833 834 854 920 1059 1114 1150 1151 1157 1184 1256 1257 1299 1343 
28 29 217 231 232 465 482 507 641 642 679 680 734 735 830 924 927 928 1019 1084 1092 1144 1155 1164 1176 
71 96 479 493 661 662 769 777 873 918 939 989 1033 1101 1136 1153 1190 1209 1262 1274 1284 1292 1316 1340 1341 
106 110 145 175 176 188 224 260 313 330 348 437 514 771 819 914 1068 1139 1208 1270 1275 1313 1339 
138 262 315 374 422 519 586 587 700 702 719 720 831 837 838 926 955 1074 1096 1217 1283 1293 1338 
53 91 92 192 213 343 452 559 568 605 654 682 731 774 879 906 907 975 1045 1152 1212 1246 
59 79 212 235 269 323 360 430 443 508 574 575 580 583 635 705 724 803 890 1072 1075 
84 368 379 424 506 520 620 672 677 678 716 717 776 846 876 877 956 1024 
23 61 62 85 86 339 408 416 696 701 744 942 1100 1195 1196 1300 1330 
258 286 414 463 484 498 549 684 807 940 963 994 1020 1149 1269 1279 1298 
101 246 314 363 364 480 621 681 770 772 811 813 857 1111 1182 1281 
49 50 241 261 350 413 456 588 810 812 842 1040 1086 1197 1260 
51 142 143 223 597 706 750 828 1067 1146 1264 1337 1344 1346 1347 
89 90 222 255 278 468 500 515 524 1110 1140 1224 1243 1311 1351 
99 199 617 628 629 711 712 736 805 806 861 1137 1138 1158 1336 
120 133 816 849 1160 1166 1171 1175 1193 1194 1229 1232 1244 1245 1350 
3 76 153 201 369 382 869 883 1051 1088 1089 1183 1265 1327 
95 122 316 345 426 572 590 639 658 669 745 778 856 1142 
25 66 121 280 306 433 467 847 888 1097 1192 
209 210 336 337 411 759 782 887 1063 1105 1329 
751 760 893 1181 1207 1218 1219 1223 1328 
16 78 609 610 836 986 1221 1235 
118 159 645 884 885 977 1000 
244 366 388 410 599 804 997 
436 447 485 894 895 1006 1039 
194 657 881 923 934 1231 
247 685 829 999 1036 1121 
150 346 825 1118 1314 
236 663 675 738 
