1 12 13 15 22 23 24 32 34 36 37 40 42 43 44 53 55 59 63 66 86 87 89 93 94 148 149 165 174 195 208 212 219 220 224 234 235 245 250 257 265 269 277 278 296 303 305 306 308 309 320 322 325 327 339 340 341 349 350 353 354 360 361 366 374 381 388 392 403 406 414 421 422 438 442 443 467 468 475 488 501 502 503 515 516 526 535 570 573 588 591 594 599 608 619 626 627 630 631 645 649 674 676 696 724 743 758 765 781 787 793 800 814 817 845 856 863 867 871 872 875 877 899 909 936 955 960 970 979 997 998 1008 1011 1023 1024 1029 1032 1037 1070 1071 1106 1147 1148 1154 1172 1187 1217 1260 1266 1271 1273 1301 1307 1308 1332 1348 
4 7 26 30 33 97 126 133 158 172 180 244 271 288 294 301 302 334 368 395 410 429 434 453 454 474 579 598 693 748 778 889 944 951 985 1073 1195 1256 1300 1310 1328 
46 141 160 161 238 239 268 275 323 402 428 527 528 534 545 634 653 672 709 718 767 782 785 897 958 1030 1049 1069 1096 1204 1231 1277 1320 1345 
48 56 57 162 191 393 407 460 542 600 624 648 656 657 715 742 803 809 969 996 1124 1135 1177 1223 1234 1290 1302 1306 
47 90 147 152 358 359 394 425 462 471 523 665 757 794 798 808 879 880 910 946 1065 1082 1083 1110 1181 1218 1311 
19 122 140 164 166 167 179 324 343 391 400 423 427 499 520 563 606 652 726 835 906 907 957 1044 1045 
98 101 215 252 310 311 435 439 459 494 552 558 561 562 590 654 655 744 756 967 991 1036 1085 1281 
0 68 104 146 258 287 338 356 367 383 440 498 548 549 557 583 604 609 786 893 978 1039 1133 
20 65 70 88 112 135 204 263 321 379 380 409 589 615 732 804 923 1094 1114 1146 1305 1325 
84 85 136 144 201 210 300 412 424 473 506 531 581 601 702 914 942 956 1063 1075 1321 
16 119 217 274 457 489 575 625 635 779 780 917 1019 1033 1035 1041 1118 1155 1235 1304 
5 75 83 111 255 259 285 307 347 362 375 430 569 595 688 736 1131 
230 248 317 318 426 566 710 739 915 987 1031 1046 1142 1168 1194 1289 1299 
45 130 378 446 496 622 746 747 752 763 815 891 892 1173 1210 1239 
128 137 171 292 464 477 486 564 616 623 692 1102 1107 1108 1125 1129 
3 76 115 369 382 384 385 478 632 843 883 1088 1089 1259 1265 
280 504 677 678 776 846 847 869 888 898 1038 1097 1192 1202 
105 116 266 291 346 398 466 490 775 825 1203 1314 1333 
127 181 185 500 524 660 683 849 1216 1229 1351 1354 
364 399 420 513 792 1064 1149 1227 1240 1244 1245 1261 
28 61 62 465 735 876 896 990 1001 1286 1330 
91 299 328 536 537 684 685 729 1215 1298 1319 
11 206 207 222 448 694 714 947 1079 1145 
14 336 337 396 565 759 913 1050 1236 1329 
31 64 189 770 943 948 953 1205 1213 1247 
58 200 329 484 546 667 703 745 865 1249 
107 187 203 284 550 611 733 754 860 981 
117 183 184 253 372 373 445 931 1034 1130 
124 155 681 711 712 857 980 1093 1158 1189 
188 260 419 437 512 721 771 974 1068 1275 
295 298 355 370 636 764 937 984 1104 1342 
433 525 602 603 853 859 1081 1262 1292 1317 
482 483 641 642 734 830 924 928 1084 1144 
493 661 662 774 836 918 986 989 1080 1101 
769 862 873 881 976 1153 1190 1274 1284 1316 
51 132 221 227 961 1006 1048 1087 1199 
99 198 199 270 297 335 533 628 973 
110 175 176 233 330 348 517 518 1208 
240 241 261 273 413 495 842 929 1167 
264 293 463 640 691 697 971 1117 1241 
313 469 470 511 521 690 789 941 972 
2 21 451 761 901 1143 1183 1276 
18 178 713 788 1076 1098 1237 1295 
529 664 930 952 977 988 999 1091 
620 621 695 716 717 831 832 1228 
805 806 868 1112 1134 1246 1263 1336 
25 213 214 272 415 610 650 
72 497 705 1166 1175 1232 1350 
73 351 404 651 723 1055 1077 
80 286 319 476 766 858 1054 
153 154 386 1003 1051 1056 1258 
236 371 663 698 1122 1141 1349 
315 586 643 790 837 838 1283 
455 456 740 741 1040 1078 1157 
555 833 834 1150 1151 1184 1257 
67 102 168 251 1058 1059 
159 262 342 926 1138 1248 
177 314 519 585 686 959 
182 290 331 755 975 1005 
237 418 539 818 932 933 
267 968 1025 1090 1230 1303 
357 551 666 855 965 1128 
576 772 966 993 1111 1222 
796 797 824 851 1119 1120 
874 886 919 1017 1018 1280 
39 223 1072 1225 1347 
41 522 904 1021 1214 
54 249 644 848 1182 
96 1012 1100 1162 1209 
108 352 532 784 1315 
131 436 461 841 1233 
139 1026 1027 1116 1185 
211 216 441 753 1103 
231 232 633 638 679 
254 829 1105 1219 1312 
408 431 432 701 905 
491 560 783 852 934 
568 587 731 916 1212 
593 612 613 911 1171 
6 35 246 813 
27 60 100 332 
29 186 671 920 
69 190 682 908 
74 123 727 1002 
77 78 142 1293 
81 218 669 995 
103 541 706 882 
113 114 202 282 
120 1062 1160 1193 
163 316 572 639 
169 226 1067 1169 
192 411 479 887 
196 554 1042 1178 
197 229 283 922 
205 1201 1327 1338 
242 508 544 1211 
279 816 878 940 
326 699 1004 1028 
344 481 577 751 
376 377 584 607 
389 417 707 820 
452 480 605 1186 
509 750 828 1346 
543 1053 1123 1200 
547 939 1163 1179 
571 596 597 1242 
580 629 801 807 
617 618 861 1294 
646 647 1326 1335 
680 1164 1253 1331 
700 719 720 1156 
730 950 1015 1057 
902 903 935 954 
927 1132 1197 1282 
962 963 1047 1269 
1165 1278 1279 1288 
8 289 1022 
10 173 802 
79 768 1066 
92 559 1099 
95 151 1255 
106 145 1270 
109 487 826 
138 670 1206 
156 157 982 
170 363 668 
225 387 510 
256 728 1060 
281 444 870 
304 821 1272 
365 659 1161 
390 530 556 
397 582 1159 
401 921 964 
405 822 1016 
449 592 1061 
450 1043 1196 
458 773 1136 
492 1013 1152 
505 839 840 
514 819 1139 
538 675 738 
553 673 722 
567 777 912 
574 854 890 
637 1121 1140 
992 1224 1243 
1010 1191 1297 
1115 1254 1343 
1220 1221 1287 
