1 12 13 15 22 23 31 32 34 36 37 40 42 43 44 53 55 59 63 64 66 86 87 89 93 94 148 149 174 189 195 208 212 219 220 224 234 235 238 245 250 257 265 269 277 278 296 303 305 306 309 320 322 325 327 339 340 341 349 350 353 354 360 361 366 374 381 388 392 394 403 406 414 421 422 438 467 468 475 501 502 503 515 516 526 535 573 588 594 599 608 619 626 627 649 676 696 724 743 758 765 770 781 787 793 814 817 845 867 871 872 875 877 899 909 936 943 948 953 955 970 979 997 998 1011 1024 1029 1070 1071 1078 1106 1147 1148 1154 1162 1167 1172 1187 1205 1213 1217 1247 1260 1266 1271 1273 1307 1308 1332 1348 
20 65 70 82 88 112 118 124 135 155 204 263 295 321 379 380 395 570 581 589 615 636 699 732 764 804 825 951 984 1000 1104 1114 1146 1189 1305 1314 1325 1342 
115 128 137 144 171 230 248 317 318 426 445 478 486 564 566 616 623 632 692 710 914 915 987 1004 1031 1034 1046 1107 1112 1142 1168 1170 1194 1241 1259 1289 
80 98 101 215 252 286 310 319 345 435 439 459 476 494 552 558 562 584 590 654 655 658 744 756 766 894 895 931 967 1007 1036 1054 1085 
48 56 57 162 191 393 407 460 542 600 624 648 656 657 715 723 742 803 809 969 996 1060 1079 1124 1135 1177 1223 1234 1290 1302 1306 1328 
16 75 83 119 132 259 285 347 430 457 488 489 569 595 625 635 688 779 780 827 861 890 1033 1035 1041 1118 1131 
19 122 140 164 166 167 179 324 391 400 423 427 499 520 563 606 652 726 800 835 906 907 957 1044 1045 
0 68 104 146 258 275 287 338 356 367 383 440 498 548 549 557 583 604 609 893 978 1039 1133 
14 107 187 203 284 332 336 337 396 550 565 611 733 754 759 913 960 981 1050 1236 1329 
84 85 136 201 210 412 424 473 506 531 617 618 702 942 1063 1075 1294 1321 
26 30 97 158 172 173 294 334 429 579 598 693 778 1073 1256 1310 
5 33 133 180 244 301 302 453 454 577 687 944 1175 
54 249 311 644 681 711 712 811 812 848 857 1158 1182 
351 884 885 902 903 935 952 954 977 988 999 1076 1091 
508 769 791 860 862 873 976 1153 1190 1197 1274 1284 1316 
45 72 378 446 496 497 622 746 752 763 815 1173 
105 116 266 398 466 490 775 896 990 1203 1286 1333 
106 110 145 175 176 233 330 348 517 518 1208 1270 
188 260 264 419 437 512 721 771 974 1068 1108 1275 
280 433 504 525 602 603 853 859 1081 1262 1292 1317 
76 165 279 442 630 631 816 863 878 921 940 
152 358 359 425 462 523 665 757 794 910 946 
299 328 536 537 610 684 685 729 1215 1298 1319 
493 661 662 774 836 986 989 1080 1101 1221 1287 
29 139 186 281 370 444 534 671 1026 1116 
141 268 428 434 528 545 634 785 1096 1210 
147 298 471 808 879 880 1065 1082 1083 1110 
177 183 184 373 519 585 668 686 959 1130 
482 483 641 642 734 830 924 928 1084 1144 
529 664 695 730 831 832 930 950 1015 1057 
111 153 255 307 362 375 601 750 1346 
211 216 229 253 283 441 753 922 1103 
509 510 739 799 828 1115 1254 1299 1343 
11 206 207 222 448 694 947 1145 
21 451 761 901 1143 1166 1183 1276 
46 160 402 409 527 718 923 1030 
51 221 227 961 1006 1048 1087 1199 
58 200 329 484 667 703 745 1237 
73 138 404 651 1055 1077 1232 1350 
126 389 390 417 530 556 707 820 
291 346 700 792 1032 1244 1245 1261 
342 576 772 966 993 1111 1222 1248 
364 399 420 513 1064 1149 1227 1240 
567 677 678 740 777 912 956 1157 
629 801 807 869 888 898 1038 1202 
7 474 582 748 1159 1181 1218 
28 62 71 465 532 1001 1330 
67 113 114 168 202 251 1058 
198 199 270 297 335 533 973 
217 505 810 839 840 1019 1086 
236 371 663 698 1122 1141 1349 
292 443 574 575 767 854 1345 
293 463 640 691 697 971 1117 
308 326 591 638 645 737 1023 
315 586 643 790 837 838 1283 
401 450 673 674 964 1043 1196 
555 833 834 1150 1151 1184 1257 
796 797 824 851 1119 1120 1201 
38 276 405 760 919 1052 
52 169 226 949 1067 1169 
69 190 682 786 908 1220 
90 185 500 524 920 1351 
129 130 254 829 1105 1239 
237 418 539 818 932 933 
239 709 958 1069 1204 1277 
267 968 1025 1090 1230 1303 
397 458 578 728 773 1136 
469 470 511 587 972 1049 
593 612 613 881 911 1171 
805 806 868 1246 1263 1336 
1009 1010 1185 1191 1296 1297 
18 546 713 714 1018 
27 60 100 747 870 
41 522 904 1021 1214 
61 96 416 1100 1209 
81 218 256 669 995 
103 541 705 706 882 
127 683 755 849 1229 
131 436 461 841 1233 
154 225 386 387 1056 
300 962 963 1047 1269 
313 521 690 1014 1176 
384 385 749 1088 1089 
464 477 1102 1125 1129 
620 621 716 717 1228 
646 647 1134 1326 1335 
660 1092 1216 1252 1354 
776 846 847 1097 1192 
6 35 246 813 
24 117 856 1008 
25 91 213 214 
39 223 1072 1347 
47 798 980 1094 
50 927 983 1132 
74 123 197 727 
109 487 826 876 
120 1062 1160 1193 
134 735 1198 1231 
159 262 926 1138 
163 316 572 639 
178 788 1098 1295 
182 282 789 941 
196 554 1042 1178 
231 232 633 679 
240 241 273 929 
242 544 1012 1211 
272 415 650 1315 
304 736 821 1272 
323 653 672 782 
343 344 481 751 
369 883 1003 1258 
382 561 991 1281 
455 456 741 1040 
543 1053 1123 1200 
547 939 1163 1179 
568 731 916 1212 
571 596 597 1242 
637 1121 1140 1311 
680 1164 1253 1331 
768 917 918 1304 
855 1128 1165 1288 
992 1224 1225 1243 
2 3 843 
4 1195 1300 
8 289 1022 
9 125 783 
10 802 889 
17 243 1028 
77 78 1293 
92 559 1099 
95 151 1255 
99 628 720 
108 352 784 
121 1005 1318 
142 1264 1344 
150 994 1020 
156 157 982 
161 897 1320 
181 271 1186 
192 411 887 
205 1327 1338 
261 413 495 
274 1155 1235 
288 368 580 
290 331 975 
314 689 866 
333 472 985 
355 937 1282 
357 372 551 
365 659 1161 
376 377 607 
408 701 905 
410 850 1291 
449 592 1061 
452 480 605 
479 1278 1279 
491 934 1051 
492 1013 1152 
514 819 1139 
538 675 738 
540 1226 1285 
560 852 886 
666 822 1016 
874 1017 1280 
1002 1188 1324 
1037 1265 1301 
