4 5 7 10 11 26 30 33 38 48 56 57 97 106 108 110 115 118 126 128 131 133 137 138 144 145 158 161 162 171 172 173 176 180 188 191 206 207 210 222 230 233 237 244 248 260 282 288 294 301 302 317 318 334 348 352 368 389 390 393 395 397 407 410 417 418 419 426 429 436 437 445 447 448 449 453 454 458 460 461 474 478 485 486 500 510 512 530 539 542 553 556 564 566 569 577 580 592 598 600 607 616 623 624 648 656 670 687 692 693 694 704 707 708 710 715 722 723 728 739 742 748 771 773 778 784 802 803 809 820 841 850 889 897 914 915 919 932 933 944 945 947 951 969 974 985 987 996 1031 1034 1046 1050 1052 1060 1061 1063 1068 1073 1079 1105 1107 1108 1112 1115 1124 1135 1136 1142 1145 1168 1170 1175 1177 1194 1195 1206 1208 1223 1233 1234 1241 1254 1259 1270 1275 1278 1279 1289 1290 1291 1299 1300 1302 1306 1310 1313 1320 1328 1339 1343 
1 12 13 15 22 23 31 32 34 36 37 40 42 43 44 53 55 59 63 64 66 79 83 86 87 89 93 94 111 148 149 153 165 174 178 189 195 208 212 219 220 224 234 235 238 245 250 255 257 259 264 265 269 277 278 285 296 303 304 305 306 307 308 309 320 322 325 327 339 340 341 347 349 350 353 354 355 360 361 362 366 374 375 381 388 392 394 403 406 414 421 422 430 438 442 467 468 475 501 502 503 515 516 526 535 573 588 594 595 599 601 608 619 626 627 631 649 676 688 724 736 743 758 765 770 781 787 793 814 817 818 821 827 845 867 871 872 875 877 899 909 910 936 943 948 953 955 970 979 997 998 1011 1024 1029 1037 1066 1070 1071 1106 1147 1148 1154 1162 1172 1187 1198 1205 1213 1217 1247 1260 1265 1266 1271 1272 1273 1301 1307 1308 1309 1332 1334 1348 
20 46 52 54 65 70 82 88 112 124 135 139 141 155 160 169 175 194 204 211 217 226 236 239 249 254 256 263 268 295 321 323 326 330 370 371 379 380 402 409 434 441 482 483 491 505 517 518 527 528 545 560 570 581 589 591 615 628 636 638 639 641 642 644 653 663 672 681 698 699 711 712 720 721 732 737 753 764 782 783 785 804 811 812 829 830 848 852 857 920 923 924 928 931 934 937 949 958 984 1004 1009 1010 1023 1026 1030 1051 1067 1069 1084 1093 1096 1104 1114 1116 1122 1141 1144 1158 1182 1185 1189 1191 1210 1282 1296 1297 1305 1325 1342 1349 
3 6 17 35 41 80 98 99 101 134 152 154 156 157 170 177 183 184 193 198 199 209 215 225 243 246 252 270 286 297 310 311 314 335 345 358 359 363 369 373 382 384 385 386 424 425 435 439 459 462 476 494 519 522 523 533 552 558 561 562 572 585 590 654 655 658 665 668 686 689 735 744 749 750 756 757 794 795 813 843 858 864 866 883 894 900 904 946 959 967 973 982 991 1003 1007 1021 1028 1036 1056 1074 1085 1088 1089 1130 1181 1188 1214 1218 1219 1231 1258 1277 1281 1312 1324 1346 
25 47 90 91 92 105 116 117 147 213 214 266 272 280 291 298 299 328 346 387 398 433 455 456 466 471 490 504 525 536 537 559 602 603 610 629 680 684 685 729 741 775 776 792 798 801 807 808 844 846 847 853 859 869 879 880 888 896 898 922 980 990 1032 1038 1040 1065 1081 1082 1083 1094 1097 1099 1110 1137 1164 1169 1192 1202 1203 1215 1244 1245 1253 1261 1262 1267 1268 1286 1292 1298 1311 1317 1319 1331 1333 
14 29 50 74 107 123 163 186 187 196 203 228 247 267 281 284 316 332 336 337 396 428 444 479 534 550 554 565 593 611 612 613 634 660 671 709 718 727 733 734 754 759 768 769 791 810 825 839 840 860 862 873 881 911 913 917 918 927 939 960 968 976 981 983 1002 1019 1025 1042 1086 1090 1092 1132 1153 1171 1178 1179 1190 1197 1204 1216 1230 1236 1252 1274 1284 1303 1304 1314 1316 1329 1340 1341 1354 
16 39 51 75 81 119 132 159 192 202 205 218 221 223 227 262 315 319 342 405 411 415 457 464 477 488 489 568 576 579 586 625 632 635 643 650 669 700 719 766 772 779 780 790 837 838 861 886 887 890 895 926 961 966 993 995 1006 1033 1035 1041 1072 1087 1095 1102 1111 1118 1125 1129 1131 1138 1146 1156 1180 1199 1222 1248 1256 1283 1315 1327 1338 1347 
8 61 96 102 129 130 150 216 229 240 241 242 253 273 274 283 289 364 376 377 399 416 420 492 507 508 509 513 544 555 567 578 584 677 678 725 740 777 796 797 799 823 824 828 851 854 870 874 912 925 929 956 994 1012 1013 1017 1020 1022 1054 1059 1064 1078 1100 1103 1119 1120 1149 1152 1155 1157 1184 1201 1209 1211 1227 1235 1238 1239 1240 1280 
27 60 100 121 127 168 181 182 185 271 290 312 313 331 333 357 372 469 470 472 511 521 524 543 547 551 587 605 637 666 683 690 696 731 747 755 789 822 849 855 916 938 941 965 972 975 1000 1005 1014 1016 1049 1053 1058 1121 1123 1128 1140 1163 1165 1176 1200 1212 1229 1288 1318 1322 1323 1351 
0 19 67 68 69 104 122 140 146 164 166 167 179 190 251 258 275 287 293 324 338 356 367 383 391 400 423 427 440 463 498 499 520 548 549 557 563 582 583 604 606 609 640 652 682 691 697 726 786 800 835 893 906 907 908 957 971 978 1039 1044 1045 1117 1159 1220 
24 73 77 78 136 292 351 404 443 452 480 493 529 574 575 614 620 621 645 651 657 661 662 664 695 716 717 730 767 774 831 832 856 884 885 902 903 930 935 950 952 954 977 986 988 989 999 1008 1015 1055 1057 1076 1077 1080 1091 1101 1133 1186 1207 1228 1232 1293 1345 1350 
18 28 45 62 71 72 95 120 151 231 232 365 378 408 431 432 446 465 496 497 532 546 571 596 597 622 633 659 679 701 713 714 746 752 763 788 815 891 892 905 992 1001 1018 1048 1062 1098 1109 1113 1160 1161 1173 1193 1224 1225 1242 1243 1255 1295 1330 
2 9 21 49 76 103 125 197 261 279 401 413 450 451 495 540 541 630 673 674 705 761 762 816 842 863 878 882 901 921 940 964 1027 1043 1143 1166 1167 1183 1196 1226 1276 1285 
113 114 142 143 276 343 344 481 538 675 706 738 751 760 833 834 836 1150 1151 1221 1257 1264 1287 1337 1344 
84 85 201 300 412 473 506 531 617 618 702 942 962 963 1047 1075 1269 1294 1321 
109 487 646 647 805 806 826 868 876 1134 1246 1263 1326 1335 1336 
58 200 329 484 514 667 703 745 819 865 1139 1237 1249 
