1 12 13 15 22 23 32 34 36 37 40 42 43 44 53 55 59 63 66 79 83 86 87 89 93 94 111 120 148 149 153 174 178 189 195 208 212 219 220 224 234 235 238 245 250 255 257 258 269 277 278 285 296 303 305 306 307 308 309 320 322 325 327 339 340 341 349 350 353 354 355 360 361 362 374 375 381 388 392 403 406 414 421 422 430 438 467 468 475 501 502 503 514 515 516 526 535 573 588 594 599 608 619 626 627 649 688 736 743 758 765 787 793 845 871 872 875 877 899 909 936 955 970 979 997 998 1024 1029 1037 1040 1066 1071 1106 1147 1148 1154 1162 1172 1178 1187 1193 1247 1260 1265 1266 1273 1301 1332 1348 
19 67 68 69 101 122 140 146 164 166 167 179 190 236 251 287 324 358 391 400 423 427 470 499 520 583 640 652 663 682 726 786 800 835 906 907 908 957 971 1044 1045 1085 1145 1168 1220 
48 56 103 162 191 393 407 460 542 584 600 624 648 656 657 715 723 742 803 809 890 969 996 1060 1124 1135 1170 1177 1223 1233 1234 1270 1290 1302 1306 1328 
20 65 70 88 112 124 135 155 204 256 263 321 379 395 570 581 589 601 615 711 712 732 804 825 980 1094 1114 1158 1160 1189 1198 1305 1325 
57 128 137 171 213 237 248 317 318 426 437 445 478 486 564 566 616 623 632 692 710 915 987 1034 1107 1142 1194 1241 1310 
46 121 141 160 268 323 402 409 425 434 456 461 505 527 528 545 653 672 718 782 785 801 839 840 923 1030 1096 1318 
45 71 72 158 207 378 446 496 497 579 622 746 748 752 763 815 889 1173 1210 1256 
139 281 282 295 326 370 591 636 638 639 699 737 764 914 937 1023 1026 1046 1104 1116 
0 104 275 338 356 367 440 498 548 549 557 582 604 609 893 978 1039 1159 
14 107 187 203 336 337 396 565 611 709 733 754 759 913 1204 1236 1329 
47 92 147 298 394 471 559 676 798 807 808 879 880 1065 1079 1082 1083 
5 30 33 126 133 173 180 288 301 302 368 454 577 802 985 1175 
16 119 132 457 488 489 504 568 625 635 779 780 861 1035 1041 1118 
3 76 115 369 382 384 385 749 843 883 925 1004 1088 1089 1259 
84 85 201 300 412 473 506 531 617 618 702 942 956 1294 1321 
96 769 860 873 881 939 976 1033 1153 1190 1209 1274 1284 1316 
217 482 641 642 734 830 917 918 924 928 1019 1084 1144 1304 
182 313 333 405 469 511 521 586 587 690 822 1016 1163 
280 387 433 620 717 776 846 847 859 888 1097 1192 1317 
401 408 431 432 450 673 674 701 722 921 964 1043 1196 
24 684 685 729 781 856 929 1215 1279 1298 1307 1308 
25 91 214 272 299 328 536 537 610 1169 1319 
51 52 221 227 228 961 1006 1048 1087 1146 1199 
61 376 377 607 876 896 972 990 1001 1100 1286 
576 738 772 833 834 966 993 1111 1151 1222 1257 
106 175 176 233 347 512 517 771 819 1275 
152 523 665 757 794 867 1181 1218 1219 1312 
168 202 319 435 558 561 766 991 1058 1281 
2 21 451 761 901 1143 1166 1183 1276 
26 172 429 598 687 693 951 992 1020 
31 64 770 943 948 953 1205 1213 1271 
181 185 524 683 755 849 1229 1243 1351 
241 261 413 495 724 842 1027 1070 1167 
7 110 397 474 728 773 945 1136 
11 206 222 448 500 694 946 947 
18 546 713 714 788 905 1098 1295 
58 200 329 667 983 1139 1237 1342 
73 266 404 651 1055 1077 1232 1350 
77 78 661 662 989 1101 1217 1293 
108 118 161 259 352 784 817 1320 
113 114 458 525 760 960 1132 1282 
211 216 229 253 283 441 753 1103 
294 334 357 389 417 704 707 820 
529 645 664 930 952 977 999 1091 
739 740 1078 1115 1157 1254 1299 1343 
27 60 100 271 332 747 778 
62 286 646 874 1011 1330 1335 
105 116 398 466 775 1203 1333 
109 151 487 826 1109 1113 1255 
188 260 348 419 721 1068 1208 
215 459 494 590 744 756 894 
252 310 311 562 654 655 1036 
428 631 634 868 1112 1246 1263 
39 223 1049 1072 1108 1347 
127 629 869 898 1038 1202 
129 130 254 829 1105 1239 
154 225 386 1003 1056 1258 
159 262 342 926 1138 1248 
169 226 550 949 981 1067 
177 424 519 585 686 959 
198 270 297 335 533 973 
240 273 274 1155 1235 1288 
249 644 681 811 812 857 
267 968 1025 1090 1230 1303 
290 331 696 975 1000 1005 
364 399 420 513 1064 1227 
373 659 660 1092 1216 1354 
415 650 824 1119 1120 1315 
483 705 706 882 887 1031 
621 695 716 831 832 1228 
1009 1010 1185 1191 1296 1297 
29 186 444 534 671 
38 145 210 1052 1063 
41 522 904 1021 1214 
117 291 553 922 931 
156 157 791 982 1197 
197 540 541 1226 1285 
218 669 995 1102 1125 
293 463 691 697 1117 
346 792 1244 1245 1261 
371 698 1122 1141 1349 
418 539 897 932 933 
509 510 750 828 1346 
567 677 678 777 912 
569 647 1050 1134 1326 
919 1017 1018 1099 1280 
6 246 383 813 
35 314 689 895 
74 123 727 1002 
75 464 477 1129 
97 485 1028 1032 
150 555 799 1150 
165 442 814 816 
196 554 927 1042 
205 1201 1327 1338 
231 232 633 679 
239 602 958 1069 
242 508 544 1211 
264 265 818 910 
276 836 1221 1287 
343 344 481 751 
351 954 988 1076 
372 551 666 965 
390 731 916 1212 
452 480 605 1186 
455 741 844 1137 
543 1053 1123 1200 
571 596 597 1242 
574 767 1133 1345 
680 1164 1253 1331 
730 950 1015 1057 
789 941 1289 1300 
796 797 850 851 
891 892 1224 1225 
8 289 1022 
9 125 279 
17 243 1291 
28 465 532 
49 603 762 
54 848 1182 
80 476 1054 
82 866 1007 
90 1110 1311 
95 703 745 
98 986 1080 
131 436 841 
134 735 1231 
136 193 1074 
138 670 1184 
142 1264 1344 
144 563 606 
163 316 572 
183 184 1130 
192 411 700 
209 247 900 
304 821 1272 
315 643 790 
330 518 920 
365 1051 1161 
439 1008 1252 
447 530 556 
449 592 1061 
453 768 944 
472 547 1179 
479 493 774 
484 1149 1240 
490 578 870 
491 783 934 
492 1013 1152 
593 612 911 
595 827 1206 
630 863 1073 
637 1121 1140 
805 806 1336 
837 838 1283 
854 994 1012 
855 1128 1165 
902 903 1047 
962 963 1269 
967 974 1062 
1081 1262 1292 
