0 1 12 13 22 23 32 36 37 42 43 48 53 55 59 63 64 65 66 75 79 86 87 88 93 94 108 111 112 155 174 189 195 200 208 212 218 219 220 234 235 242 245 250 255 256 257 259 269 272 277 278 296 303 304 305 306 308 309 321 322 327 339 340 341 349 353 355 360 361 374 379 381 388 403 415 416 421 433 443 467 468 473 475 502 503 504 508 526 573 588 594 599 608 625 626 627 656 681 724 728 736 751 770 786 798 803 812 866 867 873 890 899 923 926 936 942 952 953 980 1061 1106 1114 1136 1137 1138 1147 1159 1160 1167 1168 1187 1206 1213 1234 1247 1248 1270 1306 1325 
6 7 25 29 34 35 40 58 67 73 74 76 80 81 83 84 85 123 132 142 147 148 157 168 169 177 190 284 285 307 314 315 328 329 382 384 398 401 402 408 412 424 457 466 484 488 515 516 519 531 545 546 547 584 585 586 607 629 649 663 667 668 686 688 700 745 758 775 788 807 832 837 838 843 844 846 847 852 865 874 875 883 886 887 900 994 1024 1058 1078 1081 1085 1089 1094 1102 1111 1124 1125 1131 1162 1176 1193 1202 1260 1271 1273 1283 1294 1295 1315 1332 1333 
10 31 47 56 69 99 100 120 125 126 131 135 156 158 159 160 172 173 196 231 236 237 248 268 275 288 294 295 326 352 358 359 378 394 395 409 410 425 428 429 430 434 442 455 456 461 462 463 471 495 523 527 528 534 539 595 636 638 640 648 665 670 697 718 737 742 747 757 773 794 840 841 850 851 861 863 897 905 927 933 941 943 951 969 971 976 992 996 1008 1020 1021 1064 1073 1088 1096 1103 1117 1141 1173 1177 1194 1210 1214 1223 1233 1243 1253 
8 9 20 101 102 124 146 187 188 202 203 211 216 217 221 229 230 246 247 252 262 263 276 319 320 332 333 334 345 354 357 365 399 431 435 440 441 476 491 492 505 550 551 558 560 561 592 619 622 632 635 698 733 735 753 754 756 766 783 823 860 862 870 935 975 981 987 995 1002 1029 1036 1038 1067 1087 1098 1121 1129 1281 
4 27 30 46 68 82 91 92 121 122 134 141 152 166 179 193 253 289 323 324 376 426 427 451 452 464 470 494 511 520 535 556 572 590 610 637 639 652 655 658 669 704 744 778 795 818 821 835 845 856 910 925 931 972 1007 1030 1044 1045 1049 1072 1211 
28 44 49 60 89 117 181 182 185 186 316 317 370 371 372 373 444 445 465 479 532 587 618 659 660 666 671 683 699 714 755 764 782 790 810 822 849 916 937 964 965 983 1005 1019 1034 1053 1054 1066 1074 1104 1123 1140 1161 1181 1199 1200 1216 1342 1354 
14 15 115 267 396 513 565 596 646 647 743 759 805 806 826 868 906 907 913 968 1004 1025 1050 1090 1134 1153 1158 1230 1236 1242 1246 1263 1266 1276 1303 1326 1335 1336 
2 3 21 105 106 109 110 176 224 233 260 261 347 348 393 419 420 437 512 571 597 634 715 771 809 819 901 915 974 1083 1142 1143 1183 1208 1275 
127 128 136 137 170 171 191 192 223 264 265 460 477 478 486 487 542 564 616 623 624 691 692 710 721 1068 1107 1108 1112 1135 1241 1290 1302 1347 
5 26 33 45 97 98 130 133 161 180 243 244 254 271 279 301 302 453 454 498 577 598 687 693 802 932 944 985 1175 1312 
258 293 318 338 350 356 367 383 540 548 549 557 582 583 602 604 609 696 855 869 893 940 978 1039 1178 1269 1310 
70 71 72 238 239 446 496 497 501 552 605 653 672 746 748 752 785 801 815 892 979 991 1195 1217 1293 
153 154 226 273 386 387 536 537 600 601 750 827 828 903 998 1003 1056 1057 1154 1169 1258 1264 1319 1346 
509 510 555 567 568 645 739 740 741 792 799 854 884 885 956 977 1013 1059 1152 1157 1244 1245 1261 1277 
11 118 119 140 167 207 222 391 392 448 499 570 589 615 726 797 800 804 889 946 947 1042 1079 
77 144 145 175 201 209 210 281 282 569 591 611 898 914 1046 1051 1052 1063 1075 1105 
17 162 163 389 390 417 418 538 707 708 719 720 763 820 945 1093 1186 1291 
57 103 104 197 251 472 541 676 703 706 727 904 922 982 1031 1060 1170 
164 165 414 576 580 630 631 738 772 814 816 833 834 878 1012 1113 1192 
61 62 266 651 876 877 896 990 1001 1011 1100 1203 1259 1286 1318 1330 
206 249 342 514 643 644 732 811 848 857 1122 1145 1182 1189 1198 1349 
41 500 524 657 675 774 961 1092 1166 1220 1229 1232 1252 1350 1351 
312 313 469 521 522 554 633 690 789 1014 1016 1055 1128 1163 1285 
225 300 368 369 506 702 749 765 781 817 1265 1307 1308 1321 
364 411 614 731 808 864 879 880 962 963 1065 1082 1235 1287 
54 95 96 149 204 205 490 563 578 579 997 1146 1256 
116 480 620 621 716 717 730 831 949 950 1015 1047 1228 
432 449 673 674 701 705 722 723 921 938 1043 1196 1320 
38 39 404 405 713 919 1062 1207 1224 1225 1278 1344 
215 310 311 325 362 438 439 459 562 654 882 1028 
107 194 290 400 413 423 628 957 1212 1231 1348 
482 483 641 642 734 829 830 924 928 1084 1144 
198 199 270 297 298 335 533 958 959 973 
283 529 530 664 694 695 930 999 1035 1317 
24 684 685 729 929 1172 1215 1279 1298 
178 351 784 954 988 1076 1077 1080 1237 
213 214 336 397 474 581 1040 1328 1329 
138 139 375 881 934 967 1171 1185 
292 574 575 767 1110 1133 1311 1345 
650 725 796 824 912 1119 1120 1201 
679 680 1155 1164 1165 1288 1305 1331 
18 19 299 553 559 566 787 
51 52 227 228 1022 1023 1048 
113 366 525 836 986 1139 1221 
183 184 337 709 1069 1130 1204 
593 612 613 791 911 1109 1197 
769 939 1179 1190 1274 1284 1316 
16 489 779 780 1041 1118 
286 287 682 858 908 1249 
330 331 517 518 1018 1184 
450 1000 1086 1116 1156 1255 
458 760 960 1132 1222 1282 
493 661 662 918 989 1101 
129 606 891 1238 1239 
291 346 825 948 1032 
406 407 617 1205 1272 
422 902 993 1091 1240 
436 689 894 895 1006 
711 712 842 1026 1027 
871 872 1037 1148 1301 
1009 1010 1191 1296 1297 
240 241 274 385 
280 888 1097 1149 
603 761 762 793 
677 678 776 777 
853 1033 1262 1292 
1115 1254 1299 1343 
50 1017 1314 
114 813 909 
150 151 377 
232 507 1209 
343 344 481 
363 380 966 
447 485 984 
768 917 1304 
955 1327 1338 
1126 1127 1174 
1150 1151 1257 
