0 1 6 7 11 12 22 34 36 40 41 58 73 74 76 77 84 88 119 148 153 154 165 169 201 208 210 220 225 226 227 272 292 299 305 312 315 317 324 328 329 331 334 360 368 369 376 381 382 384 386 387 401 412 421 433 464 475 478 484 491 503 506 513 516 518 520 521 526 532 537 545 547 555 570 573 579 584 585 586 593 600 601 607 627 630 631 632 650 663 672 686 690 694 695 703 729 740 741 746 749 750 767 781 789 790 792 814 816 832 837 838 844 846 854 865 869 875 876 877 885 900 903 908 920 956 957 982 988 994 1003 1011 1014 1016 1020 1024 1041 1051 1054 1055 1056 1057 1058 1059 1063 1078 1081 1095 1102 1106 1114 1125 1129 1145 1149 1157 1162 1163 1169 1180 1184 1193 1215 1240 1244 1245 1256 1258 1260 1261 1265 1273 1283 1293 1294 1319 1332 1345 1346 1348 
4 10 18 33 44 45 65 70 98 100 123 131 149 152 160 161 172 180 184 190 215 221 239 243 244 254 265 271 279 291 295 301 302 358 359 394 395 400 406 407 423 425 429 432 439 447 454 461 462 466 471 482 483 485 490 515 523 541 543 554 608 618 626 641 642 665 674 683 693 709 732 737 747 756 784 794 802 818 829 830 851 889 892 897 916 924 928 933 944 946 948 952 954 961 976 983 1021 1028 1029 1043 1053 1064 1069 1073 1084 1091 1105 1122 1123 1130 1141 1144 1147 1178 1200 1204 1233 1277 1312 1320 1333 1349 
27 48 56 57 105 118 127 128 137 140 141 159 170 171 189 191 206 207 233 238 264 281 339 341 391 393 398 408 416 446 458 460 477 486 487 496 499 512 534 542 552 564 567 571 616 623 624 645 649 656 691 692 696 714 715 726 773 775 785 797 809 835 867 884 947 966 969 977 1000 1079 1107 1108 1124 1135 1177 1234 1241 1272 1290 1302 1306 
9 80 103 104 125 126 156 173 174 182 185 186 196 197 198 199 209 234 268 270 282 290 293 294 297 298 335 357 371 404 434 442 472 495 533 551 636 640 648 651 666 673 697 698 723 727 757 782 822 843 904 905 938 941 951 958 959 964 971 973 984 992 996 1002 1013 1023 1048 1087 1104 1117 1161 1188 1199 1210 1222 1224 1243 1248 1324 1342 
54 72 87 93 135 144 147 166 187 200 202 204 230 248 263 276 318 378 420 431 476 509 510 530 558 563 566 602 677 678 687 689 725 739 764 776 796 799 821 824 828 852 855 866 880 912 915 921 987 1031 1065 1082 1083 1093 1110 1119 1120 1168 1194 1201 1252 1289 1305 1317 1343 
28 29 32 38 49 50 71 217 232 261 350 405 413 465 479 501 522 588 612 613 679 680 713 734 735 738 777 810 812 842 853 873 911 919 927 960 1018 1019 1033 1052 1062 1086 1088 1089 1092 1109 1115 1132 1153 1155 1164 1176 1197 1254 1262 1278 1280 1292 1299 1316 1340 1341 
5 75 81 82 83 97 111 132 136 138 155 256 259 285 288 296 307 347 354 356 362 375 379 380 383 396 397 473 474 488 556 557 561 569 578 581 582 595 598 625 652 676 688 707 710 721 748 786 787 795 995 1038 1044 1050 1060 1077 1131 1159 1211 
66 101 124 203 211 229 240 241 262 273 280 314 319 320 332 345 365 366 388 410 435 440 441 480 492 502 504 550 560 599 622 659 744 753 754 766 770 783 801 807 813 847 850 888 898 929 981 1097 1192 1202 1271 1291 
8 20 21 30 31 46 69 96 112 195 205 231 249 275 308 340 409 419 428 436 507 511 528 539 634 643 644 718 728 839 840 862 894 895 899 901 935 943 953 970 978 1006 1039 1143 1187 1205 1209 1247 1310 1325 
14 15 109 115 116 267 300 326 565 596 611 646 647 699 743 805 806 826 868 913 962 963 968 1004 1025 1047 1070 1071 1090 1112 1134 1158 1203 1230 1236 1242 1259 1263 1266 1269 1286 1303 1309 1326 1334 1335 1336 
24 117 121 122 242 253 277 316 372 426 445 452 453 517 572 590 639 658 669 671 704 745 755 768 769 778 779 825 845 856 910 917 918 931 936 939 1005 1034 1066 1142 1179 1190 1274 1284 1314 
107 108 113 114 158 164 167 214 228 247 257 284 322 338 385 389 392 451 525 531 548 589 594 603 615 653 667 668 733 752 761 762 793 841 860 902 967 999 1036 1103 1276 
16 78 274 422 493 494 535 536 587 609 610 614 633 661 662 831 836 871 955 986 989 1101 1136 1148 1235 1301 1338 
17 39 68 193 194 377 402 469 470 620 621 657 670 716 717 815 881 923 934 1022 1030 1049 1156 1206 1214 1225 1231 
91 92 266 343 414 463 559 568 654 682 731 774 896 906 907 940 990 1045 1099 1152 1212 1246 
35 177 178 237 283 333 351 529 660 664 788 922 930 932 985 991 1076 1216 1237 1295 1354 
23 61 62 85 86 309 424 701 817 863 942 1012 1100 1113 1133 1195 1196 1300 1330 
37 139 216 303 355 367 544 937 1009 1010 1026 1027 1116 1185 1191 1282 1296 1297 
42 59 64 212 218 457 575 635 724 780 800 803 804 997 1035 1042 
43 89 90 94 222 245 278 361 604 730 909 993 1046 1085 1140 1311 
47 269 327 349 352 353 508 637 798 980 1075 1094 1315 1322 1323 1331 
120 133 255 286 468 500 524 849 1160 1166 1171 1175 1229 1232 1350 1351 
146 250 287 310 311 448 655 706 808 858 882 965 1015 1249 1264 1344 
150 346 827 833 834 864 998 1008 1032 1118 1150 1151 1154 1167 1257 1321 
19 134 179 427 553 562 619 722 742 765 1007 1061 1198 1307 1308 
26 60 67 390 417 444 459 497 527 848 859 870 1080 1304 1318 
55 162 163 181 289 403 418 538 708 763 820 945 1186 1213 
3 129 130 325 591 606 638 891 1001 1173 1183 1238 1239 
13 63 252 304 342 344 438 577 872 979 1037 1189 1217 
106 145 176 188 224 260 313 437 771 914 1068 1208 1270 
455 456 481 592 791 823 925 972 1040 1098 1253 1267 1268 
2 246 363 364 514 681 811 819 857 1139 1182 1281 
79 219 235 323 430 443 574 580 583 705 890 1072 
183 373 374 519 700 702 719 720 926 1074 1096 
25 53 192 213 306 370 415 467 605 975 
52 95 151 450 772 949 950 1067 1111 1255 
99 617 628 629 711 712 736 861 1137 1138 
110 175 321 330 348 489 546 1275 1313 1339 
157 236 576 675 758 878 1128 1220 1221 1287 
336 337 411 759 879 883 887 1327 1329 
751 760 893 1181 1207 1218 1219 1223 1328 
51 142 143 223 597 1146 1337 1347 
258 498 549 684 1165 1279 1288 1298 
399 505 874 886 974 1017 1172 1228 
449 540 1170 1226 1227 1285 
102 168 251 685 1121 
