1 12 13 15 22 23 31 32 34 36 37 40 42 43 44 53 55 59 63 64 66 86 87 89 90 93 94 148 149 165 174 189 195 208 212 219 220 224 234 235 238 245 250 257 265 269 277 278 296 303 305 306 308 309 320 322 325 327 339 340 341 349 350 353 354 360 361 366 374 381 388 392 403 406 414 421 422 438 442 467 468 475 501 502 503 515 516 526 535 573 588 591 594 599 608 619 626 627 631 638 645 649 676 696 724 743 758 765 770 781 787 793 814 817 845 867 871 872 875 877 899 909 936 943 948 953 955 960 970 979 997 1011 1023 1029 1037 1070 1071 1078 1106 1147 1148 1172 1187 1205 1213 1217 1247 1260 1266 1271 1273 1301 1307 1308 1332 1348 
98 101 152 215 239 252 310 326 358 359 425 435 439 459 462 494 523 552 558 590 654 655 665 709 744 756 757 794 910 946 958 1007 1036 1069 1080 1204 1277 
5 26 30 33 97 126 133 158 172 180 244 288 294 301 302 334 356 368 395 410 429 453 454 577 579 598 687 693 778 889 944 985 1073 1256 1310 
48 56 57 162 191 393 407 460 542 595 600 624 648 656 657 673 715 723 742 803 809 827 969 996 1060 1124 1135 1177 1223 1234 1290 1302 1306 
19 68 122 140 164 166 167 179 236 324 391 400 423 427 499 520 563 583 606 652 663 726 800 835 906 907 957 1044 1045 1133 1231 
16 75 83 119 132 153 255 259 285 307 347 375 430 457 488 489 569 625 635 688 736 779 780 861 890 1033 1035 1041 1118 1131 
128 137 171 230 248 317 318 426 478 486 564 566 616 623 632 692 710 739 915 987 1031 1046 1107 1142 1168 1170 1194 1241 1289 
14 107 187 203 284 336 337 396 550 565 611 733 754 759 913 981 1050 1236 1329 1344 
84 85 136 144 201 210 412 424 473 506 531 617 618 702 914 942 1063 1075 1294 1321 
70 129 130 254 482 483 641 642 734 825 829 830 924 928 1084 1105 1144 1239 1314 
45 72 120 378 446 496 497 622 746 752 763 815 891 892 1062 1160 1173 1193 
0 104 258 275 338 367 383 440 498 548 549 557 604 609 893 978 1039 
105 116 266 291 346 398 466 490 775 896 990 1032 1203 1286 1333 
54 249 311 644 681 711 712 811 812 848 857 1158 1182 
769 791 860 862 873 939 976 1153 1190 1197 1274 1284 1316 
27 60 100 217 271 332 505 747 839 840 870 1019 
82 135 155 204 570 581 601 615 737 951 1114 1305 
10 11 206 207 222 448 694 714 947 1079 1145 
20 65 124 263 379 380 589 732 804 1189 1325 
147 298 394 471 808 879 880 1065 1082 1083 1110 
188 260 419 437 512 721 771 974 1068 1108 1275 
237 389 417 418 539 704 707 820 932 933 945 
299 328 536 537 610 684 685 729 1215 1298 1319 
110 175 176 233 264 330 348 517 518 1208 
115 805 806 868 1004 1112 1246 1259 1263 1336 
141 268 434 528 534 545 653 672 785 1210 
433 525 602 603 853 859 1081 1262 1292 1317 
7 458 474 728 748 773 1136 1181 1328 
24 117 445 856 931 1008 1034 1232 1350 
51 315 586 643 790 837 838 1146 1283 
67 102 113 114 168 202 251 1058 1059 
88 280 677 678 776 846 847 1097 1192 
139 295 370 636 699 764 1026 1104 1116 
21 451 761 901 1143 1166 1183 1276 
69 146 190 287 682 786 908 1220 
154 225 386 387 509 510 828 1056 
177 314 519 585 686 689 866 959 
364 399 420 513 1064 1149 1227 1240 
493 661 662 774 836 986 989 1101 
620 621 695 716 717 831 832 1228 
25 91 213 214 272 415 650 
46 409 527 718 818 923 1096 
58 200 329 484 667 703 745 
73 404 614 651 1055 1077 1207 
76 279 630 816 863 878 940 
159 262 342 504 926 1138 1248 
211 216 229 283 441 753 1103 
292 443 574 575 767 854 1345 
293 463 640 691 697 971 1117 
351 902 903 935 954 988 1091 
369 750 883 1003 1258 1265 1346 
401 450 674 921 964 1043 1196 
28 62 465 532 1001 1330 
81 111 218 256 669 995 
178 788 1076 1098 1237 1295 
181 185 500 524 849 1351 
198 270 297 335 533 973 
221 227 961 1006 1087 1199 
241 261 413 495 842 1027 
267 968 1025 1090 1230 1303 
312 313 521 690 789 938 
321 869 888 898 1038 1202 
491 560 783 852 934 1051 
529 664 930 952 977 999 
567 740 777 912 956 1157 
593 612 613 881 911 1171 
796 797 824 851 1119 1120 
1009 1010 1185 1191 1296 1297 
38 276 405 760 1052 
41 522 904 1021 1214 
103 541 705 706 882 
109 487 826 876 1134 
121 253 372 1005 1318 
131 436 461 841 1233 
160 323 402 782 1030 
300 962 963 1047 1269 
362 792 1244 1245 1261 
371 698 1122 1141 1349 
382 561 562 991 1281 
464 477 1102 1125 1129 
469 470 511 972 1049 
568 587 731 916 1212 
660 1092 1216 1252 1354 
833 834 1150 1151 1257 
874 886 1017 1018 1280 
992 1048 1224 1225 1243 
9 125 319 766 
18 546 713 1299 
29 186 671 920 
39 223 1072 1347 
47 798 980 1094 
61 96 1100 1209 
74 123 727 1002 
80 286 476 967 
108 352 784 1315 
112 169 226 1169 
127 683 755 1229 
138 390 530 556 
163 316 572 639 
183 184 373 1130 
192 411 479 887 
196 554 1042 1178 
205 1201 1327 1338 
231 232 633 679 
242 508 544 1211 
281 428 444 634 
343 344 481 751 
384 385 1088 1089 
452 480 605 1186 
455 456 741 1040 
543 1053 1123 1200 
571 596 597 1242 
580 629 801 807 
637 1121 1140 1311 
646 647 1326 1335 
680 1164 1253 1331 
730 950 1015 1057 
768 917 918 1304 
855 1128 1165 1288 
998 1024 1154 1167 
2 3 843 
4 1195 1300 
6 246 813 
8 289 1022 
17 243 1028 
35 197 922 
52 949 1067 
77 78 1293 
95 151 1255 
106 145 1270 
134 735 1198 
142 738 1264 
150 994 1020 
156 157 982 
161 897 1320 
170 363 668 
173 802 1175 
182 282 941 
240 273 929 
274 1155 1235 
290 331 975 
304 821 1272 
355 937 1282 
357 551 965 
365 659 1161 
376 377 607 
397 582 1159 
408 701 905 
416 823 925 
449 592 1061 
492 1013 1152 
514 819 1139 
540 1226 1285 
547 1163 1179 
553 559 722 
555 578 1184 
576 772 1111 
584 1054 1085 
666 822 1016 
700 719 1156 
795 858 864 
919 1278 1279 
927 983 1132 
966 993 1222 
1115 1254 1343 
1218 1219 1312 
