1 12 22 34 36 40 88 119 148 149 165 169 208 220 227 245 292 324 381 412 421 433 464 475 477 503 513 516 526 541 570 573 585 600 627 630 686 695 749 781 792 814 832 854 899 908 957 988 1011 1058 1078 1081 1129 1157 1240 1261 1271 1273 1294 1332 1335 1348 
18 44 47 65 100 123 131 152 190 215 221 239 265 275 291 358 359 425 432 462 466 471 490 523 543 552 608 618 626 665 673 674 722 756 784 790 794 818 916 933 938 948 952 954 976 1021 1029 1043 1053 1091 1123 1141 1147 1196 1200 1277 1333 
5 75 81 82 83 111 132 136 155 218 256 259 284 285 288 296 305 307 347 354 362 375 383 396 397 458 473 474 488 556 557 569 578 581 582 595 598 625 652 676 688 710 748 795 995 1038 1044 1050 1060 1077 1131 1159 
48 56 57 105 127 128 137 170 171 189 191 233 264 393 398 407 446 460 486 487 512 542 564 571 616 623 624 656 691 692 715 775 809 867 966 969 1107 1108 1124 1135 1177 1234 1241 1272 1290 1302 1306 
10 31 46 135 140 141 158 167 172 207 238 268 271 295 391 394 395 429 461 496 499 528 534 634 683 687 693 765 796 797 801 802 841 889 912 947 953 970 1064 1079 1233 
54 72 93 144 202 248 318 378 420 476 478 509 510 530 566 602 739 799 855 915 980 987 1031 1082 1289 1299 1317 1343 
52 125 126 174 290 293 294 400 434 442 495 640 697 941 971 1023 1048 1117 1210 
217 232 482 641 642 679 680 734 830 924 928 1019 1084 1144 1155 1164 1165 1288 1305 
9 21 33 97 98 160 243 244 279 301 302 453 454 901 910 944 1028 1143 
117 121 253 345 372 426 445 590 658 669 755 778 845 931 936 1005 1034 1142 
14 15 115 267 326 565 596 743 913 968 1025 1090 1230 1236 1242 1259 1303 
106 110 145 175 176 188 224 260 313 348 437 771 914 1068 1208 1270 1275 
13 20 69 112 180 195 200 204 205 219 255 308 340 419 511 1325 
182 185 186 209 371 636 666 698 782 964 984 1054 1104 1199 1342 
153 154 201 210 225 226 386 491 869 1003 1051 1056 1063 1258 
49 50 241 261 350 413 588 810 812 842 1086 1260 
214 392 451 589 594 615 761 800 967 1042 1103 1276 
299 300 328 537 601 729 903 1014 1016 1057 1215 1319 
769 777 791 873 1033 1092 1153 1190 1197 1274 1284 1316 
124 319 320 365 435 502 550 766 979 981 1217 
32 405 613 713 919 1018 1062 1115 1254 1278 
91 92 343 559 654 682 906 907 1045 1246 
317 334 631 703 746 844 868 961 1112 1263 
2 3 76 369 382 1088 1089 1183 1265 
4 45 70 254 622 747 892 1105 1312 
11 547 694 741 767 939 1145 1179 1345 
66 280 504 847 888 898 1097 1192 1202 
99 628 629 711 712 805 806 1158 1336 
183 262 373 374 519 702 926 1074 1096 
7 58 73 74 329 545 865 900 
16 78 274 661 662 989 1101 1235 
24 242 277 517 704 779 835 856 
61 134 427 619 701 742 1100 1198 
198 199 270 297 335 533 958 973 
368 387 520 620 716 717 846 1024 
404 492 651 723 843 996 1013 1055 
415 650 725 824 1119 1120 1201 1315 
23 85 86 744 942 1195 1300 
26 67 459 497 848 859 1304 
62 325 591 611 1001 1173 1330 
89 90 222 278 1110 1140 1311 
95 384 579 632 1114 1146 1256 
107 108 203 298 389 531 733 
109 646 647 826 876 1134 1326 
113 114 282 322 525 653 752 
133 849 1166 1175 1229 1232 1350 
156 196 197 727 905 951 992 
162 163 418 538 708 763 820 
193 377 402 621 1030 1049 1156 
206 249 643 644 714 728 946 
258 479 498 549 684 1279 1298 
310 311 483 655 882 965 1161 
336 337 411 759 879 887 1329 
341 535 536 871 1148 1169 1301 
441 455 592 753 927 1132 1253 
568 731 740 774 885 1152 1212 
6 376 401 607 875 1106 
8 211 839 840 862 935 
25 53 272 306 360 467 
41 103 104 472 904 982 
59 212 575 635 724 803 
63 304 342 872 1037 1189 
68 670 815 1022 1206 1214 
120 816 1160 1171 1244 1245 
129 130 606 891 1238 1239 
147 166 880 1065 1083 1093 
178 788 1076 1098 1237 1295 
187 276 560 754 852 886 
229 283 529 664 922 930 
246 681 811 857 1182 1281 
312 521 554 789 1163 1178 
677 678 750 776 828 1346 
827 864 998 1154 1167 1321 
1009 1010 1185 1191 1296 1297 
17 39 469 470 1225 
38 522 1052 1099 1280 
60 332 390 417 527 
84 555 672 877 1184 
87 161 352 1320 1331 
101 314 480 770 813 
116 1071 1203 1266 1286 
146 250 287 858 1249 
184 709 1069 1130 1204 
216 361 909 937 1282 
230 449 450 921 1168 
240 273 385 860 929 
315 586 837 838 1283 
366 388 406 410 599 
370 593 612 911 1109 
399 505 707 974 1228 
422 587 831 955 1338 
436 894 895 1006 1039 
468 500 515 524 1351 
617 736 861 1137 1138 
833 834 1150 1151 1257 
851 863 1073 1113 1133 
19 179 553 562 
28 71 465 735 
29 379 732 1176 
30 978 1187 1310 
37 303 367 544 
42 64 234 457 
51 223 597 1347 
79 235 574 580 
94 440 604 1070 
96 231 507 1209 
118 645 884 977 
138 700 719 720 
139 1026 1027 1116 
151 772 1111 1255 
157 576 878 1128 
177 333 985 991 
228 247 558 1036 
237 539 897 932 
257 338 548 1172 
263 563 783 821 
266 414 896 990 
281 428 444 870 
289 403 945 1213 
327 349 798 1094 
330 331 518 920 
356 443 751 760 
430 705 890 1072 
481 823 925 972 
484 994 1020 1149 
638 737 874 1017 
659 660 1216 1354 
718 943 1205 1247 
768 917 918 1066 
780 1035 1125 1162 
893 1181 1218 1219 
962 963 1047 1269 
0 1122 1349 
27 726 773 
43 730 993 
55 181 1186 
77 532 1293 
102 251 1059 
150 346 1118 
164 236 663 
194 657 1231 
213 452 605 
252 355 438 
269 508 1075 
286 807 808 
316 572 639 
321 489 546 
339 416 696 
357 551 648 
409 561 1211 
423 439 1252 
424 506 956 
493 614 1136 
494 633 690 
501 960 1041 
514 819 1139 
540 1226 1227 
584 786 787 
668 902 959 
671 825 1314 
685 829 999 
757 1002 1087 
758 1220 1287 
836 986 1221 
853 1262 1292 
881 923 934 
949 950 1067 
1207 1223 1328 
