1 10 18 44 46 47 65 100 123 131 152 221 265 275 295 358 359 409 425 432 461 462 471 515 523 527 543 608 618 665 683 784 790 794 802 818 841 916 933 952 954 976 1021 1029 1043 1053 1064 1091 1123 1141 1147 1200 1233 
5 75 81 82 83 111 132 138 155 256 259 284 285 288 296 307 347 354 356 375 383 396 397 458 473 474 488 556 557 569 578 581 582 595 598 625 652 676 688 710 748 786 787 795 995 1038 1044 1050 1060 1077 1131 1159 
48 56 57 105 127 128 137 167 170 171 189 191 233 264 393 398 407 446 460 477 486 487 512 542 564 571 616 623 624 656 691 692 715 775 809 867 966 969 1079 1107 1108 1124 1135 1177 1234 1241 1272 1290 1302 1306 
154 225 226 299 300 312 328 386 387 521 537 600 601 690 729 789 903 1003 1014 1016 1056 1057 1163 1169 1215 1258 1319 
54 72 93 144 202 248 318 378 420 476 510 530 566 602 739 783 855 915 980 987 1031 1082 1289 1299 1317 1343 
14 15 109 115 267 326 565 596 611 646 647 743 826 913 968 1025 1090 1134 1230 1236 1242 1259 1303 1326 1335 
119 148 149 165 208 227 433 503 516 541 570 695 749 781 814 832 908 1125 1162 1273 1348 
160 161 180 184 190 215 239 243 453 454 709 756 910 944 1069 1130 1204 1277 1320 
106 110 145 175 176 188 224 260 313 330 348 437 771 914 1068 1208 1270 1275 
9 125 126 268 290 293 294 434 495 640 697 941 971 1023 1117 1210 
13 20 21 97 98 112 195 200 205 219 279 511 901 1028 1143 1325 
32 38 405 522 713 919 1018 1052 1062 1115 1254 1278 1280 
36 40 88 220 292 381 412 464 573 627 1081 1102 1129 
49 50 218 261 350 413 475 588 810 812 842 1086 1260 
11 547 694 741 767 769 939 1145 1179 1190 1274 1345 
24 136 242 277 517 671 704 779 825 856 1314 
91 92 343 559 654 682 906 907 1045 1099 1246 
103 104 156 196 197 472 727 904 905 951 992 
214 392 451 589 594 615 800 967 1042 1103 1276 
8 211 528 718 839 840 862 935 943 1247 
140 141 236 238 496 534 552 663 785 801 
258 498 549 684 962 963 1047 1269 1279 1298 
384 478 509 555 579 632 799 1114 1184 1256 
3 76 369 382 593 1088 1089 1183 1265 
7 58 73 74 329 484 545 865 900 
28 71 465 735 777 873 1153 1284 1316 
34 324 606 674 726 891 957 1240 1332 
66 280 504 847 888 898 1097 1192 1202 
94 415 650 725 824 1119 1120 1201 1315 
117 121 253 372 445 755 931 1005 1034 
183 262 373 374 519 702 926 1074 1096 
198 199 270 297 298 335 533 958 973 
305 362 513 792 807 994 1020 1149 1261 
317 334 631 703 746 844 868 1112 1263 
345 426 590 658 669 778 845 936 1142 
6 376 401 585 607 686 875 1106 
33 172 271 301 302 429 693 961 
61 134 427 619 701 742 1100 1198 
62 84 286 672 876 877 1011 1330 
63 304 342 681 857 872 1037 1189 
185 666 822 964 1161 1165 1199 1288 
206 207 499 714 796 797 946 947 
217 232 679 680 734 1019 1155 1164 
482 641 642 830 924 928 1084 1144 
22 124 320 502 526 722 1196 
23 85 86 744 942 1195 1300 
26 67 459 497 848 859 1304 
78 609 610 661 662 989 1101 
87 327 349 352 798 1094 1331 
133 849 1166 1175 1229 1232 1350 
153 201 210 491 869 1051 1063 
162 163 418 538 708 763 820 
193 377 402 621 1030 1049 1156 
237 333 539 897 932 985 991 
244 366 388 406 410 421 599 
336 337 411 759 879 887 1329 
404 651 723 843 996 1013 1055 
4 45 70 622 747 892 
25 53 272 306 360 467 
31 634 899 953 970 1271 
52 174 234 442 443 1048 
59 212 575 635 724 803 
68 670 815 1022 1206 1214 
89 90 222 278 1140 1311 
107 108 203 389 531 733 
113 114 322 525 653 752 
116 1070 1071 1203 1266 1286 
120 816 1160 1171 1244 1245 
146 250 287 808 858 1249 
147 166 880 1065 1083 1093 
177 178 788 1076 1237 1295 
186 240 273 385 860 929 
229 283 529 664 922 930 
254 483 554 1105 1178 1312 
325 591 780 1001 1035 1173 
341 535 536 871 1148 1301 
468 617 736 861 1137 1138 
568 731 774 854 1152 1212 
677 678 750 776 828 1346 
827 864 998 1154 1167 1321 
1009 1010 1185 1191 1296 1297 
16 274 836 986 1235 
30 978 1187 1205 1310 
35 351 660 1216 1354 
55 289 403 945 1213 
79 235 574 580 1110 
95 151 772 1111 1255 
101 314 480 770 813 
118 645 884 885 977 
135 204 687 912 1305 
158 394 395 400 889 
164 603 761 762 793 
187 276 560 754 852 
230 449 450 921 1168 
245 361 440 604 909 
315 586 837 838 1283 
357 550 551 648 981 
371 636 698 1104 1342 
399 505 974 1172 1228 
422 587 831 955 1338 
501 567 960 1041 1282 
833 834 1150 1151 1257 
851 863 1073 1113 1133 
2 514 819 1139 
12 263 563 821 
17 39 469 470 
19 179 553 562 
29 927 1092 1176 
37 355 367 544 
60 332 390 417 
69 308 340 419 
96 231 507 1209 
129 130 1238 1239 
139 1026 1027 1116 
157 576 878 1128 
228 247 558 1036 
241 441 492 753 
246 811 1182 1281 
249 643 644 728 
255 500 524 1351 
266 414 896 990 
368 520 846 1024 
379 506 732 956 
430 705 890 1072 
436 894 895 1006 
455 456 1040 1253 
638 667 737 983 
740 1059 1078 1157 
768 917 918 1066 
853 1033 1262 1292 
893 1181 1218 1219 
0 1122 1349 
42 64 457 
43 730 993 
51 597 1146 
77 532 1293 
99 628 629 
142 223 1347 
150 346 1118 
169 1058 1294 
181 452 1186 
194 657 1231 
216 303 937 
257 338 548 
269 508 1075 
281 391 835 
316 572 639 
319 435 766 
321 489 546 
331 518 920 
339 416 696 
380 721 984 
423 439 1252 
428 444 870 
447 485 1039 
466 490 1333 
481 823 1098 
493 614 1136 
540 1226 1227 
561 707 1211 
592 1132 1197 
620 716 717 
655 882 965 
668 902 959 
685 829 999 
700 719 720 
706 1264 1344 
711 712 1158 
757 1002 1087 
791 925 972 
805 806 1336 
874 886 1017 
881 923 934 
949 950 1067 
1207 1223 1328 
1224 1225 1243 
