10 16 17 31 47 51 52 56 57 69 70 71 72 99 100 103 104 120 125 126 135 150 151 156 158 159 160 172 173 196 197 227 228 231 232 236 237 238 239 248 251 268 275 280 288 294 295 326 352 356 358 359 377 378 394 409 410 425 428 429 430 432 434 442 446 455 456 461 462 463 471 472 495 496 497 501 507 523 527 528 534 539 541 552 595 605 636 638 640 648 653 665 670 672 673 674 676 697 701 703 705 706 718 722 723 727 737 742 746 747 748 752 757 763 773 785 794 801 815 840 841 850 851 855 861 863 892 897 904 905 921 922 927 933 938 941 943 951 969 971 976 979 982 991 992 996 1006 1008 1020 1021 1022 1023 1031 1043 1048 1060 1064 1073 1088 1096 1103 1141 1170 1173 1175 1176 1177 1194 1195 1196 1209 1210 1214 1217 1223 1233 1243 1253 1267 1268 1271 1289 1291 1300 
6 7 25 28 29 34 35 40 41 58 67 73 74 76 80 81 83 84 85 113 115 123 132 142 143 147 148 157 168 169 177 190 284 285 291 307 314 315 328 329 366 382 384 398 401 402 408 412 424 457 458 465 466 484 488 489 515 516 519 524 531 545 546 547 555 567 568 574 584 585 586 593 606 607 612 613 629 649 657 660 663 667 668 675 686 688 700 739 740 741 745 760 774 775 779 780 788 791 792 807 832 837 838 843 844 846 852 854 865 874 875 883 884 885 886 887 888 900 911 923 948 956 960 961 977 986 994 1007 1013 1024 1032 1041 1058 1059 1078 1081 1085 1089 1094 1098 1100 1102 1109 1110 1111 1117 1118 1124 1125 1131 1132 1139 1149 1152 1157 1162 1166 1193 1197 1202 1220 1221 1222 1229 1232 1236 1252 1260 1273 1277 1282 1283 1294 1315 1324 1332 1333 1337 1350 1351 1354 
0 1 12 13 22 23 32 36 37 42 43 48 53 54 55 59 63 64 65 66 75 79 86 87 88 93 94 95 96 108 111 112 149 155 174 189 195 200 204 205 208 212 218 219 220 234 235 242 245 250 255 256 257 259 269 272 277 278 296 303 304 305 306 308 309 321 322 327 339 340 341 349 353 355 360 361 374 379 381 388 403 415 416 421 433 443 467 468 473 475 490 502 503 504 508 526 557 563 573 578 579 588 594 599 603 608 625 626 627 656 681 724 728 736 751 770 786 798 803 812 866 867 873 890 899 926 936 942 952 953 980 997 1002 1061 1070 1106 1114 1136 1137 1138 1146 1147 1159 1160 1167 1168 1187 1188 1206 1213 1234 1247 1248 1256 1270 1306 1310 1325 
11 38 39 44 49 50 60 89 90 117 118 119 129 131 140 167 181 182 185 186 207 222 316 317 330 331 346 370 371 372 373 391 392 395 404 405 406 407 436 444 445 447 448 479 481 499 500 517 518 532 570 587 589 615 617 618 621 659 666 671 683 699 714 726 755 764 782 790 797 800 804 810 822 849 889 916 919 920 937 946 947 964 965 983 984 988 1005 1017 1018 1019 1034 1039 1042 1053 1054 1062 1066 1074 1079 1091 1092 1095 1099 1104 1123 1140 1150 1161 1180 1181 1184 1199 1200 1205 1207 1216 1224 1225 1272 1278 1280 1311 1314 1342 
4 5 26 27 30 33 45 46 68 82 91 92 97 98 107 121 122 130 133 134 141 152 161 166 179 180 193 194 213 214 243 244 253 254 271 279 289 290 292 301 302 323 324 336 376 397 400 413 423 426 427 451 452 453 454 464 470 474 485 494 498 511 520 556 572 577 581 590 598 610 619 628 637 639 652 655 658 669 687 693 704 712 717 744 778 795 802 818 820 821 827 835 845 856 891 910 925 931 932 944 957 972 985 1030 1040 1044 1045 1049 1071 1072 1211 1212 1218 1219 1231 1238 1239 1312 1322 1323 1328 1329 1348 
14 15 61 62 77 144 145 175 183 184 201 209 210 266 267 281 282 337 343 344 396 513 565 569 591 596 611 645 646 647 651 709 743 759 805 806 826 868 876 877 896 898 906 907 913 914 968 990 1001 1004 1011 1025 1046 1050 1051 1052 1063 1069 1075 1090 1097 1105 1130 1134 1153 1158 1203 1204 1230 1242 1246 1259 1263 1266 1276 1286 1293 1303 1309 1318 1326 1330 1334 1335 1336 1340 1341 
8 9 20 101 102 124 146 187 188 202 203 211 216 217 221 229 230 246 247 252 262 263 276 319 320 332 333 334 345 354 357 365 399 431 435 440 441 476 491 492 505 550 551 558 560 561 592 622 632 635 698 733 735 753 754 756 766 783 823 860 862 870 935 975 981 987 995 1029 1036 1038 1067 1087 1121 1129 1281 
138 139 164 165 312 313 351 375 414 422 469 493 521 522 535 554 575 576 580 630 631 633 690 738 758 761 762 767 772 789 793 814 816 825 833 834 836 847 853 878 881 902 934 967 993 1009 1010 1012 1014 1016 1033 1055 1113 1128 1133 1151 1163 1171 1185 1191 1192 1240 1244 1245 1257 1261 1262 1285 1292 1296 1297 1345 
2 3 21 105 106 109 110 127 128 136 137 170 171 176 191 192 223 224 233 260 261 264 265 347 348 393 419 420 437 460 477 478 486 487 512 542 564 571 597 616 623 624 634 691 692 710 715 721 771 809 819 901 915 974 1068 1083 1107 1108 1112 1135 1142 1143 1183 1208 1241 1275 1290 1302 1313 1339 1347 
18 19 153 154 225 226 273 299 300 368 369 386 387 506 509 510 536 537 553 559 566 600 601 677 678 685 702 749 750 765 776 777 781 787 799 817 828 871 872 903 955 998 1003 1037 1056 1057 1148 1154 1169 1258 1264 1265 1301 1307 1308 1319 1321 1327 1338 1346 
258 286 287 293 318 338 350 367 383 525 540 543 544 548 549 582 583 602 604 609 682 689 696 711 713 842 858 869 893 908 940 978 1026 1027 1115 1178 1189 1249 1254 1269 1295 1299 1343 1344 
206 215 249 310 311 325 342 362 363 380 438 439 459 514 562 643 644 654 732 811 848 857 882 894 895 966 1028 1122 1145 1182 1198 1349 
78 116 364 411 480 614 620 661 662 716 730 731 808 831 864 879 880 949 950 962 963 970 989 1015 1047 1065 1082 1101 1228 1235 1287 
162 163 389 390 417 418 538 650 707 708 719 720 725 796 824 912 945 1093 1119 1120 1186 1201 
24 240 241 274 385 679 680 684 729 929 1155 1164 1165 1172 1215 1279 1288 1298 1305 1331 
283 529 530 664 694 695 839 859 930 999 1035 1317 
482 483 641 642 734 829 830 924 928 1084 1144 
768 769 917 918 939 1179 1190 1274 1284 1304 1316 
198 199 270 297 298 335 533 958 959 973 
449 450 1000 1086 1116 1156 1226 1227 1255 1320 
178 784 954 1076 1077 1080 1237 
114 813 909 
1126 1127 1174 
