13 15 22 23 34 40 42 43 53 63 64 66 79 82 83 86 87 89 93 94 111 148 149 153 195 218 224 235 238 245 250 255 257 258 269 277 278 285 296 303 307 308 320 339 340 349 350 353 354 361 374 375 388 392 394 403 406 414 421 422 467 468 475 501 502 503 516 526 588 594 599 619 631 649 669 736 758 765 781 787 845 867 871 872 875 877 899 909 936 943 955 995 997 1037 1106 1125 1162 1172 1193 1198 1205 1247 1260 1266 1271 1273 1301 1332 1348 
12 31 32 36 37 44 55 59 174 178 189 208 212 220 234 305 306 309 322 325 327 341 355 360 362 381 438 515 535 573 608 626 627 701 743 770 793 817 948 953 970 998 1024 1066 1147 1148 1154 1213 1265 
20 65 70 88 112 124 135 155 204 256 263 321 379 570 581 589 601 615 636 711 712 732 804 980 1094 1104 1114 1146 1158 1159 1160 1168 1189 1305 1325 
48 56 126 162 191 393 460 542 595 600 624 648 656 673 715 723 742 803 809 827 890 969 996 1060 1124 1135 1170 1177 1223 1233 1234 1290 1302 1306 1328 
57 128 137 171 237 248 317 318 426 437 445 478 486 510 564 566 616 623 692 710 739 915 987 1034 1107 1142 1194 1241 1299 1310 
0 68 104 146 287 293 338 356 367 383 440 498 548 549 557 582 583 604 609 640 893 971 978 1039 1145 1178 
19 118 122 140 164 166 167 179 324 391 400 423 427 470 499 520 652 726 800 835 906 907 957 1044 1045 
98 215 252 310 311 459 494 552 558 562 572 590 654 655 658 744 756 894 931 1007 1036 
3 154 225 299 369 384 385 386 650 749 750 843 1003 1056 1088 1089 1258 1346 
14 107 187 203 336 337 396 565 611 709 733 759 913 960 1204 1236 1329 1344 
211 217 262 319 332 334 345 357 435 441 550 632 734 753 754 981 1019 1304 
25 91 213 214 272 328 415 536 537 610 684 685 729 1169 1215 1298 1319 
45 72 120 378 446 496 605 622 746 752 763 815 891 892 1113 1173 1210 
84 85 201 210 412 473 506 531 617 618 702 942 1052 1063 1075 1294 1321 
182 313 333 405 469 511 521 666 690 789 822 941 985 1016 1163 1289 1300 
16 119 132 457 488 489 568 625 635 779 780 861 1035 1041 1102 1118 
101 127 280 387 439 504 776 846 847 869 888 898 1038 1097 1192 1202 
158 172 173 294 395 429 579 598 687 693 889 951 992 1020 1073 1243 
99 183 184 198 199 270 297 335 373 519 533 973 1130 
115 647 805 806 868 1112 1134 1246 1259 1263 1326 1335 1336 
11 26 206 207 222 448 497 500 694 946 947 1079 
61 62 286 646 876 896 990 1001 1011 1100 1286 1330 
106 176 188 260 348 419 512 974 1068 1208 1270 1275 
254 482 483 641 642 829 830 924 928 1084 1105 1144 
620 621 695 716 717 730 831 832 950 1015 1057 1228 
46 275 409 425 428 528 634 718 839 840 1096 
47 147 298 471 798 808 879 880 1065 1082 1083 
54 249 514 644 681 811 812 848 857 1182 
76 165 279 442 630 814 816 863 878 940 
103 197 540 541 705 706 882 1031 1226 1285 
50 292 574 575 767 1110 1133 1311 1345 
58 200 329 484 667 703 745 983 1237 
77 78 493 661 662 774 989 1101 1293 
108 259 352 532 680 784 1164 1315 1331 
768 769 917 918 939 1179 1190 1274 1284 
10 180 288 368 461 802 841 1175 
21 451 761 901 1143 1166 1183 1276 
24 452 480 657 704 856 1232 1350 
51 221 227 961 1006 1048 1087 1199 
90 175 233 330 517 518 920 1018 
105 116 398 466 490 775 1203 1333 
113 114 276 366 458 760 836 1222 
152 219 407 443 523 665 757 794 
181 185 524 683 755 849 1229 1351 
281 282 591 638 737 914 1023 1046 
291 346 792 922 1032 1244 1245 1261 
351 902 903 935 954 988 1076 1091 
364 399 420 513 1064 1149 1227 1240 
4 97 453 454 944 1028 1195 
18 546 713 714 788 1098 1295 
29 186 444 534 671 825 1314 
75 81 284 464 477 1129 1248 
160 402 456 505 527 923 1030 
236 371 698 1122 1141 1342 1349 
261 413 495 724 1070 1167 1224 
529 645 664 930 952 977 999 
567 677 678 777 785 828 912 
860 873 881 976 1033 1153 1316 
5 33 133 301 302 577 
7 110 474 748 1181 1218 
27 60 100 271 747 778 
73 266 404 651 1055 1077 
96 231 232 633 679 1209 
177 424 585 663 686 959 
239 884 885 958 1069 1277 
267 968 1025 1090 1230 1303 
342 576 772 966 993 1111 
796 797 824 851 1119 1120 
1009 1010 1185 1191 1296 1297 
1 347 430 688 1029 
30 358 436 1071 1187 
39 223 1072 1225 1347 
41 522 904 1021 1214 
69 190 682 786 908 
129 130 578 870 1239 
139 295 764 937 1116 
216 229 253 283 1103 
300 962 963 1047 1269 
382 561 991 1085 1281 
389 417 707 820 1186 
401 674 964 1043 1196 
418 539 932 933 945 
433 853 859 1292 1317 
449 450 719 921 1156 
463 691 697 1117 1253 
491 560 783 852 934 
507 509 555 799 1238 
833 834 1150 1151 1257 
6 35 246 813 
74 123 727 1002 
80 230 476 858 
109 487 826 1109 
141 268 434 545 
161 897 1049 1320 
196 554 927 1042 
205 1201 1327 1338 
240 273 274 929 
241 492 1013 1152 
242 508 544 1211 
264 416 721 1108 
290 331 696 975 
314 689 866 895 
326 639 699 1004 
343 344 481 751 
365 659 1051 1161 
370 380 676 984 
376 377 607 972 
397 728 773 1136 
543 1053 1123 1200 
571 596 597 1242 
593 612 791 911 
660 1092 1216 1354 
740 956 1078 1157 
874 919 1017 1280 
2 819 1139 
8 289 1022 
9 125 766 
28 71 465 
92 559 1099 
95 151 1255 
117 553 722 
121 1005 1318 
131 670 1206 
134 735 1231 
136 193 1074 
142 738 1264 
144 563 606 
156 157 982 
159 926 1138 
168 202 1058 
169 226 1067 
192 411 700 
265 818 910 
304 821 1272 
315 643 790 
372 551 965 
390 530 556 
455 741 1040 
479 613 1171 
525 602 603 
580 1278 1279 
586 587 1256 
629 801 807 
637 1121 1140 
731 916 1212 
771 854 1012 
795 864 883 
837 838 1283 
842 1026 1027 
855 1128 1165 
886 887 1131 
1000 1014 1176 
1115 1254 1343 
1132 1197 1282 
1155 1235 1288 
1220 1221 1287 
