4 5 7 10 11 26 30 33 38 48 56 57 97 106 108 110 115 126 128 131 133 137 144 145 158 161 162 171 172 173 175 176 180 188 191 206 207 222 230 233 237 244 248 260 264 276 288 294 301 302 317 318 330 334 348 352 368 389 390 393 397 405 407 410 417 418 419 426 429 436 437 445 448 449 453 454 458 460 461 474 478 486 509 510 512 517 518 530 539 542 556 564 566 577 578 579 580 582 592 598 600 616 623 624 632 648 656 657 670 687 692 693 694 704 707 710 715 721 723 728 739 742 748 760 771 773 778 784 799 802 803 809 818 820 828 841 850 889 897 914 915 919 932 933 944 945 947 969 974 987 996 1004 1031 1034 1046 1052 1060 1061 1068 1073 1079 1107 1108 1112 1115 1124 1135 1136 1142 1145 1159 1168 1170 1175 1177 1181 1194 1195 1206 1208 1218 1223 1233 1234 1241 1254 1256 1259 1270 1275 1289 1290 1291 1299 1300 1302 1306 1310 1313 1320 1328 1339 1343 
6 9 14 17 35 41 50 74 80 98 101 107 123 125 152 154 156 157 187 192 196 197 203 209 211 215 216 225 228 229 242 243 246 247 252 253 267 283 284 286 310 319 332 336 337 345 358 359 369 382 384 385 386 387 396 411 425 435 439 441 459 462 476 479 493 494 508 522 523 544 550 552 554 558 561 562 565 584 590 593 611 612 613 654 655 658 661 662 665 727 733 744 749 753 754 756 757 759 766 769 774 783 791 794 813 836 860 862 873 881 883 887 894 895 900 904 910 911 913 922 927 931 946 960 967 968 976 981 982 983 986 989 991 1002 1003 1007 1012 1021 1025 1028 1036 1042 1050 1054 1056 1080 1085 1088 1089 1090 1101 1103 1132 1153 1171 1178 1188 1190 1197 1211 1214 1221 1230 1236 1258 1274 1278 1279 1281 1284 1287 1303 1316 1324 1329 1340 1341 
1 12 13 15 22 23 31 32 34 36 37 40 42 43 44 53 55 59 63 64 66 76 86 87 89 93 94 148 149 165 174 189 195 208 212 219 220 224 234 235 238 245 250 257 261 265 269 277 278 279 296 303 305 306 309 320 322 325 327 339 340 341 349 350 353 354 360 361 366 374 381 388 392 394 403 406 413 414 421 422 438 442 467 468 475 495 501 502 503 515 516 526 535 573 588 594 599 608 619 626 627 630 631 649 676 696 724 743 758 765 770 781 787 793 814 816 817 845 863 867 871 872 875 877 878 899 909 921 936 940 943 948 953 955 970 979 997 998 1011 1024 1029 1037 1070 1071 1078 1106 1147 1148 1154 1162 1167 1172 1187 1205 1213 1217 1247 1260 1265 1266 1271 1273 1301 1307 1308 1309 1332 1334 1348 
2 3 20 29 46 52 54 65 70 82 88 112 118 124 129 130 135 139 141 155 160 163 169 186 194 204 205 217 226 249 254 263 268 281 295 308 311 316 321 323 326 355 370 379 380 395 402 409 428 434 444 447 482 483 485 505 527 528 534 545 570 572 581 589 591 615 634 636 638 639 641 642 644 645 653 660 671 672 681 699 711 712 718 732 734 737 764 768 782 785 804 810 811 812 825 829 830 839 840 842 843 848 857 917 918 923 924 928 937 949 951 984 1000 1019 1023 1026 1027 1030 1067 1084 1086 1092 1093 1096 1104 1105 1114 1116 1144 1146 1158 1169 1182 1189 1210 1216 1219 1239 1252 1282 1304 1305 1312 1314 1325 1327 1338 1342 1354 
16 39 51 75 79 81 83 111 119 132 153 159 218 221 223 227 239 255 256 259 262 285 291 292 304 307 315 342 346 347 362 375 430 443 457 464 477 488 489 569 574 575 576 586 595 601 625 635 643 669 688 700 709 736 750 767 772 779 780 790 792 821 827 837 838 854 861 890 926 958 961 966 993 995 1006 1032 1033 1035 1041 1048 1066 1069 1072 1087 1095 1102 1111 1118 1125 1129 1131 1138 1180 1199 1204 1222 1244 1245 1248 1261 1272 1277 1283 1345 1346 1347 
27 60 90 100 102 121 127 181 182 185 271 282 290 312 313 331 333 357 372 452 469 470 472 480 492 500 511 521 524 543 547 551 567 568 587 605 637 666 677 678 683 690 731 740 747 755 777 789 795 796 797 822 824 849 851 855 858 864 870 912 916 920 938 939 941 956 965 972 975 985 1005 1013 1014 1016 1049 1053 1059 1119 1120 1121 1123 1128 1140 1152 1157 1163 1165 1176 1179 1186 1200 1201 1212 1229 1288 1311 1318 1322 1323 1351 
0 19 68 69 104 122 140 146 164 166 167 179 190 236 258 275 287 293 324 338 356 367 371 383 391 400 423 427 440 463 498 499 520 548 549 557 563 583 604 606 609 640 652 663 682 691 697 698 726 786 800 835 893 906 907 908 957 971 978 1039 1044 1045 1117 1122 1133 1141 1220 1349 
18 45 58 72 95 120 151 178 200 231 232 329 365 378 408 431 432 446 484 496 497 514 546 571 596 597 622 633 659 667 679 701 703 713 714 745 746 752 763 788 815 819 865 891 892 905 992 1018 1062 1098 1109 1113 1139 1160 1161 1173 1193 1224 1225 1237 1242 1243 1249 1255 1295 
21 49 67 77 78 84 85 103 113 114 136 142 143 168 201 202 210 251 300 343 344 412 424 451 473 481 506 531 538 540 541 617 618 675 702 705 706 738 751 761 762 823 882 901 925 942 962 963 1047 1058 1063 1075 1143 1166 1183 1226 1264 1269 1276 1285 1293 1294 1321 1337 1344 
8 61 96 99 109 150 289 364 376 377 399 416 420 487 507 513 555 607 628 646 647 708 720 725 805 806 826 833 834 868 874 876 994 1017 1020 1022 1064 1100 1134 1149 1150 1151 1184 1209 1227 1238 1240 1246 1257 1263 1280 1326 1335 1336 
25 91 213 214 272 280 299 328 415 433 504 525 536 537 602 603 610 629 650 684 685 729 776 801 807 846 847 853 859 869 888 898 1038 1081 1097 1192 1202 1215 1262 1292 1298 1315 1317 1319 
24 73 117 138 351 404 529 614 620 621 651 664 695 716 717 730 831 832 856 884 885 902 903 930 935 950 952 954 977 988 999 1008 1015 1055 1057 1076 1077 1091 1207 1228 1232 1350 
47 92 105 116 147 266 298 398 455 456 466 471 490 559 680 741 775 798 808 844 879 880 896 980 990 1040 1065 1082 1083 1094 1099 1110 1137 1164 1203 1253 1267 1268 1286 1331 1333 
170 177 183 184 193 198 199 270 297 314 335 363 373 401 450 519 533 553 585 668 673 674 686 689 719 722 866 959 964 973 1043 1074 1130 1156 1196 
28 62 71 134 465 532 735 1001 1198 1231 1330 
240 241 273 274 929 1155 1235 
491 560 852 886 934 1051 
1009 1010 1185 1191 1296 1297 
