4 5 7 10 11 26 28 30 33 38 39 48 56 57 61 62 97 108 110 115 119 126 128 133 137 145 158 162 171 172 173 180 188 191 206 217 222 223 234 237 244 248 259 260 288 294 301 302 317 318 334 348 352 357 366 368 376 377 389 390 393 394 397 407 410 416 417 418 419 426 429 437 445 447 448 454 457 460 465 474 478 485 486 500 504 530 532 539 542 552 556 564 566 577 580 595 598 600 607 616 623 624 632 635 646 648 656 687 692 693 694 704 707 710 715 721 723 728 742 773 784 802 803 809 810 817 820 823 827 861 874 876 884 885 890 896 897 915 917 918 932 933 944 945 946 947 951 969 974 985 987 990 992 996 1001 1011 1019 1020 1032 1034 1052 1060 1068 1072 1073 1079 1086 1100 1107 1108 1124 1135 1136 1142 1170 1175 1177 1194 1195 1208 1223 1233 1234 1241 1259 1277 1286 1290 1302 1304 1306 1310 1328 1330 1347 
1 12 13 15 22 23 31 32 34 36 37 40 42 43 44 53 55 59 63 64 66 79 83 86 87 89 93 94 96 111 148 149 153 161 174 178 189 195 208 212 218 219 220 224 235 238 245 250 255 257 258 269 277 278 285 296 303 304 305 306 307 308 309 320 322 325 327 339 340 341 347 349 350 353 354 355 360 361 362 374 375 381 388 392 403 406 414 421 422 430 438 467 468 475 501 502 503 514 515 516 526 535 573 579 588 594 599 601 608 619 626 627 634 649 669 688 736 743 758 765 770 781 787 793 821 845 871 872 875 877 899 909 936 943 948 953 955 970 979 995 997 998 1024 1029 1037 1040 1066 1071 1102 1106 1125 1147 1148 1154 1162 1172 1178 1187 1193 1205 1209 1213 1247 1256 1260 1265 1266 1271 1272 1273 1301 1307 1308 1309 1320 1332 1334 1348 
14 29 106 107 109 139 144 151 156 157 175 176 186 187 203 210 233 267 281 282 295 326 330 336 337 370 380 396 428 444 487 512 517 518 525 534 565 569 591 593 603 611 612 636 638 639 671 699 709 733 737 759 764 769 771 791 819 826 854 860 862 873 881 911 913 914 920 937 939 968 976 982 984 994 1004 1009 1010 1012 1018 1023 1025 1026 1028 1033 1046 1050 1063 1090 1104 1109 1113 1116 1153 1185 1190 1191 1197 1204 1230 1236 1255 1270 1274 1278 1279 1284 1296 1297 1303 1316 1329 1340 1341 
24 25 46 47 91 92 121 127 131 141 147 152 160 213 214 239 264 265 268 272 298 299 323 328 402 409 425 434 436 443 456 461 471 505 523 527 528 536 537 545 559 602 610 629 653 657 665 672 676 684 685 718 729 757 785 794 798 801 808 818 839 840 841 867 869 879 880 898 910 923 925 958 1014 1030 1038 1049 1065 1069 1075 1082 1083 1096 1169 1176 1181 1202 1206 1215 1218 1219 1232 1298 1312 1318 1319 1350 
0 19 67 68 69 101 104 118 122 134 140 146 164 166 167 179 190 236 251 275 287 293 324 338 345 356 358 367 371 383 391 400 423 427 439 440 463 470 498 499 520 548 549 557 572 582 583 584 604 609 640 652 658 663 680 682 691 697 698 726 735 786 800 835 856 893 906 907 908 931 957 971 978 1039 1044 1045 1117 1122 1141 1145 1159 1164 1168 1220 1231 1253 1267 1268 1331 1349 
3 41 76 80 98 125 154 196 211 215 216 225 229 230 241 252 253 261 283 286 310 311 369 382 384 385 386 413 415 435 441 459 476 494 495 522 554 558 561 562 590 650 654 655 724 744 749 753 756 795 807 824 842 843 858 864 866 883 894 904 927 967 986 991 1003 1007 1021 1027 1036 1042 1054 1056 1070 1080 1085 1088 1089 1103 1119 1120 1167 1214 1258 1281 1315 
27 60 100 163 181 182 183 184 185 271 290 312 313 316 331 332 333 372 373 405 469 472 511 521 524 543 547 550 551 586 587 637 659 660 666 683 690 696 731 747 754 755 778 789 822 849 855 916 938 941 965 975 981 1000 1005 1008 1016 1053 1092 1121 1123 1128 1130 1140 1163 1165 1179 1200 1212 1216 1217 1225 1229 1243 1252 1289 1293 1300 1322 1323 1351 1354 
2 21 49 74 103 123 129 130 150 197 254 451 452 479 480 482 483 490 493 507 509 510 540 541 555 578 605 641 642 705 706 708 725 727 734 761 762 774 799 828 829 830 833 834 870 882 886 887 901 924 928 1002 1031 1084 1105 1131 1143 1144 1150 1151 1166 1183 1186 1226 1238 1239 1257 1276 1285 
20 54 65 70 82 84 85 88 112 124 135 155 169 194 201 204 207 226 249 256 263 300 321 379 395 412 473 506 531 570 581 589 615 617 618 644 681 702 711 712 732 804 811 812 825 848 857 889 942 956 962 963 980 1067 1093 1094 1114 1146 1158 1182 1189 1198 1269 1294 1305 1321 1325 
50 71 73 266 280 292 351 387 404 433 529 574 575 614 620 621 645 651 664 695 716 717 730 767 776 796 797 831 832 846 847 850 851 853 859 888 902 903 919 930 935 950 952 954 977 988 999 1015 1017 1047 1055 1057 1076 1077 1091 1097 1099 1133 1192 1207 1228 1280 1314 1317 1345 
75 77 78 81 113 114 142 143 159 168 202 240 262 273 274 276 284 342 359 458 464 477 563 576 606 661 662 738 750 760 772 836 926 929 960 966 989 993 1058 1101 1111 1129 1132 1138 1155 1221 1222 1235 1248 1264 1282 1287 1288 1337 1344 1346 
6 35 58 95 99 170 177 198 199 200 205 209 246 247 270 297 314 329 335 363 424 462 519 533 585 667 668 686 689 703 745 813 865 895 900 959 973 983 1139 1188 1201 1237 1249 1324 1327 1338 1342 
102 105 116 117 242 291 319 346 398 455 466 492 508 544 553 567 677 678 739 740 741 766 775 777 792 844 912 922 1013 1059 1078 1081 1115 1137 1152 1157 1203 1211 1244 1245 1254 1261 1262 1292 1299 1333 1343 
9 51 52 165 221 227 228 279 315 442 630 631 643 647 719 790 805 806 814 816 837 838 863 868 878 940 949 961 1006 1048 1087 1095 1112 1134 1156 1180 1199 1246 1263 1283 1326 1336 
18 365 401 408 431 432 449 450 546 571 592 596 597 613 673 674 701 713 714 722 788 905 921 964 1043 1051 1061 1098 1161 1171 1196 1242 1275 1295 1313 1339 
17 45 72 120 231 232 243 378 446 491 496 497 560 622 633 679 746 748 752 763 783 815 852 891 892 934 1062 1160 1173 1210 1224 1291 
8 138 289 343 344 364 399 420 481 484 513 538 628 670 675 720 751 1022 1064 1149 1184 1227 1240 1335 
16 132 136 192 193 411 488 489 568 625 700 779 780 782 972 1035 1041 1074 1118 
90 1110 1311 
