4 10 27 31 44 46 47 48 56 59 99 100 105 127 128 132 137 140 141 142 143 149 155 160 161 167 170 171 183 191 206 215 223 233 236 238 243 244 254 264 268 275 281 295 354 358 359 366 373 391 393 394 395 408 409 410 425 428 432 446 460 461 462 466 471 477 481 483 486 487 488 490 491 496 499 500 504 514 519 521 523 528 542 543 552 554 561 564 571 575 584 598 616 618 623 624 625 626 634 635 656 659 660 665 675 683 691 692 702 714 715 718 726 744 756 773 775 784 786 787 794 796 797 801 802 804 809 835 884 889 898 899 914 916 933 943 946 947 948 951 952 953 954 966 969 970 976 995 997 1021 1053 1064 1067 1076 1079 1091 1096 1105 1107 1108 1122 1123 1124 1135 1141 1147 1177 1200 1216 1231 1233 1234 1241 1247 1272 1277 1290 1302 1306 1310 1320 1333 1337 1347 1349 1354 
0 6 7 22 34 36 40 58 67 73 74 80 81 88 119 120 148 154 165 169 173 208 212 220 225 226 227 255 272 273 277 283 284 299 300 315 320 324 328 329 356 360 376 381 386 388 401 412 421 433 464 468 475 484 503 513 515 516 524 526 537 545 573 585 599 600 601 617 627 628 629 647 650 663 666 667 686 695 711 712 729 736 749 750 781 790 803 805 806 816 832 861 865 875 886 900 903 908 936 957 964 983 1003 1014 1016 1050 1054 1056 1057 1058 1095 1106 1125 1129 1131 1134 1137 1138 1158 1160 1162 1171 1180 1199 1215 1236 1237 1240 1243 1258 1271 1273 1294 1319 1326 1332 1336 1346 1348 1351 
41 103 104 107 108 112 113 114 129 130 158 164 182 186 196 197 198 199 214 228 257 266 270 282 297 298 335 338 371 385 389 392 399 404 424 444 451 458 472 525 529 531 533 548 551 578 589 591 594 603 606 615 630 636 638 648 651 653 664 668 698 707 723 725 733 737 752 757 761 762 780 800 814 824 841 843 854 860 870 891 904 905 919 930 958 959 960 967 973 974 982 1002 1012 1013 1017 1035 1042 1055 1062 1087 1098 1102 1103 1104 1119 1120 1132 1139 1163 1172 1173 1188 1225 1227 1238 1239 1276 1282 1324 1342 
19 23 43 61 62 63 85 86 87 89 90 94 95 117 122 134 179 222 245 252 253 278 291 292 310 311 312 327 342 344 349 352 355 361 379 426 427 438 470 510 553 557 562 572 577 590 604 645 646 655 658 669 673 681 701 730 732 742 745 765 778 798 817 845 856 857 866 872 874 876 882 887 896 909 922 931 938 942 965 979 990 993 1001 1007 1011 1031 1037 1043 1061 1081 1094 1100 1110 1140 1142 1189 1195 1262 1307 1308 1311 1330 1331 1335 
2 9 18 21 33 45 54 70 97 98 123 124 131 133 135 146 147 152 166 172 174 180 181 190 204 207 221 230 249 256 271 279 286 287 301 302 325 406 407 423 429 430 439 447 448 449 450 454 455 498 502 549 582 687 693 705 722 747 770 792 807 823 849 858 867 880 890 901 912 921 944 961 998 1008 1015 1020 1028 1032 1060 1065 1072 1083 1088 1093 1143 1154 1159 1166 1168 1175 1196 1229 1232 1244 1245 1249 1252 1255 1261 1305 1312 1321 1350 
16 17 24 25 38 39 68 121 136 138 145 150 193 194 209 210 242 251 274 306 330 331 336 337 346 377 402 405 411 452 456 467 469 517 518 522 568 657 670 671 700 704 709 720 738 759 779 782 791 808 815 825 827 833 834 864 881 883 920 923 925 926 929 934 962 972 988 1018 1022 1030 1049 1052 1099 1118 1145 1150 1151 1184 1204 1214 1235 1257 1280 1291 1314 1327 1329 
30 35 42 49 50 64 66 101 151 205 218 234 246 261 280 309 314 350 351 363 364 413 415 436 457 480 485 534 588 621 677 678 689 716 724 772 777 810 811 812 813 828 842 847 873 888 894 895 949 950 978 1006 1033 1039 1040 1046 1085 1086 1092 1097 1111 1149 1153 1167 1182 1187 1192 1197 1201 1202 1205 1224 1260 1281 1284 1292 1315 1316 1340 1341 
12 57 71 72 93 96 102 144 187 202 203 211 213 217 229 237 240 241 248 262 263 276 318 319 332 345 378 420 431 435 437 440 441 476 492 505 530 550 560 563 566 592 605 622 735 748 753 754 764 766 783 789 821 836 852 855 892 915 941 981 987 996 1082 1114 1206 1209 1228 1289 1300 1317 
3 11 28 29 51 76 84 153 159 201 231 232 357 365 368 369 382 384 387 465 478 506 507 509 520 547 555 579 597 607 620 632 672 679 680 694 717 727 734 739 740 741 776 799 846 869 877 885 927 956 1000 1019 1024 1051 1059 1063 1078 1089 1146 1152 1155 1157 1164 1169 1176 1183 1288 1299 1343 
1 5 13 20 69 75 82 83 110 111 175 195 200 250 285 288 304 307 308 321 340 347 374 375 396 397 398 414 419 473 474 489 508 511 540 541 546 556 569 570 581 595 619 643 644 652 688 710 728 771 795 819 980 1029 1044 1077 1170 1198 1226 1285 1325 
26 55 60 162 163 189 265 289 305 322 362 390 403 417 418 453 459 497 527 538 614 708 719 731 763 768 769 774 818 820 848 859 879 910 917 918 939 945 986 1066 1080 1179 1186 1190 1212 1213 1221 1274 1304 1318 
14 15 109 115 116 267 326 341 494 501 535 536 565 567 593 596 608 612 633 639 690 699 743 785 826 871 911 913 968 1004 1025 1041 1070 1071 1090 1109 1148 1203 1211 1230 1242 1259 1265 1266 1286 1301 1303 1309 1334 
53 79 118 192 235 259 296 323 339 370 380 383 416 463 493 574 580 583 649 676 696 706 721 850 851 863 902 940 975 977 984 994 1038 1047 1073 1113 1133 1136 1178 1193 1194 1264 1278 1344 
32 37 52 78 125 126 219 269 290 293 294 303 367 400 434 442 443 495 544 609 610 613 640 661 662 697 713 971 989 992 1023 1048 1075 1101 1115 1117 1156 1210 1253 1254 1267 1268 
65 106 139 176 184 188 216 224 239 260 313 348 353 512 602 611 637 674 767 788 937 1009 1010 1026 1027 1068 1069 1116 1130 1185 1191 1208 1270 1275 1295 1296 1297 1313 1322 1323 1339 1345 
8 77 156 157 185 258 316 317 334 372 445 479 532 576 631 684 703 746 755 758 839 840 844 853 862 868 878 935 963 1005 1034 1112 1128 1161 1165 1220 1263 1269 1279 1287 1298 
91 92 177 178 333 343 539 559 654 682 897 906 907 932 985 991 1045 1246 
168 247 482 558 641 642 685 829 830 924 928 999 1036 1084 1121 1144 
422 586 587 831 837 838 955 1074 1217 1256 1283 1293 1338 
751 760 793 822 893 1181 1207 1218 1219 1222 1223 1248 1328 
