0 22 34 36 40 88 119 148 165 208 212 220 227 255 272 277 324 360 364 381 382 384 388 421 433 464 473 475 477 503 513 516 526 573 574 599 600 627 695 749 781 803 832 888 908 936 957 1097 1125 1129 1149 1162 1240 1247 1273 1332 1348 
48 56 105 127 128 137 170 171 191 233 244 264 366 393 408 410 446 460 486 487 542 564 571 616 623 624 656 673 692 715 723 775 809 898 966 969 1060 1107 1108 1124 1135 1170 1177 1233 1234 1241 1272 1290 1302 1306 
44 99 100 149 199 238 275 358 359 432 462 466 471 490 514 515 523 543 554 618 665 784 794 916 933 952 954 976 988 1053 1076 1091 1123 1141 1147 1200 1333 
57 93 144 202 237 248 318 378 389 420 437 476 478 530 566 595 783 827 855 915 941 987 996 1082 1206 1289 1300 1317 
154 225 226 299 300 328 369 386 521 537 601 690 729 750 903 1003 1014 1016 1056 1057 1215 1258 1264 1319 1346 
102 187 203 211 217 229 262 276 319 332 345 435 440 441 550 558 560 622 735 753 754 766 852 981 
14 15 115 116 267 326 565 596 608 743 913 968 1004 1025 1070 1071 1090 1230 1242 1259 1266 1303 
52 68 126 290 293 294 442 495 640 670 697 971 992 1022 1023 1048 1093 1117 1145 1210 1214 1253 
46 140 167 206 281 391 395 400 499 500 589 714 726 796 797 800 835 946 947 1042 1079 
141 214 231 236 268 295 425 434 496 528 552 675 718 801 884 943 1021 1277 
4 33 45 70 129 130 254 301 302 454 483 577 944 1238 1239 
39 193 377 402 456 469 470 881 923 925 934 972 1030 1049 1072 
198 270 297 298 335 341 533 535 536 871 958 973 1148 1301 
60 162 163 390 417 418 527 538 614 708 719 747 763 
76 110 379 387 474 506 620 717 776 846 1089 1169 
186 371 584 636 666 698 782 964 1054 1104 1199 1342 
317 334 372 445 631 703 746 868 1005 1034 1112 1263 
28 29 159 465 734 927 1000 1019 1155 1176 1288 
106 176 188 224 260 313 348 512 1068 1208 1275 
135 204 325 680 687 824 912 1119 1120 1175 1305 
6 180 190 376 401 585 663 686 875 1106 
7 73 74 329 484 545 865 900 1249 1324 
16 17 240 251 273 274 405 929 1235 1291 
49 218 219 350 588 812 1040 1086 1197 1260 
139 164 216 758 937 1009 1010 1116 1185 1191 
145 336 337 411 568 611 709 759 1204 1329 
426 572 590 658 669 778 845 856 931 1142 
453 768 769 917 918 939 1179 1190 1274 1284 
18 123 152 174 221 406 407 447 867 
91 92 343 654 682 906 907 1045 1246 
1 65 195 347 556 688 732 1029 
8 316 839 840 853 862 935 1161 
32 232 546 679 713 1115 1156 1254 
47 327 349 352 798 980 1094 1331 
61 134 427 619 701 742 1001 1100 
107 108 196 284 525 603 733 982 
215 246 681 756 811 857 1182 1281 
482 641 642 830 924 928 1084 1144 
628 629 711 712 805 806 1158 1336 
777 873 1033 1088 1153 1262 1292 1316 
11 547 607 694 741 767 1345 
13 79 83 111 235 250 580 
26 67 459 497 848 859 1304 
35 351 659 660 1216 1220 1354 
38 522 738 833 834 1151 1257 
78 609 610 661 662 989 1101 
89 90 222 278 1110 1140 1311 
101 314 480 621 716 770 813 
124 502 722 792 1244 1245 1261 
132 205 354 488 625 815 1201 
310 311 655 882 887 965 1031 
436 485 689 894 895 1006 1039 
458 760 960 1132 1222 1248 1282 
507 555 578 579 632 727 1114 
1181 1207 1218 1219 1223 1312 1328 
3 591 638 737 1173 1183 
10 461 683 1064 1122 1349 
20 342 511 1198 1278 1325 
23 85 86 744 942 1195 
24 136 242 517 1232 1350 
31 634 899 953 970 1271 
42 64 234 309 457 861 
62 646 874 1011 1330 1335 
97 98 423 439 1028 1252 
103 104 197 472 904 905 
113 114 158 606 653 752 
146 230 287 363 858 1168 
151 772 949 950 1111 1255 
266 404 651 843 1013 1055 
330 331 518 920 1018 1184 
731 755 774 879 1212 1229 
740 885 956 1059 1078 1157 
850 851 863 1073 1113 1133 
2 175 414 771 819 
19 179 553 559 562 
21 207 279 901 1143 
37 303 355 367 544 
41 757 1002 1087 1188 
53 261 413 1224 1225 
54 147 880 1065 1083 
55 403 945 1066 1186 
59 504 575 635 724 
63 872 1037 1189 1265 
75 285 397 569 795 
94 415 650 1270 1315 
117 291 292 922 1043 
120 320 357 816 1160 
182 282 725 914 1163 
183 373 519 702 1096 
184 239 602 1069 1130 
189 305 322 362 1213 
209 247 808 999 1036 
253 283 529 664 930 
399 974 1017 1172 1227 
412 617 736 1137 1138 
450 630 836 921 1171 
451 761 762 870 1276 
468 524 1236 1243 1351 
498 549 582 807 1159 
864 998 1154 1167 1321 
5 133 289 820 
12 263 563 821 
25 121 306 467 
30 978 1187 1205 
51 356 597 1146 
66 280 847 1192 
71 72 748 892 
87 161 645 1320 
112 169 1058 1294 
142 223 1067 1347 
150 346 1118 1150 
156 157 576 878 
185 1128 1164 1165 
210 1052 1063 1105 
228 531 594 967 
249 643 644 728 
258 684 1279 1298 
296 383 508 1178 
339 416 696 721 
370 380 676 984 
422 831 955 1338 
424 668 841 959 
428 444 534 810 
557 866 1007 1061 
567 785 1152 1211 
593 612 791 911 
647 1050 1134 1326 
707 780 814 1035 
1074 1217 1256 1293 
43 730 993 
58 667 1237 
69 340 419 
81 886 1131 
82 398 1077 
84 672 877 
95 122 745 
96 995 1209 
109 826 876 
118 166 977 
138 720 789 
153 201 869 
160 243 491 
172 256 693 
194 657 1231 
200 288 1139 
252 438 979 
257 338 548 
259 649 1038 
265 818 910 
269 443 1075 
333 985 991 
344 849 1166 
361 909 1081 
368 520 1024 
374 375 1044 
396 493 1136 
429 765 961 
430 705 890 
452 479 613 
463 691 940 
481 598 823 
501 1041 1109 
539 897 932 
540 1226 1285 
639 699 951 
671 825 1314 
674 788 1196 
677 678 828 
739 1299 1343 
804 997 1310 
837 838 1283 
842 1026 1027 
854 891 1012 
962 963 1269 
986 1221 1287 
1046 1085 1202 
1098 1102 1295 
