1 6 7 12 22 24 25 34 36 40 52 58 67 68 73 74 88 119 121 129 130 148 154 165 169 208 220 225 226 227 236 242 245 277 299 300 306 309 314 315 321 324 325 328 329 376 381 386 387 398 401 412 421 433 464 467 475 477 484 489 491 503 513 516 517 526 537 545 546 570 573 585 586 591 600 601 606 611 627 630 638 663 670 671 686 695 726 729 749 780 792 814 832 837 838 865 874 875 891 900 903 908 957 988 994 1003 1011 1012 1014 1016 1020 1022 1023 1035 1055 1056 1057 1058 1078 1081 1102 1106 1125 1129 1149 1162 1169 1173 1187 1214 1215 1238 1239 1240 1244 1245 1258 1261 1271 1273 1283 1294 1319 1332 1348 
41 80 102 103 104 107 108 113 114 156 164 167 168 173 182 186 196 197 198 203 214 228 240 251 257 270 273 282 286 297 298 322 335 338 341 371 385 389 392 404 451 472 493 494 525 531 533 535 536 548 551 589 594 603 615 636 648 651 653 661 662 667 668 698 699 723 725 727 733 737 744 752 757 762 800 802 807 808 824 843 860 871 902 904 905 918 929 951 958 959 967 973 982 983 984 989 996 1002 1013 1017 1042 1046 1047 1054 1085 1087 1101 1103 1104 1119 1120 1136 1139 1148 1188 1202 1276 1301 1324 1342 
0 4 10 18 31 44 46 47 65 98 100 123 131 149 152 160 161 184 215 221 239 243 265 275 291 292 295 310 311 358 359 360 394 395 400 409 423 425 428 432 439 447 450 461 462 466 471 490 514 523 527 528 541 543 561 618 626 634 649 659 660 665 673 674 683 709 718 722 732 756 767 784 786 787 790 794 818 841 889 899 916 933 938 946 948 952 953 954 970 976 1021 1028 1029 1043 1053 1064 1069 1079 1091 1095 1122 1123 1130 1141 1147 1180 1200 1204 1216 1233 1252 1320 1333 1345 1349 1354 
48 56 57 105 106 110 127 128 137 140 141 145 170 171 175 176 188 189 191 206 210 224 233 238 260 264 281 312 313 330 348 391 393 407 437 446 460 486 487 496 497 499 501 512 521 534 542 552 564 571 584 616 623 624 633 656 690 691 692 714 715 748 771 775 785 789 796 797 801 809 819 835 867 892 914 943 947 960 966 969 1041 1068 1105 1107 1108 1124 1135 1163 1177 1208 1234 1241 1247 1270 1272 1275 1277 1290 1302 1306 1313 1339 
8 54 72 93 144 146 147 166 187 202 211 229 230 248 263 276 287 318 319 378 420 431 435 436 441 448 476 485 492 530 540 558 560 563 566 602 689 753 764 766 783 821 852 855 858 880 886 894 895 915 921 980 987 1006 1015 1031 1039 1065 1082 1083 1093 1168 1170 1206 1226 1249 1285 1289 1317 
9 21 30 33 45 70 97 125 126 158 172 174 180 190 207 234 244 254 268 271 279 290 293 294 301 302 317 334 379 424 429 434 442 454 495 506 622 631 640 693 697 703 746 747 844 868 901 941 944 956 961 971 978 992 1008 1032 1048 1112 1117 1143 1205 1210 1253 1263 1267 1268 1310 1312 1331 
13 20 23 37 69 82 85 86 87 94 112 135 195 200 204 205 212 216 219 249 250 255 272 288 303 308 327 340 349 352 355 356 361 367 415 419 440 511 544 557 604 643 644 650 687 728 765 781 798 803 817 866 909 937 942 1007 1061 1077 1094 1195 1201 1282 1300 1307 1308 1315 1325 
5 27 42 64 75 81 83 111 132 136 155 218 256 259 284 285 296 305 307 347 354 362 375 380 383 396 397 457 458 473 474 481 488 554 556 569 578 581 582 595 598 625 652 676 688 710 721 773 795 815 995 1038 1044 1050 1060 1131 1159 1178 
2 3 49 50 71 76 96 153 201 241 258 261 350 369 382 413 479 498 549 588 684 769 777 810 812 842 869 873 883 939 963 1033 1040 1051 1063 1086 1088 1089 1153 1183 1190 1197 1209 1260 1262 1265 1269 1274 1279 1284 1292 1298 1316 1327 1340 1341 
11 331 357 384 478 509 510 518 547 555 579 607 632 694 739 740 741 799 833 834 854 920 1059 1114 1145 1146 1150 1151 1152 1157 1179 1184 1256 1257 1299 1343 
14 15 109 115 116 267 326 565 567 596 608 646 647 743 826 913 968 1004 1025 1070 1071 1090 1134 1203 1211 1230 1236 1242 1259 1266 1286 1303 1309 1326 1334 1335 
32 38 139 370 405 522 613 675 713 738 850 851 863 919 1009 1010 1018 1026 1027 1052 1062 1073 1099 1109 1113 1115 1116 1133 1185 1191 1254 1278 1280 1296 1297 
95 117 122 183 253 316 345 353 372 373 426 445 453 572 590 637 639 658 669 745 755 768 778 845 856 910 917 931 936 1005 1034 1066 1142 1322 1323 
43 63 124 252 304 320 342 344 365 438 502 550 577 681 730 754 827 857 864 872 898 962 979 981 993 998 1037 1154 1167 1189 1222 1248 1321 
177 178 237 333 399 449 455 505 539 592 707 788 823 839 840 853 862 897 932 935 974 985 991 1076 1098 1161 1172 1227 1228 1237 1295 
26 55 60 162 163 181 289 332 390 403 417 418 444 459 538 614 708 763 820 848 859 870 945 1080 1186 1213 1304 1318 
89 90 120 133 222 278 468 500 515 524 816 849 1110 1140 1160 1166 1171 1175 1193 1194 1224 1225 1229 1232 1243 1311 1350 1351 
29 217 231 232 482 507 641 642 679 680 734 830 924 927 928 1019 1084 1092 1144 1155 1164 1165 1176 1288 1305 
17 39 193 194 377 402 456 469 470 657 791 881 923 925 934 972 1030 1049 1156 1231 1291 
53 91 92 192 213 343 452 559 568 605 654 682 731 774 906 907 975 1045 1212 1246 
59 66 280 366 388 406 410 504 575 599 635 724 804 847 888 912 997 1097 1192 
51 142 143 223 597 677 678 706 750 776 828 1067 1264 1337 1344 1346 1347 
101 151 246 363 364 480 621 770 772 811 813 949 950 1111 1182 1255 1281 
28 62 77 422 465 532 587 735 831 955 1001 1217 1293 1330 1338 
99 199 617 628 629 711 712 736 805 806 861 1137 1138 1158 1336 
185 209 247 666 685 761 782 793 822 829 964 999 1036 1121 1199 
19 61 134 179 408 427 553 562 619 701 742 1100 1196 1198 
79 235 269 430 443 508 574 580 705 890 1072 1075 
16 78 274 609 610 836 879 986 1221 1235 1287 
84 368 520 620 672 716 717 846 876 877 1024 
138 262 374 519 700 702 719 720 926 1074 1096 
118 159 339 416 645 696 884 885 977 1000 
336 337 411 483 655 759 882 887 965 1329 
751 760 893 1132 1181 1207 1218 1219 1223 1328 
157 576 593 612 758 878 911 1128 1220 
266 323 414 463 583 896 940 990 
35 283 351 529 664 922 930 
150 346 704 779 825 1118 1314 
