4 5 7 10 11 14 26 30 33 48 56 57 73 84 85 97 107 108 118 125 126 129 131 133 136 138 158 162 172 173 180 187 188 191 201 203 206 207 210 222 237 244 260 271 284 288 294 300 301 302 334 336 337 351 352 389 390 393 395 396 397 404 407 410 412 418 419 424 429 434 436 437 447 448 453 454 458 460 461 473 474 485 506 512 530 531 532 539 542 550 556 565 578 579 581 582 595 598 600 601 611 614 624 648 651 656 657 670 687 693 694 702 704 707 714 715 721 723 728 733 742 748 754 759 771 773 778 784 796 797 802 803 809 818 820 824 841 850 851 860 889 913 932 933 942 944 945 947 951 956 962 963 969 974 981 985 996 1000 1020 1047 1050 1055 1063 1068 1073 1075 1077 1119 1120 1124 1135 1136 1145 1159 1165 1177 1195 1206 1207 1223 1233 1234 1236 1256 1269 1275 1278 1279 1288 1290 1291 1300 1302 1306 1310 1313 1315 1321 1328 1329 1339 
1 9 12 13 15 22 23 24 31 32 34 36 37 40 42 43 44 53 55 59 63 64 66 86 87 89 93 94 139 148 149 165 174 189 195 208 212 219 220 224 234 235 245 250 257 265 269 277 278 279 296 303 305 306 308 309 320 322 325 327 339 340 341 349 350 353 354 360 361 366 368 374 381 388 392 403 406 414 421 422 438 442 443 467 468 475 501 502 503 515 516 526 535 567 570 573 588 591 594 599 608 619 626 627 630 631 645 649 674 676 696 724 743 758 765 770 777 781 787 793 814 816 817 845 856 863 867 871 872 875 877 878 899 909 912 936 940 943 948 953 955 960 970 979 990 997 998 1008 1011 1023 1024 1029 1037 1070 1071 1078 1106 1116 1147 1148 1154 1172 1185 1187 1205 1213 1217 1247 1252 1260 1266 1271 1273 1301 1307 1308 1309 1332 1334 1348 
17 27 29 60 100 117 121 127 163 181 182 183 184 185 186 243 253 281 290 312 313 316 331 332 333 345 357 372 373 401 405 417 444 445 449 450 452 469 470 472 480 500 511 521 524 543 547 551 553 568 572 587 605 637 639 658 660 666 671 673 683 690 722 731 755 789 822 849 855 870 916 920 921 931 938 939 941 964 965 975 1005 1016 1034 1043 1049 1053 1092 1121 1123 1128 1130 1140 1163 1179 1186 1196 1200 1212 1216 1225 1229 1318 1322 1323 1351 1354 
16 39 51 75 81 83 111 119 128 132 137 159 171 218 221 223 227 228 247 255 256 259 262 285 292 304 307 315 342 347 362 375 430 439 457 464 477 486 489 529 564 569 575 576 586 616 623 625 635 643 664 669 688 692 736 772 779 780 790 792 821 837 838 890 894 895 926 930 961 966 993 995 1006 1033 1035 1041 1048 1060 1072 1087 1095 1102 1107 1108 1111 1125 1129 1138 1146 1180 1199 1222 1244 1245 1248 1261 1272 1283 1347 
20 46 52 54 58 65 70 88 112 124 135 141 155 160 161 169 194 200 204 226 238 239 249 263 268 275 321 323 329 379 380 402 409 428 484 505 527 528 534 545 546 589 615 634 644 653 667 672 681 703 709 711 712 718 732 737 745 767 782 785 800 804 811 812 827 839 840 848 857 865 897 923 949 958 980 983 1026 1030 1067 1069 1093 1094 1096 1114 1158 1169 1182 1189 1204 1249 1277 1305 1320 1325 1345 
3 41 76 80 82 98 101 156 157 215 240 241 242 252 261 264 273 286 293 310 311 369 382 384 385 413 435 459 463 476 478 488 493 494 495 508 522 544 552 558 561 562 593 612 632 640 654 655 691 697 744 749 756 774 795 799 810 836 842 843 858 864 883 904 911 929 967 971 982 986 991 1007 1012 1021 1027 1036 1054 1080 1085 1086 1088 1089 1117 1162 1167 1211 1214 1241 1265 1281 
2 21 72 95 103 109 115 150 151 197 205 230 248 314 317 318 376 377 426 451 487 497 507 540 541 555 566 607 646 647 689 705 706 708 710 725 739 761 805 806 826 833 834 866 868 882 901 915 987 994 1031 1046 1109 1112 1113 1115 1118 1134 1142 1143 1150 1151 1166 1168 1170 1175 1183 1184 1194 1201 1226 1232 1238 1246 1254 1255 1257 1259 1263 1276 1285 1289 1326 1327 1335 1336 1338 1343 1350 
0 19 68 69 104 122 130 140 144 146 164 166 167 179 190 236 258 272 287 324 338 343 356 367 371 383 391 400 423 427 440 498 499 520 548 549 557 563 583 584 590 604 606 609 650 652 663 682 698 726 786 815 835 893 906 907 908 957 978 1039 1044 1045 1122 1133 1141 1220 1221 1239 1287 1349 
6 8 35 170 209 211 216 229 246 283 289 363 364 399 420 441 513 620 621 668 695 716 717 730 753 813 831 832 900 902 903 922 935 950 954 1015 1022 1057 1064 1103 1149 1188 1227 1228 1240 1324 
74 123 196 254 479 482 483 554 592 641 642 727 734 769 829 830 862 873 881 924 927 928 976 1002 1042 1061 1084 1105 1132 1144 1153 1164 1178 1190 1197 1219 1253 1267 1268 1274 1284 1312 1316 1331 1340 1341 
47 90 147 152 295 298 326 355 358 359 370 394 425 462 471 523 636 665 699 757 764 794 798 808 879 880 910 937 946 984 1004 1028 1065 1079 1082 1083 1104 1110 1181 1218 1282 1311 1342 
25 91 213 214 280 299 328 415 433 504 525 536 537 580 602 603 610 629 677 678 729 776 801 807 846 847 853 859 869 888 898 1014 1038 1081 1097 1176 1192 1202 1262 1292 1317 1319 
28 49 50 61 62 71 79 96 134 416 455 456 465 492 574 617 618 735 740 741 762 768 791 823 854 861 876 896 925 1001 1013 1040 1066 1100 1152 1157 1198 1209 1231 1286 1294 1330 
99 153 177 192 193 198 199 270 297 319 335 411 491 519 533 560 585 628 686 700 719 720 766 783 852 874 886 887 919 934 959 972 973 1017 1018 1051 1074 1131 1156 1280 
45 120 217 231 232 378 446 496 613 622 633 638 679 680 746 747 752 763 891 892 917 918 992 1019 1062 1155 1160 1171 1173 1193 1210 1224 1243 1304 
67 77 78 102 113 114 142 143 168 202 251 274 276 282 344 481 538 577 661 662 675 738 751 760 989 1058 1059 1101 1235 1264 1293 1337 1344 
38 106 110 145 175 176 233 330 348 514 517 518 684 685 819 884 885 914 952 977 988 999 1052 1091 1139 1208 1215 1270 1298 
18 178 365 408 431 432 571 596 597 659 701 713 788 905 1076 1098 1161 1237 1242 1295 1299 
92 105 116 266 291 346 398 466 490 559 775 825 844 1032 1099 1137 1203 1314 1333 
154 225 386 387 509 510 750 828 1003 1056 1258 1346 
267 968 1025 1090 1230 1303 
1009 1010 1191 1296 1297 
