10 27 31 44 46 47 48 56 100 105 106 127 128 137 140 141 142 143 149 160 161 170 171 176 180 184 188 190 191 206 215 223 224 231 233 236 238 239 243 254 260 264 268 275 295 313 348 358 359 391 393 408 409 425 432 446 454 460 461 462 466 471 477 483 486 487 490 491 496 499 500 512 514 521 523 528 534 540 541 542 543 552 554 561 564 571 602 616 618 623 624 626 634 656 659 660 665 674 675 683 691 692 714 715 718 726 756 773 775 784 788 790 794 796 797 801 809 884 885 898 899 916 933 943 944 946 947 948 952 953 954 966 969 970 976 1021 1046 1053 1064 1067 1068 1069 1076 1085 1091 1095 1107 1108 1122 1123 1124 1130 1135 1141 1147 1170 1177 1180 1200 1202 1208 1216 1226 1233 1234 1237 1241 1270 1272 1275 1277 1285 1290 1295 1302 1306 1313 1320 1333 1337 1339 1347 1349 1354 
6 7 22 34 36 40 58 67 73 74 81 88 119 120 123 133 148 154 165 169 181 208 220 225 226 227 255 273 299 300 315 320 324 328 329 376 381 386 388 401 412 421 433 464 468 473 475 484 503 513 515 516 524 526 537 545 570 573 584 585 599 600 601 617 627 628 629 647 650 663 686 695 711 712 729 736 749 750 781 805 806 816 832 849 861 865 875 900 903 908 957 1003 1014 1050 1056 1057 1058 1106 1129 1137 1138 1149 1158 1160 1166 1171 1175 1215 1229 1232 1236 1240 1243 1247 1258 1271 1273 1294 1319 1326 1332 1336 1346 1348 1350 1351 
1 13 20 65 69 75 82 83 87 111 112 124 139 195 200 216 249 250 285 288 304 307 308 336 337 340 342 347 361 374 375 396 397 398 419 498 502 511 549 556 581 582 611 643 644 645 652 688 709 710 722 728 759 792 795 909 937 980 1009 1010 1026 1027 1029 1044 1077 1081 1116 1159 1185 1191 1196 1198 1204 1244 1245 1261 1262 1296 1297 1325 1329 
4 18 30 33 45 54 70 131 135 146 147 152 158 166 172 174 204 221 230 256 271 286 287 301 302 325 394 395 400 406 407 429 430 447 449 450 687 693 705 747 748 807 858 864 867 880 883 889 890 892 912 921 961 962 978 998 1020 1060 1065 1079 1083 1088 1093 1154 1168 1187 1205 1249 1305 1312 1321 1327 
3 11 76 84 153 201 357 365 368 369 382 384 387 478 479 506 507 509 520 547 555 579 607 620 632 672 677 678 694 716 717 727 739 740 741 767 776 799 828 846 869 877 956 1024 1051 1059 1078 1089 1114 1152 1157 1169 1179 1183 1299 1343 1345 
17 24 25 39 52 68 121 136 138 193 194 228 242 245 277 306 330 331 377 402 452 456 467 469 470 517 518 609 610 621 657 670 671 791 827 881 920 923 925 929 934 972 1018 1022 1023 1030 1048 1049 1072 1145 1184 1214 1231 1291 
5 12 57 72 89 90 93 94 144 202 213 222 237 248 263 278 318 353 378 420 431 437 476 510 530 563 566 595 604 605 637 764 766 783 817 821 855 915 987 1082 1110 1140 1206 1311 1317 1322 1323 
41 102 103 104 107 108 113 114 156 164 196 197 203 251 282 284 389 472 525 603 630 653 655 667 706 733 737 752 757 762 802 882 887 904 905 919 965 982 983 988 1002 1017 1031 1087 1139 1264 1344 
19 61 62 95 122 134 179 345 426 427 553 557 562 572 590 619 646 658 669 701 742 745 765 778 845 856 866 874 876 896 931 936 990 1001 1007 1011 1061 1100 1142 1286 1307 1308 1330 1335 
16 38 78 145 209 210 274 312 341 405 411 494 522 535 536 568 569 633 661 662 673 690 738 782 808 871 879 914 938 986 989 1016 1052 1055 1063 1099 1101 1105 1148 1235 1265 1280 1301 
37 42 64 79 96 155 234 235 303 309 327 349 352 355 367 379 415 457 493 544 574 580 583 732 798 850 851 863 902 995 1047 1073 1094 1113 1133 1136 1209 1278 1315 1331 
14 15 109 115 116 267 326 501 565 567 593 596 608 612 639 699 743 785 826 911 913 968 1004 1025 1041 1070 1071 1090 1109 1134 1203 1211 1230 1242 1259 1266 1303 1309 1334 
80 110 167 173 186 214 266 385 392 404 444 451 474 531 578 589 594 615 651 668 723 761 800 841 843 860 870 951 967 996 1013 1042 1062 1103 1276 
182 185 198 229 270 283 297 298 335 371 529 533 550 551 636 648 664 666 698 725 824 930 958 964 973 1054 1104 1119 1120 1163 1199 1225 1342 
8 177 178 211 262 319 333 435 440 441 455 539 560 592 622 735 753 754 823 839 840 853 862 897 932 935 981 985 991 1161 
0 51 212 219 259 269 272 296 356 360 383 443 508 597 649 751 760 803 893 1038 1075 1146 1178 1181 1207 1218 1219 1223 1328 
49 50 71 218 240 241 261 350 413 492 588 777 810 812 842 873 1033 1040 1086 1092 1153 1167 1197 1224 1260 1292 1316 1340 1341 
55 162 163 189 265 289 305 322 362 403 418 453 538 708 763 768 769 818 820 910 939 945 1066 1186 1190 1213 1274 1284 
32 125 126 290 293 294 434 442 495 613 640 697 713 789 941 971 992 1115 1117 1156 1210 1253 1254 1267 1268 1289 1300 
66 101 151 246 280 314 363 364 480 681 770 772 811 813 847 857 888 949 950 1097 1111 1182 1192 1255 1281 
26 60 281 332 390 417 459 497 527 614 731 774 848 859 917 918 1080 1212 1304 1318 
23 59 85 86 244 323 366 410 504 575 635 724 744 804 942 997 1036 1195 1310 
91 92 175 321 343 414 489 546 559 654 682 771 819 906 907 1045 1246 
129 130 424 591 606 638 854 891 959 1012 1098 1102 1125 1162 1173 1238 1239 
28 29 159 217 232 465 679 680 734 927 1000 1019 1155 1164 1176 1288 
53 192 339 370 380 416 463 676 696 721 940 975 984 994 1193 1194 
117 183 253 291 292 316 372 373 445 755 922 1005 1034 1043 
168 247 482 641 642 685 829 830 924 928 999 1084 1121 1144 
150 346 704 779 825 833 834 835 1118 1150 1151 1257 1314 
422 586 587 831 837 838 955 1074 1217 1256 1283 1293 1338 
43 63 252 344 438 577 730 872 979 993 1037 1189 
77 317 334 428 532 631 703 746 844 868 1112 1263 
35 205 351 436 485 689 894 895 1006 1039 1201 
99 199 519 700 702 719 720 886 926 1096 1131 
97 98 310 311 423 439 1008 1028 1032 1252 
257 258 338 548 684 963 1165 1269 1279 1298 
399 505 707 780 814 974 1035 1172 1227 1228 
2 9 21 207 279 448 901 1015 1143 
132 354 481 488 598 625 786 787 815 
157 576 758 878 1128 1220 1221 1287 
118 458 960 977 1132 1282 
187 276 558 836 852 
793 822 1222 1248 
