8 10 18 31 44 46 48 56 57 96 98 100 105 106 123 127 128 131 137 140 141 145 149 152 160 161 167 170 171 172 176 188 189 191 206 215 221 224 231 233 236 237 238 243 260 264 265 268 271 275 281 295 301 313 339 341 358 359 391 393 394 395 398 406 407 408 416 423 425 428 429 432 437 439 447 460 461 462 466 471 477 485 486 487 490 496 499 507 512 523 528 530 534 539 541 542 543 552 564 571 608 616 618 623 624 626 634 638 649 656 665 674 675 683 691 692 693 696 699 714 715 718 737 757 771 775 784 794 797 802 809 818 835 839 840 851 862 867 889 897 899 916 932 933 935 943 946 947 948 952 953 954 966 969 970 974 976 983 1002 1004 1021 1028 1043 1053 1064 1068 1073 1079 1087 1091 1107 1108 1122 1123 1124 1135 1141 1147 1177 1188 1196 1200 1208 1209 1210 1224 1231 1233 1234 1241 1247 1270 1271 1272 1275 1290 1302 1306 1313 1317 1320 1324 1333 1339 1349 
0 1 6 7 11 12 22 34 36 40 58 65 73 74 76 84 88 119 148 153 154 165 169 180 184 190 201 208 210 220 225 226 227 239 291 292 299 315 324 328 329 330 331 360 368 369 376 381 382 384 386 387 401 412 421 424 433 464 475 478 484 491 503 506 513 516 518 520 526 537 545 547 555 570 573 579 585 586 593 600 601 607 627 630 632 663 672 686 694 695 709 729 740 741 749 750 767 781 790 792 814 816 832 837 838 846 854 865 869 875 876 877 878 900 903 908 920 956 957 988 994 1003 1011 1014 1016 1024 1029 1051 1055 1056 1057 1058 1059 1063 1069 1078 1081 1095 1106 1114 1129 1130 1145 1149 1157 1162 1169 1180 1184 1193 1202 1204 1240 1244 1245 1256 1258 1260 1261 1264 1265 1273 1277 1283 1294 1319 1332 1345 1346 1348 
41 80 102 103 104 107 108 113 114 156 164 168 173 182 185 186 196 197 198 199 202 209 214 228 247 251 257 270 282 284 286 297 298 312 322 335 338 357 371 385 389 392 404 451 472 525 531 533 548 551 558 589 594 603 615 636 648 651 653 666 667 668 673 685 698 723 727 733 752 761 762 782 793 800 822 841 843 860 902 904 905 938 951 958 959 964 967 973 982 984 992 996 999 1013 1036 1042 1046 1048 1054 1085 1102 1103 1104 1121 1125 1199 1222 1243 1248 1276 1342 
17 28 29 32 38 39 49 50 53 71 193 194 232 261 350 377 402 405 413 455 456 465 469 470 479 501 522 567 588 592 612 613 620 621 657 679 680 690 713 716 717 734 735 738 777 785 791 810 812 823 842 853 873 881 911 919 923 925 927 934 960 972 1018 1019 1030 1033 1040 1041 1049 1052 1062 1086 1092 1098 1109 1115 1132 1153 1155 1156 1176 1197 1225 1253 1254 1262 1267 1268 1278 1280 1292 1316 1340 1341 
54 72 93 135 144 146 147 166 187 207 230 248 250 263 276 279 287 310 311 318 353 420 431 448 449 450 476 509 510 540 563 566 602 637 655 677 678 687 689 725 739 764 776 796 799 808 817 821 824 828 852 855 858 866 880 882 912 915 921 965 987 1015 1031 1065 1082 1083 1093 1119 1120 1161 1168 1170 1194 1201 1226 1227 1249 1252 1285 1289 1299 1305 1322 1323 1343 
3 4 27 33 45 68 70 110 118 120 129 130 133 159 175 254 302 323 325 348 378 414 446 454 458 463 482 483 521 554 583 591 606 622 641 642 645 670 726 747 763 773 780 789 815 829 830 849 863 884 885 891 892 924 928 940 944 977 1000 1001 1012 1022 1035 1084 1105 1113 1133 1144 1160 1163 1166 1171 1173 1175 1178 1183 1214 1229 1232 1238 1239 1312 1350 
19 24 43 61 62 117 121 122 134 136 179 242 245 253 277 304 316 321 342 345 372 399 426 427 445 452 453 489 505 517 546 553 562 572 590 619 639 658 669 671 684 701 704 722 742 745 765 768 769 778 779 825 845 856 874 886 910 917 918 931 936 939 1005 1007 1017 1034 1061 1066 1100 1142 1172 1179 1190 1198 1215 1228 1274 1284 1298 1307 1308 1314 1330 
2 9 23 52 66 85 86 95 101 124 151 203 211 217 229 240 241 246 258 262 273 274 280 314 319 320 332 363 364 365 366 388 435 440 441 480 492 498 502 504 514 549 550 560 599 659 681 744 753 754 756 766 770 783 801 807 811 813 819 847 857 888 898 929 942 949 950 981 1020 1097 1111 1139 1164 1165 1182 1192 1195 1255 1279 1281 1288 1300 
13 20 21 25 37 47 63 69 87 94 97 112 158 195 200 204 205 216 244 249 252 255 269 272 288 303 306 308 327 340 344 349 352 355 356 361 367 409 410 415 419 438 467 508 511 544 577 604 643 644 650 728 730 798 850 872 901 909 914 937 979 980 993 1037 1075 1088 1089 1094 1143 1189 1217 1282 1291 1315 1325 1331 
14 15 89 90 99 109 115 116 222 266 267 278 300 326 468 500 515 524 565 596 611 617 628 629 646 647 711 712 736 743 805 806 826 861 868 896 913 962 963 968 990 1025 1047 1070 1071 1090 1110 1112 1134 1137 1138 1140 1152 1158 1203 1230 1236 1242 1259 1263 1266 1269 1286 1303 1309 1311 1326 1334 1335 1336 1351 
5 75 81 82 83 111 132 138 155 256 259 285 296 305 307 347 354 362 375 379 380 383 396 397 473 474 481 488 556 557 561 569 578 581 582 584 595 598 625 652 676 688 707 710 721 732 748 786 787 795 995 1038 1050 1060 1077 1131 1159 1206 1211 
26 55 60 67 91 92 139 162 163 181 192 213 289 343 370 390 403 417 418 444 459 497 527 538 559 568 605 654 682 708 731 755 774 820 848 859 870 906 907 945 975 1009 1010 1026 1027 1045 1080 1099 1116 1185 1186 1191 1212 1213 1246 1296 1297 1304 1318 
16 59 78 79 212 235 422 430 493 494 535 536 574 575 580 587 614 633 635 661 662 705 724 803 804 831 836 871 890 955 986 989 997 1072 1101 1136 1148 1235 1293 1301 1338 
42 51 64 77 142 143 157 218 223 309 317 334 336 337 411 457 532 576 597 631 703 746 758 759 772 844 879 883 887 961 1044 1067 1128 1146 1220 1221 1287 1327 1329 1337 1347 
30 125 126 174 219 234 290 293 294 400 434 436 442 443 495 609 610 640 697 751 760 893 894 895 941 971 978 1006 1023 1039 1117 1181 1187 1205 1207 1218 1219 1223 1310 1328 
150 183 346 373 374 519 700 702 719 720 827 833 834 864 926 998 1008 1032 1074 1096 1118 1150 1151 1154 1167 1257 1321 
35 177 178 283 333 351 529 660 664 788 922 930 985 991 1076 1216 1237 1295 1354 
