4 5 7 26 30 33 38 48 56 57 97 103 106 108 109 110 115 126 131 133 138 145 152 158 162 172 173 176 180 188 191 210 219 237 244 248 259 260 272 288 294 301 302 317 318 334 348 352 368 389 390 393 397 407 410 416 417 418 419 426 429 436 437 445 447 454 460 461 462 474 512 523 530 532 542 556 566 577 579 580 595 598 600 624 647 648 656 665 668 670 673 687 693 704 707 710 715 721 723 728 742 757 773 784 794 802 803 805 806 809 817 820 823 827 841 868 890 915 932 933 944 945 946 951 969 974 983 985 987 992 996 1004 1020 1032 1034 1052 1060 1063 1068 1073 1079 1112 1124 1134 1135 1136 1142 1170 1175 1177 1181 1184 1186 1194 1195 1205 1206 1208 1218 1219 1223 1233 1234 1241 1243 1246 1256 1259 1263 1270 1275 1278 1279 1290 1302 1306 1310 1312 1313 1315 1326 1328 1335 1336 1339 
1 12 13 15 22 23 31 32 34 36 37 40 42 43 44 53 55 59 63 64 66 79 82 83 86 87 89 93 94 111 148 149 153 174 178 189 195 208 212 220 224 234 235 238 250 255 257 258 269 277 278 285 296 303 304 305 306 307 308 309 320 322 325 327 339 340 341 347 349 353 354 355 360 361 362 374 375 381 388 392 394 403 406 414 421 422 430 438 467 468 501 502 503 514 515 516 526 535 573 588 594 599 608 619 626 627 631 649 669 688 736 743 758 765 770 781 787 793 821 845 867 871 872 875 877 899 909 936 943 948 953 955 970 995 997 998 1024 1029 1037 1066 1102 1106 1125 1147 1148 1154 1162 1178 1187 1193 1198 1213 1247 1260 1265 1266 1271 1272 1273 1301 1307 1308 1309 1332 1334 1348 
0 19 67 68 69 104 118 122 140 146 164 166 167 170 179 190 251 256 287 293 324 338 356 358 363 367 383 391 395 400 423 427 440 463 470 485 498 499 520 548 549 557 582 583 604 609 640 652 680 682 691 697 726 786 800 835 889 893 906 907 908 957 971 978 1039 1044 1045 1117 1133 1145 1159 1220 1253 1267 1268 1331 
2 20 47 54 65 70 88 90 92 112 124 135 147 155 169 175 194 204 226 233 249 263 298 321 330 379 380 471 517 518 559 570 581 589 601 615 644 676 681 711 712 732 798 804 808 811 812 819 825 848 857 879 880 920 980 984 1018 1065 1067 1082 1083 1093 1094 1099 1114 1158 1168 1182 1189 1305 1325 
3 41 80 98 101 134 215 230 252 286 299 310 311 345 369 382 384 385 435 439 459 476 493 494 522 552 558 561 562 572 590 650 654 655 658 735 744 749 750 756 774 795 843 856 858 864 866 883 894 904 931 967 979 986 991 1007 1021 1036 1080 1085 1088 1089 1214 1217 1231 1281 1346 
27 60 100 181 182 185 271 290 312 313 331 333 405 469 472 511 521 524 543 547 586 587 605 637 683 690 696 731 747 755 778 789 822 849 916 938 941 975 1000 1005 1014 1016 1053 1121 1123 1140 1163 1176 1179 1200 1212 1229 1289 1300 1322 1323 1351 
29 73 75 76 81 128 137 168 171 186 196 202 217 264 265 266 284 357 404 444 464 477 478 486 534 554 564 569 614 616 623 632 651 671 692 734 810 818 910 917 918 927 1019 1042 1050 1055 1058 1077 1086 1107 1108 1129 1207 1304 
46 121 141 160 161 231 232 239 268 275 323 402 409 425 428 434 456 505 527 528 539 545 602 633 634 653 672 679 718 782 785 839 840 884 885 897 923 925 958 1030 1049 1069 1096 1277 1318 1320 
28 61 62 96 150 211 216 229 253 262 283 376 377 441 465 507 555 584 646 708 725 753 771 833 834 874 876 896 990 994 1001 1011 1012 1054 1100 1103 1150 1151 1209 1238 1257 1286 1330 
14 107 117 187 203 267 291 332 336 337 346 396 525 550 553 565 603 611 709 722 733 754 759 792 913 922 968 981 1025 1090 1204 1230 1236 1244 1245 1261 1303 1329 
10 24 25 91 127 136 193 213 214 328 366 504 536 537 610 629 657 684 685 729 801 807 869 898 972 1038 1074 1202 1215 1232 1298 1319 1350 
6 35 99 177 198 199 205 209 246 247 270 297 314 335 424 519 533 585 607 663 686 689 813 895 900 959 973 1188 1201 1324 1327 1338 
77 78 113 114 142 143 144 274 276 458 563 606 661 662 738 760 836 960 989 1101 1132 1155 1197 1221 1222 1235 1248 1282 1287 1288 1293 1337 
16 39 119 132 192 218 223 245 350 411 415 457 475 488 489 568 625 635 700 779 780 861 1033 1035 1041 1071 1072 1118 1172 1347 
18 365 401 408 431 432 449 450 546 571 592 596 597 659 674 701 713 714 788 905 921 964 1043 1051 1061 1098 1161 1196 1242 1295 
45 71 72 120 261 378 413 446 495 496 497 622 724 746 748 752 763 815 842 891 892 1027 1062 1070 1160 1167 1173 1210 1224 1225 
50 84 85 201 292 300 412 443 473 506 531 574 575 617 618 702 767 942 962 963 1047 1075 1110 1269 1294 1311 1314 1321 1345 
21 49 129 130 254 451 482 483 578 641 642 761 762 829 830 870 901 924 928 1084 1105 1143 1144 1166 1183 1239 1276 
139 281 282 295 326 370 591 636 638 639 699 737 764 914 937 1009 1010 1023 1026 1028 1046 1104 1116 1185 1191 1296 1297 
9 11 125 165 206 207 222 279 319 442 448 500 630 694 719 766 797 814 816 850 851 863 878 940 947 1156 
102 240 241 273 492 509 510 739 740 799 828 854 929 956 1013 1059 1078 1115 1152 1157 1254 1299 1343 
51 52 221 227 228 315 643 790 837 838 949 961 1006 1048 1087 1095 1146 1180 1199 1283 
58 95 151 200 329 484 487 667 703 745 826 865 1109 1113 1139 1237 1249 1255 
154 225 386 620 621 695 716 717 730 831 832 950 1003 1015 1056 1057 1169 1228 
8 289 364 399 420 513 628 720 919 1017 1022 1064 1149 1227 1240 1280 
351 529 645 664 902 903 930 935 952 954 977 988 999 1076 1091 1258 
105 116 398 455 466 490 741 775 844 1040 1081 1137 1203 1262 1333 
197 540 541 705 706 882 886 887 1031 1131 1226 1264 1285 1344 
74 123 727 860 862 873 881 976 1002 1153 1316 1340 1341 
242 508 544 567 677 678 777 796 824 912 1119 1120 1211 
280 387 433 776 846 847 853 859 888 1097 1192 1292 1317 
156 157 236 371 698 982 1122 1141 1342 1349 
159 342 359 576 772 926 966 993 1111 1138 
163 316 372 551 666 855 965 1128 1164 1165 
183 184 373 660 1008 1092 1130 1216 1252 1354 
452 479 480 593 612 613 791 911 1171 
17 243 491 560 783 852 934 1291 
453 768 769 939 1190 1274 1284 
343 344 481 538 675 751 
