12 13 15 22 23 31 32 34 36 37 40 42 44 53 55 59 63 64 66 86 87 89 93 94 148 149 165 174 189 195 208 212 219 220 224 234 235 238 245 250 255 257 269 277 278 296 303 305 306 309 320 322 325 327 339 340 341 349 350 353 354 355 360 361 362 366 374 381 388 392 394 403 406 414 421 422 438 442 467 468 475 501 502 503 515 516 526 535 573 588 594 599 608 619 626 627 631 649 676 724 743 758 765 770 781 787 793 814 817 867 871 872 875 877 899 909 943 948 953 955 970 979 997 998 1011 1024 1037 1070 1071 1106 1147 1148 1154 1162 1172 1187 1198 1205 1213 1217 1247 1260 1265 1266 1271 1273 1301 1307 1308 1332 1348 
5 26 30 33 48 56 97 126 133 158 162 172 173 180 191 207 233 244 248 288 294 301 302 334 368 393 407 410 429 453 454 460 500 542 577 598 600 624 648 656 693 715 723 742 778 803 809 944 969 985 996 1060 1073 1079 1124 1135 1170 1177 1194 1223 1233 1234 1290 1302 1306 1328 
57 128 137 171 230 237 317 318 426 437 445 478 486 510 564 566 616 623 692 710 739 915 987 1031 1034 1046 1107 1108 1115 1142 1168 1241 1254 1299 1310 1343 
17 98 101 215 243 252 310 311 345 435 439 459 494 558 562 572 590 654 655 658 744 756 894 967 1007 1028 1036 1085 
19 122 140 164 166 167 179 324 391 400 423 427 499 520 563 606 652 726 800 835 906 907 957 1044 1045 
20 65 70 82 88 112 124 135 155 204 256 263 321 379 570 581 589 615 732 804 1114 1189 1305 1325 
0 68 104 258 275 293 338 356 367 383 440 498 548 549 557 582 583 604 609 893 978 1039 1159 
7 108 110 138 352 389 390 397 417 458 474 530 556 704 707 708 728 748 773 784 820 945 1136 
16 39 119 132 192 223 405 411 457 488 489 568 625 635 779 780 861 1033 1035 1041 1118 1347 
3 154 225 369 382 384 385 386 561 749 750 843 883 991 1003 1056 1088 1089 1258 1281 1346 
25 91 213 214 272 299 328 536 537 610 684 685 729 1169 1215 1298 1319 
35 99 183 184 198 199 270 297 314 335 373 519 533 689 866 973 1130 
45 72 120 378 446 496 497 622 746 752 763 815 891 892 1160 1173 1193 
84 85 201 412 473 506 531 617 618 702 942 1075 1294 1321 
152 358 359 425 462 523 665 757 794 946 1181 1218 1219 1312 
38 106 144 145 210 282 569 914 1050 1052 1063 1105 1270 
83 111 153 178 259 285 307 308 375 595 601 736 827 
46 141 268 434 528 545 653 672 785 931 1096 1210 
105 116 266 398 466 490 775 896 990 1203 1286 1333 
280 433 504 525 602 603 853 859 1081 1262 1292 1317 
139 295 370 639 699 764 937 1004 1026 1116 1282 
176 188 260 348 419 512 771 974 1068 1208 1275 
254 482 483 641 642 829 830 924 928 1084 1144 
646 647 805 806 868 1134 1246 1263 1326 1335 1336 
14 336 337 396 565 611 759 913 1236 1329 
75 202 319 464 477 579 632 766 1129 1256 
107 187 203 284 332 550 733 754 860 981 
211 217 441 491 560 753 783 852 934 1051 
18 546 713 714 788 1018 1062 1098 1295 
51 221 227 895 961 1006 1087 1146 1199 
54 249 644 681 811 812 848 857 1182 
77 78 493 661 662 774 989 1101 1293 
117 291 346 792 922 1032 1244 1245 1261 
127 181 185 524 683 755 849 1229 1351 
147 298 471 808 879 880 1065 1082 1083 
2 21 451 761 901 1143 1183 1276 
24 136 452 480 657 856 1008 1186 
58 200 329 484 667 703 745 1237 
69 146 190 287 682 786 908 1220 
342 576 772 966 993 1111 1222 1248 
351 902 903 935 954 988 1076 1091 
364 399 420 513 1064 1149 1227 1240 
401 450 673 674 921 964 1043 1196 
620 621 695 716 717 831 832 1228 
28 62 71 465 532 1001 1330 
73 404 651 1055 1077 1232 1350 
76 279 630 816 863 878 940 
113 114 276 760 836 1221 1287 
160 402 409 505 527 923 1030 
236 371 663 698 1122 1141 1349 
292 443 574 575 767 1133 1345 
315 586 643 790 837 838 1283 
387 776 846 847 888 1097 1192 
479 593 612 613 881 911 1171 
529 645 664 930 952 977 999 
629 801 807 869 898 1038 1202 
796 797 824 851 1119 1120 1201 
81 218 669 995 1102 1125 
103 197 540 541 1226 1285 
131 436 461 670 841 1206 
182 333 666 822 941 1016 
216 229 253 283 1054 1103 
240 241 273 492 929 1013 
261 413 495 842 1027 1167 
267 968 1025 1090 1230 1303 
290 331 605 696 975 1000 
463 640 691 697 971 1117 
469 470 511 587 972 1049 
509 555 725 799 1020 1184 
534 791 873 976 1153 1197 
734 810 960 1019 1086 1304 
740 854 956 1078 1152 1157 
1009 1010 1185 1191 1296 1297 
1 347 430 688 1029 
11 222 607 694 1145 
27 60 100 271 747 
29 186 671 825 1314 
41 522 904 1021 1214 
118 395 447 485 951 
129 130 578 870 1239 
156 157 552 982 1277 
159 262 700 926 1138 
175 330 517 518 920 
177 424 585 686 959 
300 962 963 1047 1269 
312 313 690 789 938 
326 591 638 737 1023 
628 711 712 720 1158 
660 1092 1216 1252 1354 
768 917 918 939 1179 
769 1190 1274 1284 1316 
833 834 1150 1151 1257 
992 1048 1224 1225 1243 
47 798 980 1094 
50 927 983 1132 
61 96 1100 1209 
74 123 727 1002 
80 286 476 858 
109 487 826 876 
196 554 1042 1178 
231 232 633 679 
242 508 544 1211 
264 265 818 910 
281 428 444 634 
323 636 782 1104 
343 344 481 751 
357 372 551 965 
380 721 984 1342 
418 539 932 933 
455 456 741 1040 
543 1053 1123 1200 
571 596 597 1242 
580 919 1278 1279 
680 1164 1253 1331 
718 839 840 862 
730 950 1015 1057 
855 1128 1165 1288 
6 246 813 
8 289 1022 
10 802 889 
43 845 936 
90 1110 1311 
92 559 1099 
95 151 1255 
115 1112 1259 
121 1005 1318 
134 735 1231 
150 994 1012 
161 897 1320 
168 1058 1121 
169 226 1067 
170 363 668 
205 1327 1338 
206 448 947 
239 958 1069 
274 1155 1235 
304 821 1272 
365 659 1161 
376 377 584 
408 701 905 
415 650 1315 
416 823 925 
449 592 1061 
472 547 1163 
514 819 1139 
521 1014 1176 
567 777 912 
677 678 828 
705 882 1166 
706 1264 1344 
731 916 1212 
874 1017 1280 
886 887 1131 
