0 22 34 36 40 88 119 148 155 165 208 212 220 227 255 272 320 324 360 381 388 412 421 433 464 475 503 513 516 526 570 573 599 600 627 650 695 749 781 792 803 832 908 936 957 1058 1097 1129 1240 1244 1245 1261 1271 1273 1332 1348 
5 48 56 57 105 127 128 137 170 171 191 244 264 366 393 408 410 446 460 477 486 487 512 542 564 571 595 616 623 624 656 691 692 715 775 809 898 966 969 1107 1108 1124 1135 1177 1206 1234 1241 1272 1290 1302 1306 
10 44 46 47 100 149 275 295 358 359 409 425 428 432 462 466 471 490 514 523 527 541 543 561 584 618 665 718 784 786 787 794 916 933 952 954 976 995 1021 1053 1064 1091 1122 1123 1141 1147 1200 1333 1349 
1 13 69 75 83 111 195 250 285 304 307 308 340 347 375 396 397 414 419 473 474 556 569 578 581 582 643 652 688 710 728 795 980 1029 1044 1159 
7 11 58 67 73 74 123 329 484 545 547 585 607 663 686 694 767 865 875 900 1106 1179 1345 
154 225 299 300 328 386 537 601 729 750 903 1003 1014 1016 1055 1056 1057 1215 1258 1319 1346 
140 141 236 238 268 496 501 528 552 675 748 801 884 892 943 1041 1233 1247 1277 
72 93 202 248 318 378 420 476 530 566 766 783 855 915 987 1082 1289 1317 
125 126 290 293 294 434 442 495 640 697 789 941 971 1117 1210 1253 1300 
14 15 115 267 326 565 596 743 913 968 1025 1090 1230 1242 1259 1303 
61 62 646 701 874 876 896 990 1001 1011 1100 1196 1286 1330 1335 
452 479 509 510 555 579 727 739 740 799 1059 1078 1157 1299 1343 
198 270 297 298 335 371 533 636 698 958 973 1054 1104 1342 
41 103 104 197 472 757 904 905 982 1002 1087 1188 1324 
345 353 426 572 590 637 639 658 669 778 845 856 1142 
33 160 161 215 243 301 302 454 491 756 944 1320 
193 377 402 456 470 791 923 925 972 1030 1049 1072 
3 76 369 382 384 478 632 1089 1114 1183 1265 
107 108 164 203 284 389 531 630 733 988 1344 
183 184 336 337 611 709 759 1069 1130 1204 1329 
217 231 232 507 679 680 734 1019 1155 1164 1288 
2 106 110 175 176 233 260 348 819 1270 
91 92 343 559 654 682 906 907 1045 1246 
117 253 316 372 373 445 755 931 1005 1034 
129 130 254 483 554 606 891 1105 1238 1239 
211 262 440 441 560 622 735 753 754 981 
214 392 589 594 615 800 967 1042 1062 1103 
49 50 218 350 588 812 1040 1086 1260 
52 68 228 670 1022 1023 1048 1145 1214 
206 499 500 644 714 796 797 946 947 
237 319 333 539 823 897 932 985 991 
387 506 620 716 717 776 846 956 1169 
18 152 174 221 406 407 447 867 
26 459 497 848 859 917 918 1304 
32 405 613 713 1115 1156 1254 1278 
59 323 504 575 583 635 724 1036 
113 114 196 282 525 653 752 1139 
133 181 849 1166 1175 1229 1232 1350 
162 163 418 538 708 763 820 1186 
317 334 357 631 703 746 844 961 
482 641 642 830 924 928 1084 1144 
6 180 190 315 376 401 790 
8 839 840 853 862 935 1161 
9 21 207 249 279 901 1143 
37 216 303 355 367 544 937 
54 147 166 880 1065 1083 1093 
71 777 873 1033 1153 1292 1316 
78 609 610 661 662 989 1101 
153 201 210 365 869 1051 1063 
182 725 824 1119 1120 1163 1225 
188 224 313 437 1068 1208 1275 
436 485 689 894 895 1006 1039 
628 629 711 712 805 806 1158 
864 883 998 1154 1167 1321 1327 
23 352 817 1195 1315 1331 
24 136 242 277 517 671 
42 64 234 309 415 457 
55 453 768 1066 1274 1284 
63 681 857 872 1037 1189 
65 239 602 674 788 1295 
66 280 847 888 1149 1192 
79 235 574 580 902 1047 
109 593 612 826 911 1109 
116 608 1070 1071 1203 1266 
135 204 687 912 1020 1305 
151 772 949 950 1111 1255 
172 271 429 430 693 1088 
240 273 274 385 843 929 
266 404 651 723 996 1013 
327 349 379 732 798 1094 
341 535 536 871 1148 1301 
468 617 736 861 1137 1138 
586 587 1074 1217 1256 1293 
655 706 882 887 965 1031 
771 854 1012 1125 1152 1162 
850 851 863 1073 1113 1133 
4 45 70 158 747 
20 342 511 1198 1325 
28 455 465 592 1132 
31 634 899 953 970 
60 332 390 417 614 
89 222 1110 1140 1311 
97 98 423 439 1028 
101 314 480 621 770 
132 354 488 625 815 
139 1026 1027 1116 1185 
142 223 1067 1264 1347 
156 157 576 878 1128 
187 276 435 558 852 
229 283 529 664 930 
246 811 813 1182 1281 
258 684 1165 1279 1298 
261 413 810 842 1224 
291 292 765 922 1043 
325 591 638 741 1173 
374 519 702 926 1096 
444 451 761 870 1276 
515 524 1236 1243 1351 
659 660 683 1216 1354 
833 834 1150 1151 1257 
893 1181 1218 1219 1312 
1009 1010 1191 1296 1297 
16 836 986 1235 
17 39 469 1291 
19 179 553 562 
25 121 306 467 
30 978 1187 1205 
38 522 738 1052 
43 94 730 993 
51 356 597 1146 
85 86 744 942 
96 493 1136 1209 
112 169 226 1294 
120 816 1160 1171 
134 427 619 742 
138 881 934 1184 
145 411 568 885 
185 666 964 1199 
189 305 322 362 
194 657 827 1231 
219 269 443 1075 
230 449 450 921 
281 391 835 914 
289 403 945 1213 
296 383 508 1178 
330 331 518 920 
339 416 696 721 
361 909 1081 1262 
370 380 676 984 
399 974 1172 1227 
422 831 955 1338 
463 549 940 994 
494 521 633 690 
534 1046 1085 1202 
557 866 1007 1061 
647 1050 1134 1326 
704 779 825 1314 
707 780 814 1035 
731 774 879 1212 
758 1220 1221 1287 
793 822 1222 1248 
868 1112 1263 1336 
27 726 773 
29 927 1176 
53 192 975 
81 886 1131 
82 398 1077 
84 672 877 
90 278 604 
95 122 745 
124 502 722 
131 256 286 
144 263 563 
150 346 1118 
167 951 992 
177 178 1076 
209 782 808 
252 438 979 
257 338 548 
259 649 1038 
265 818 910 
312 673 938 
321 489 546 
368 520 1024 
394 889 1079 
395 400 461 
458 960 1282 
550 551 648 
567 785 1211 
667 802 983 
677 678 828 
700 719 720 
705 890 1060 
737 919 1017 
769 939 1190 
804 997 1310 
837 838 1283 
962 963 1269 
1008 1032 1252 
1018 1099 1280 
1098 1102 1237 
1207 1223 1328 
