0 4 8 9 10 18 21 30 31 33 44 45 46 47 48 56 57 65 70 96 97 98 100 105 123 127 128 131 135 137 140 141 152 158 160 167 170 171 172 189 190 191 206 207 211 215 221 231 233 238 239 243 244 249 254 264 265 268 271 275 279 291 295 301 302 312 358 359 391 393 394 395 398 407 408 423 425 429 432 439 446 453 454 460 461 462 466 471 486 487 490 496 499 507 512 521 523 528 534 542 543 552 554 564 567 571 608 616 618 622 623 624 626 634 643 644 649 656 659 660 665 673 674 683 687 691 692 693 714 715 718 722 728 747 756 765 775 784 785 789 790 794 796 797 801 802 809 818 839 840 841 862 867 889 892 901 910 912 916 933 935 938 943 944 946 947 948 952 953 954 966 969 970 976 978 1021 1028 1029 1043 1053 1064 1079 1091 1095 1105 1107 1108 1122 1123 1124 1135 1141 1143 1147 1163 1177 1178 1180 1187 1196 1200 1205 1209 1216 1233 1234 1241 1247 1252 1272 1277 1290 1302 1306 1310 1312 1333 1349 1354 
1 6 7 12 22 34 36 40 58 73 74 88 119 148 149 153 154 165 169 201 208 210 220 225 226 227 245 292 299 300 315 321 324 328 329 376 381 386 401 412 421 433 464 475 477 489 491 503 513 516 526 537 541 545 546 570 573 585 586 600 601 607 627 630 686 695 729 749 781 792 814 832 837 838 854 865 869 875 899 900 903 908 957 962 963 988 1003 1011 1014 1016 1047 1051 1056 1057 1058 1063 1078 1081 1106 1129 1157 1215 1240 1258 1261 1269 1271 1273 1283 1294 1307 1308 1319 1332 1335 1348 
13 20 37 63 66 69 87 112 124 161 180 195 200 204 205 216 219 252 255 269 280 303 304 308 319 320 327 340 342 344 349 352 355 361 365 367 419 435 438 502 504 508 511 544 550 577 766 798 827 847 864 872 888 898 909 937 979 981 998 1037 1075 1094 1097 1154 1167 1189 1192 1202 1217 1282 1320 1321 1325 1331 
2 3 28 29 49 50 71 76 241 261 350 369 379 382 413 424 441 455 456 465 481 506 588 592 732 735 753 769 777 791 810 812 823 842 853 873 925 927 956 972 1033 1040 1086 1088 1089 1092 1132 1153 1176 1183 1190 1197 1253 1260 1262 1265 1267 1268 1274 1284 1292 1316 1340 1341 
54 72 93 144 147 166 187 202 230 248 263 276 318 353 378 420 431 436 447 449 450 476 478 485 509 510 530 560 563 566 602 637 689 739 754 764 783 799 821 852 855 866 880 886 894 895 915 921 980 987 1006 1031 1039 1065 1082 1083 1093 1168 1289 1299 1317 1322 1323 1343 
107 108 113 114 198 199 203 214 228 240 247 257 270 273 282 297 298 322 335 338 385 389 392 399 451 505 525 531 533 548 558 589 594 603 615 638 653 667 668 707 733 737 752 761 762 800 860 874 902 929 958 959 967 973 974 983 1017 1036 1042 1103 1172 1228 1276 
5 75 81 82 83 111 132 136 155 218 256 259 284 285 288 296 305 307 347 354 362 375 380 383 396 397 458 473 474 488 556 557 569 578 581 582 584 595 598 625 652 676 688 710 721 748 786 787 795 995 1038 1044 1050 1060 1077 1131 1159 
26 55 60 67 146 162 163 181 213 250 281 287 289 310 311 332 390 403 417 418 428 444 448 452 459 483 497 527 538 568 605 655 708 731 740 763 774 820 848 858 859 870 882 885 945 965 1015 1080 1152 1161 1186 1212 1213 1249 1304 1318 
32 38 217 232 370 405 482 501 522 593 612 613 641 642 679 680 713 734 830 911 919 924 928 960 1018 1019 1041 1052 1062 1084 1099 1109 1115 1144 1155 1164 1165 1254 1278 1280 1288 1305 
24 117 121 122 242 253 277 316 345 372 426 445 517 572 590 639 658 669 671 704 745 755 768 778 779 825 835 845 856 917 918 931 936 1005 1034 1066 1142 1314 
52 125 126 156 174 196 197 290 293 294 356 400 434 442 443 495 640 697 727 751 760 893 905 941 951 971 992 1023 1048 1117 1181 1207 1210 1218 1219 1223 1328 
27 62 129 130 139 184 325 591 606 611 709 726 773 780 891 1001 1009 1010 1026 1027 1035 1069 1116 1125 1130 1162 1173 1185 1191 1204 1238 1239 1296 1297 1330 
11 84 95 330 331 368 384 387 518 520 547 555 579 620 632 672 694 716 717 741 767 846 877 920 939 1024 1114 1145 1146 1179 1184 1256 1345 
14 15 109 115 116 267 326 565 596 646 647 699 743 826 876 913 968 1004 1025 1071 1090 1134 1203 1230 1236 1242 1259 1266 1286 1303 1309 1326 1334 
91 92 106 110 145 175 176 188 224 260 266 313 343 348 414 437 559 654 682 771 896 906 907 914 990 1045 1068 1208 1246 1270 1275 1313 1339 
80 173 182 185 186 209 357 371 404 492 551 636 648 651 666 698 723 782 793 822 843 964 984 996 1013 1054 1055 1104 1199 1342 
16 78 258 274 422 479 493 498 549 587 609 610 614 661 662 684 831 836 955 986 989 1101 1136 1221 1235 1279 1298 1338 
120 133 468 500 515 524 816 849 851 863 1073 1113 1133 1160 1166 1171 1175 1193 1194 1224 1229 1232 1243 1244 1245 1350 1351 
17 39 68 193 194 377 402 469 470 621 657 670 815 881 923 934 1022 1030 1049 1156 1206 1214 1225 1231 
35 177 178 229 237 283 333 351 529 539 664 788 897 922 930 932 985 991 1076 1098 1237 1295 
19 23 61 85 86 134 179 427 553 562 619 701 742 744 942 1007 1061 1100 1195 1198 1300 
42 59 64 79 212 234 235 323 430 457 574 575 580 583 635 705 724 803 890 1072 
77 157 317 334 532 576 631 703 746 758 844 868 878 961 1112 1128 1220 1263 1287 1293 
43 89 90 94 222 278 440 604 730 993 1046 1070 1085 1110 1140 1222 1248 1311 
25 53 192 272 306 360 415 467 650 725 824 975 1119 1120 1201 1315 
51 142 143 223 597 677 678 706 750 776 828 1264 1337 1344 1346 1347 
101 246 314 363 364 480 514 681 770 811 813 819 857 1139 1182 1281 
99 617 628 629 711 712 736 805 806 861 1137 1138 1158 1336 
309 341 494 535 536 633 690 817 871 1012 1102 1148 1169 1301 
138 183 262 373 374 519 700 702 719 720 926 1074 1096 
41 103 104 472 757 904 982 1002 1087 1188 1324 
102 168 251 409 561 685 829 999 1059 1121 1211 
164 236 663 675 738 833 834 1150 1151 1257 
118 159 339 416 645 696 884 977 1000 
286 463 484 807 808 940 994 1020 1149 
336 337 411 759 879 883 887 1327 1329 
366 388 406 410 599 804 850 997 1291 
151 772 949 950 1067 1111 1255 
150 346 1008 1032 1118 
540 1170 1226 1227 1285 
