6 7 11 12 22 34 36 40 58 73 74 84 119 129 130 148 149 154 165 169 208 212 220 225 226 227 292 299 300 305 312 315 321 324 325 328 329 360 362 368 376 381 386 387 398 401 412 421 433 464 475 477 484 489 503 513 516 520 521 526 537 541 545 546 547 570 573 585 586 591 600 601 606 607 627 630 672 674 677 678 686 690 694 695 707 724 729 741 749 750 767 776 780 781 789 792 803 807 808 814 828 832 837 838 846 865 875 876 877 891 900 903 908 957 962 963 988 994 1001 1003 1014 1016 1020 1024 1035 1047 1056 1057 1058 1081 1102 1106 1125 1129 1145 1149 1162 1163 1169 1173 1215 1238 1239 1240 1244 1245 1258 1261 1262 1269 1271 1273 1283 1294 1319 1332 1345 1346 1348 
0 1 4 9 10 18 21 30 33 44 45 47 65 70 87 91 92 98 100 123 124 131 135 147 152 158 160 161 172 190 204 215 221 237 239 243 254 265 271 279 291 295 301 302 310 311 343 358 359 365 394 395 423 425 429 432 439 453 454 461 462 466 471 490 502 523 539 543 552 554 559 608 618 622 626 654 659 660 665 673 682 683 687 693 722 747 756 784 790 794 802 818 827 841 864 880 889 892 897 901 906 907 910 912 916 932 933 938 944 948 952 954 976 978 998 1011 1028 1029 1043 1045 1053 1064 1065 1083 1091 1095 1099 1105 1110 1122 1123 1141 1143 1147 1154 1167 1178 1180 1187 1200 1205 1216 1233 1246 1252 1277 1310 1312 1320 1321 1333 1349 1354 
13 19 20 25 37 43 53 63 66 69 94 112 134 139 179 180 195 200 205 216 219 249 252 255 269 272 280 303 306 308 327 340 342 344 349 352 353 355 361 367 415 419 427 438 440 467 483 504 508 511 544 553 562 577 604 619 637 643 644 650 655 681 725 728 730 742 758 765 798 824 845 847 857 872 882 888 898 909 936 937 965 979 993 1007 1009 1010 1026 1027 1037 1046 1061 1075 1085 1094 1097 1116 1119 1120 1161 1185 1189 1191 1192 1198 1201 1202 1217 1220 1221 1287 1296 1297 1307 1308 1315 1322 1323 1325 1331 
8 51 54 72 93 95 101 142 143 144 145 151 166 187 202 211 223 230 246 248 263 276 314 318 319 331 363 364 378 384 420 431 435 436 447 449 450 476 478 480 485 509 510 518 530 540 550 555 558 560 563 566 579 597 602 632 689 706 739 754 764 766 770 772 783 799 811 813 821 852 855 866 894 895 914 915 920 921 949 950 980 981 987 1006 1031 1039 1067 1082 1093 1111 1114 1146 1168 1170 1182 1184 1226 1227 1255 1256 1264 1281 1285 1289 1299 1317 1337 1343 1344 1347 
41 80 102 103 104 107 108 113 114 164 168 173 182 185 186 198 199 203 209 214 228 240 247 251 257 270 273 282 297 298 322 335 338 357 371 385 389 392 404 451 472 525 531 533 548 551 561 584 589 594 603 615 636 638 648 651 653 666 667 668 685 698 723 733 737 752 757 761 762 782 786 787 793 800 822 829 843 860 902 904 929 958 959 964 967 973 982 983 996 999 1002 1013 1036 1054 1055 1087 1103 1104 1121 1188 1199 1211 1276 1324 1342 
31 46 48 56 57 96 105 118 127 128 137 140 141 159 167 170 171 189 191 192 206 207 231 233 238 264 275 281 339 391 393 407 408 409 416 446 460 486 487 496 499 507 512 528 534 542 564 571 616 623 624 634 645 649 656 691 692 696 714 715 718 726 775 785 796 797 801 809 839 840 862 867 884 899 935 943 946 947 953 966 969 970 975 977 1000 1021 1042 1079 1107 1108 1124 1135 1177 1209 1234 1241 1247 1272 1290 1302 1306 
3 28 29 35 71 76 153 177 178 201 210 229 283 333 351 369 379 382 424 455 456 465 468 481 491 506 529 592 593 617 664 732 735 736 769 777 788 791 823 853 861 869 873 922 925 927 930 939 956 972 985 991 1033 1040 1051 1063 1076 1088 1089 1092 1098 1132 1137 1138 1153 1176 1179 1183 1190 1197 1237 1253 1265 1267 1268 1274 1284 1292 1295 1316 1340 1341 
17 32 38 39 68 193 194 217 232 236 370 377 402 405 428 444 469 470 482 501 522 567 612 613 620 621 641 642 657 663 670 675 679 680 713 716 717 734 738 815 830 833 834 870 881 911 919 923 924 928 934 960 1018 1019 1022 1030 1041 1049 1052 1062 1084 1109 1115 1144 1150 1151 1155 1156 1164 1165 1206 1214 1231 1254 1257 1278 1280 1282 1288 1305 
5 27 49 50 75 81 82 83 88 97 111 132 155 218 241 256 259 261 284 285 286 288 296 304 307 320 347 350 354 356 375 380 383 396 397 413 441 458 473 474 488 492 556 557 569 578 581 582 588 595 598 625 652 676 688 710 721 748 753 773 795 810 812 842 886 984 995 1038 1050 1060 1077 1086 1131 1159 1260 
2 14 15 106 109 110 115 116 175 176 184 188 224 260 266 267 313 323 326 330 348 414 437 463 514 565 583 596 611 646 647 699 709 743 771 819 826 896 913 940 968 990 1004 1025 1068 1069 1070 1071 1090 1130 1134 1139 1203 1204 1208 1230 1236 1242 1259 1266 1270 1275 1286 1303 1309 1313 1326 1334 1335 1339 
42 52 64 77 125 126 156 157 174 196 197 234 268 290 293 294 317 334 400 434 442 443 457 495 532 576 631 640 697 703 727 746 751 760 844 868 878 893 905 941 951 961 971 992 1023 1044 1048 1112 1117 1128 1181 1207 1210 1218 1219 1222 1223 1248 1263 1293 1328 
24 117 121 122 136 138 150 183 242 245 253 262 277 316 345 346 372 373 374 426 445 517 519 572 590 639 658 669 671 700 702 704 719 720 745 755 768 778 779 825 835 856 917 918 926 931 1005 1008 1032 1034 1066 1074 1096 1118 1142 1314 
26 55 60 67 146 162 163 181 213 250 287 289 332 390 403 417 418 448 452 459 497 527 538 568 605 708 731 740 763 774 820 848 854 858 859 885 945 1015 1059 1078 1080 1152 1157 1186 1212 1213 1249 1304 1318 
16 78 79 235 258 274 336 337 411 422 479 493 498 549 574 580 587 609 610 614 661 662 684 759 831 836 879 883 887 955 986 989 1101 1136 1235 1279 1298 1327 1329 1338 
89 90 99 120 133 222 278 500 515 524 628 629 711 712 805 806 816 849 851 863 1073 1113 1133 1140 1158 1160 1166 1171 1175 1193 1194 1224 1225 1229 1232 1243 1311 1336 1350 1351 
23 61 62 85 86 309 341 399 494 505 535 536 633 701 744 817 871 874 942 974 1012 1017 1100 1148 1172 1195 1196 1228 1300 1301 1330 
59 244 366 388 406 410 430 575 599 635 705 804 850 890 997 1072 1291 
