6 22 36 40 67 80 81 88 148 165 173 208 220 227 255 284 315 376 381 382 388 401 412 421 464 473 475 477 503 516 573 584 585 599 627 663 686 695 749 781 832 875 908 1054 1097 1106 1125 1129 1162 1247 1273 1348 
48 56 105 128 137 170 171 191 233 264 281 393 408 446 460 486 487 530 542 564 571 616 623 624 656 673 692 715 723 775 809 966 969 1060 1107 1108 1124 1135 1177 1234 1241 1272 1290 1302 1306 1317 
31 46 140 141 214 231 236 268 295 391 425 426 434 496 528 572 590 634 658 669 675 718 778 801 835 845 856 899 931 936 943 953 970 1021 1142 1233 
44 99 100 149 199 275 358 359 394 432 462 466 471 490 514 523 543 618 665 784 790 794 916 933 952 954 976 988 1053 1076 1091 1123 1141 1147 1200 1333 
34 154 169 225 226 238 239 299 300 328 364 369 386 537 600 601 602 674 729 750 788 903 957 1003 1016 1056 1057 1058 1215 1240 1258 1294 1319 1332 1346 
9 102 125 203 211 217 229 262 319 332 345 435 440 441 505 550 560 622 735 753 754 756 766 783 981 1228 
13 75 79 83 87 108 110 111 235 285 304 352 397 474 556 574 580 652 795 1331 
118 167 206 395 400 499 500 589 714 726 796 797 800 946 947 977 1042 1079 1092 
8 57 93 202 237 248 318 378 389 420 437 476 478 566 915 987 996 1082 
14 15 115 267 326 565 596 743 913 968 1004 1025 1090 1230 1242 1259 1303 
28 29 379 465 482 641 642 732 734 830 924 927 928 1019 1084 1144 1176 
32 232 501 546 593 612 613 679 713 911 1041 1109 1115 1254 
52 68 442 609 610 640 670 971 992 1022 1023 1048 1145 1214 
103 104 107 156 196 197 472 525 603 712 733 904 905 982 
198 270 297 298 335 533 535 536 871 958 973 1148 1265 1301 
106 176 188 224 260 261 313 348 512 1068 1208 1270 1275 
47 63 327 349 681 798 857 872 980 1037 1094 1189 
4 45 70 71 72 129 254 554 748 815 892 
77 78 96 493 507 661 662 989 1101 1136 1209 
113 114 458 606 752 760 960 1132 1222 1248 1282 
368 387 506 520 620 621 716 717 776 846 1169 
7 73 74 329 484 545 865 900 1249 1324 
61 62 646 647 874 876 1011 1326 1330 1335 
317 334 532 631 703 746 868 1034 1112 1263 
568 739 740 885 956 1059 1078 1157 1299 1343 
18 123 152 174 221 406 407 447 867 
49 218 350 588 812 1040 1086 1197 1260 
91 92 343 654 682 906 907 1045 1246 
266 404 651 843 896 990 1001 1013 1055 
777 791 873 1033 1088 1089 1153 1292 1316 
3 277 591 638 645 737 1173 1183 
5 33 133 289 301 302 577 820 
116 608 741 1070 1071 1203 1266 1286 
121 136 193 377 402 456 1030 1049 
135 204 325 680 687 889 912 1305 
139 164 351 758 902 1026 1047 1116 
209 247 529 664 808 930 999 1036 
310 311 483 655 882 887 965 1031 
769 917 918 939 1179 1190 1274 1284 
893 1181 1207 1218 1219 1223 1312 1328 
10 461 659 683 1122 1216 1349 
24 242 517 704 779 1232 1350 
38 522 738 833 834 1151 1257 
89 90 222 278 1110 1140 1311 
160 161 215 243 454 491 944 
162 163 417 418 538 708 763 
182 282 725 824 1119 1120 1163 
183 336 337 396 611 759 1329 
186 371 636 698 782 1104 1342 
258 684 962 963 1269 1279 1298 
259 296 341 383 649 1038 1178 
628 629 711 805 806 1158 1336 
1 65 195 347 688 1029 
11 547 607 694 767 1345 
20 342 511 1198 1278 1325 
25 53 272 306 360 467 
26 459 497 848 859 1304 
42 64 234 309 457 861 
55 372 445 1005 1066 1186 
101 314 363 480 770 813 
120 320 357 526 1160 1271 
132 205 354 488 625 1201 
147 166 880 1065 1083 1093 
151 772 949 950 1111 1255 
185 666 964 1164 1165 1199 
210 569 1050 1052 1063 1105 
330 331 518 920 1018 1184 
373 374 519 700 926 1096 
390 731 755 774 1212 1229 
449 450 719 1156 1227 1320 
481 539 598 823 897 932 
513 792 807 994 1020 1149 
555 578 579 632 727 1114 
586 587 837 838 1283 1293 
850 851 863 1073 1113 1133 
1009 1010 1185 1191 1296 1297 
0 290 293 294 697 
2 175 414 771 819 
16 17 251 405 1291 
19 179 553 559 562 
21 207 279 901 1143 
23 85 86 942 1195 
35 660 689 1220 1354 
37 303 355 367 544 
59 504 575 635 724 
66 280 847 888 1192 
98 423 439 1028 1252 
117 291 292 922 1043 
134 427 619 653 742 
146 230 287 858 1168 
184 709 1069 1130 1204 
194 469 470 657 1231 
316 839 840 862 1161 
399 974 1017 1064 1172 
451 761 762 870 1276 
468 617 736 1137 1138 
494 521 633 690 1014 
515 524 1236 1243 1351 
998 1024 1154 1167 1321 
30 978 1187 1205 
43 94 730 993 
76 816 925 972 
119 324 433 650 
131 172 256 286 
142 223 1067 1347 
145 411 452 479 
150 346 864 1150 
153 201 307 869 
157 576 878 1128 
168 685 829 1121 
187 276 558 852 
189 305 322 362 
219 356 443 751 
228 531 594 967 
240 273 274 929 
244 366 410 744 
246 811 1182 1281 
249 643 644 728 
269 508 914 1075 
361 909 1081 1262 
370 380 676 984 
384 701 1100 1196 
422 831 955 1338 
424 854 891 1012 
428 444 534 810 
429 693 765 961 
430 705 890 1072 
436 894 895 1006 
498 549 582 1159 
540 1170 1226 1285 
557 866 1007 1061 
567 785 1152 1211 
626 948 1117 1253 
630 836 921 1171 
707 780 814 1035 
879 1155 1235 1288 
39 1224 1225 
41 757 1087 
50 413 495 
51 597 1146 
54 1002 1188 
58 667 1237 
60 527 614 
69 308 419 
82 398 1077 
84 672 877 
95 122 745 
97 1008 1032 
109 826 1134 
112 615 1103 
124 502 722 
126 1175 1210 
127 898 1202 
130 1238 1239 
138 720 789 
144 263 563 
155 392 702 
180 190 747 
192 696 975 
200 288 1139 
252 438 979 
257 338 548 
321 489 1118 
333 985 991 
339 416 721 
340 375 1044 
344 849 1166 
403 945 1213 
453 768 910 
455 592 844 
463 691 940 
552 884 1277 
595 827 1206 
639 699 951 
668 841 959 
671 825 1314 
677 678 828 
706 1264 1344 
804 997 1310 
881 923 934 
941 1289 1300 
986 1221 1287 
1074 1217 1256 
1098 1102 1295 
1244 1245 1261 
