6 7 25 28 29 34 35 40 58 67 73 74 76 80 81 83 84 85 113 115 123 132 142 147 148 157 168 169 177 190 284 285 307 314 315 328 329 366 375 382 384 398 401 402 408 412 424 457 458 465 466 484 488 489 515 516 519 524 531 545 546 547 574 584 585 586 593 606 607 612 613 629 649 657 660 663 667 668 686 688 700 745 775 779 788 791 792 807 832 837 838 843 844 846 852 865 874 875 883 886 887 888 900 911 923 986 994 1007 1024 1032 1041 1058 1081 1085 1088 1089 1094 1100 1102 1109 1110 1111 1117 1118 1124 1131 1139 1149 1157 1193 1197 1202 1220 1252 1260 1273 1283 1294 1315 1324 1332 1333 1351 1354 
0 1 12 13 22 23 32 36 37 42 43 48 53 55 59 63 64 65 66 75 79 86 87 88 93 94 108 111 112 155 174 189 195 200 208 212 218 219 220 234 235 242 245 250 255 256 257 259 269 272 277 278 296 303 304 305 306 308 309 321 322 327 339 340 341 349 353 355 360 361 374 379 381 388 403 415 416 421 433 443 467 468 473 475 502 503 504 508 526 573 588 594 599 603 608 625 626 627 656 681 724 728 736 751 770 786 798 803 812 867 873 890 899 926 936 942 952 953 980 1061 1070 1106 1136 1137 1138 1147 1159 1160 1167 1168 1187 1206 1213 1234 1247 1248 1270 1306 1325 
10 16 31 56 57 69 70 71 72 120 126 135 156 158 159 160 172 173 196 231 232 236 237 238 239 248 251 268 280 288 294 295 352 359 378 409 425 428 429 430 434 442 446 455 456 461 463 495 496 497 501 507 527 528 534 539 552 595 605 636 638 640 648 653 670 672 683 697 699 718 727 737 742 746 747 748 752 763 764 773 785 801 815 840 841 851 855 863 892 905 922 927 933 934 937 941 943 951 967 969 971 976 979 982 991 992 996 1008 1020 1021 1048 1064 1073 1096 1103 1173 1175 1177 1194 1195 1209 1210 1214 1216 1217 1223 1233 1243 1253 1289 1300 
8 9 20 101 102 124 146 187 188 202 203 211 216 217 221 229 230 246 247 252 262 263 276 319 320 332 333 334 345 354 357 365 399 431 435 440 441 476 491 492 505 550 551 558 560 561 592 622 632 635 698 733 735 753 754 756 766 783 823 860 862 870 935 975 981 987 995 1029 1036 1038 1067 1087 1121 1129 1281 
4 27 46 68 82 91 92 121 122 134 141 166 179 194 253 289 323 324 400 426 427 451 452 470 494 520 572 590 637 639 652 655 658 669 704 744 778 795 818 835 845 856 891 931 957 1044 1045 1211 1231 1238 1239 
2 3 21 105 106 109 110 176 223 224 233 260 261 347 348 393 419 420 437 512 571 597 634 715 771 809 819 901 915 974 1068 1083 1112 1142 1143 1183 1208 1275 1290 1302 1347 
38 39 49 50 60 181 185 186 370 373 404 405 444 479 532 587 659 810 919 920 960 1017 1018 1019 1062 1074 1092 1099 1161 1176 1181 1207 1224 1225 1278 1280 1304 1314 
5 26 30 33 45 97 98 130 133 152 161 180 243 244 254 271 279 301 302 453 454 464 485 498 577 598 619 687 693 802 820 910 932 944 985 1071 1312 
44 117 131 182 291 316 317 346 372 445 481 618 666 671 755 782 790 822 849 916 948 964 965 988 1005 1034 1053 1054 1066 1091 1123 1150 1199 1200 1271 
11 118 119 140 167 207 391 392 395 447 448 499 500 570 589 615 621 714 726 797 800 804 889 946 947 1039 1042 1079 1140 
127 128 136 137 170 171 191 192 264 265 460 477 478 486 487 542 564 616 623 624 691 692 710 721 1107 1108 1135 1241 
164 165 292 414 575 576 580 630 631 767 814 816 825 836 878 1012 1113 1133 1192 1221 1244 1245 1261 1345 
77 144 145 175 201 209 210 281 282 343 344 569 591 898 914 1046 1050 1051 1052 1063 1075 1105 1293 
225 273 300 368 369 387 506 510 600 702 749 750 765 799 817 903 1148 1264 1265 1346 
258 293 338 350 356 367 548 549 557 582 583 604 609 696 869 881 940 978 1178 1269 
54 95 96 129 149 204 205 490 563 578 579 866 997 1002 1114 1146 1188 1256 
312 313 469 521 522 554 633 690 761 762 789 793 1014 1016 1055 1128 1163 1285 
555 567 568 645 739 740 741 854 884 885 956 977 1013 1059 1078 1152 1277 
61 62 266 651 876 877 896 990 1001 1011 1203 1259 1286 1318 1330 
206 249 514 643 644 732 811 848 857 1122 1145 1182 1189 1198 1349 
215 310 311 325 342 362 438 439 459 562 654 882 894 1028 
286 287 318 383 540 602 682 689 711 858 893 908 1249 1310 
536 537 601 827 871 872 998 1037 1057 1154 1169 1301 1319 1321 
47 99 100 275 326 358 394 462 471 523 665 757 794 
364 411 614 731 808 864 879 880 962 1065 1082 1235 1287 
646 805 806 826 868 906 907 1134 1158 1246 1263 1335 1336 
15 267 565 611 968 1025 1090 1153 1230 1236 1242 1303 
24 684 685 729 781 929 1172 1215 1279 1298 1307 1308 
103 104 197 472 541 676 703 706 904 1031 1060 1170 
116 480 620 716 730 831 949 950 963 1015 1047 1228 
283 529 530 664 694 695 839 859 930 999 1035 1317 
213 214 336 397 474 556 581 610 1040 1328 1329 
432 673 674 701 705 722 723 921 938 1043 1196 
482 483 641 642 734 829 830 924 928 1084 1144 
107 290 413 423 525 628 712 717 1212 1348 
183 184 337 396 709 743 759 1069 1130 1204 
198 199 270 297 298 335 533 958 959 973 
768 769 917 918 939 1179 1190 1274 1284 1316 
14 513 596 647 913 1004 1266 1276 1326 
78 493 661 662 847 970 989 1097 1101 
193 376 511 821 925 972 1030 1049 1072 
41 675 774 961 1166 1229 1232 1350 
650 725 796 824 912 1119 1120 1201 
679 680 1155 1164 1165 1288 1305 1331 
18 19 299 553 559 566 787 
51 52 227 228 1006 1022 1023 
153 154 226 386 1003 1056 1258 
162 390 418 719 720 945 1093 
163 389 417 538 707 708 1186 
351 422 535 758 902 993 1240 
371 436 895 983 984 1104 1342 
450 1000 1086 1116 1156 1255 
509 677 678 776 777 828 
738 772 833 834 1151 1257 
330 331 517 518 1184 
406 407 617 1205 1272 
713 1098 1295 1299 1344 
1009 1010 1191 1296 1297 
17 410 850 1291 
89 90 222 1311 
125 150 151 377 
138 139 1171 1185 
240 241 274 385 
449 1226 1227 1320 
760 1132 1222 1282 
784 1076 1077 1237 
853 1033 1262 1292 
114 813 909 
178 954 1080 
363 380 966 
780 1125 1162 
842 1026 1027 
861 897 1141 
955 1327 1338 
1115 1254 1343 
1126 1127 1174 
