13 15 22 23 34 40 42 43 53 63 66 79 83 86 87 89 93 94 148 161 195 208 219 224 235 245 250 255 257 258 269 277 278 285 296 303 306 308 309 320 339 340 349 350 353 354 360 361 374 375 388 392 403 406 414 421 422 467 468 475 501 502 503 515 516 526 535 588 594 599 619 649 736 758 765 781 793 845 871 872 875 909 936 955 979 997 998 1037 1040 1102 1106 1125 1148 1154 1162 1172 1178 1187 1193 1260 1265 1266 1273 1301 1307 1308 1320 1332 1348 
5 7 10 11 26 30 33 38 108 110 119 126 133 158 172 173 180 222 234 244 248 259 288 294 301 302 334 352 368 390 397 429 447 454 457 474 556 577 580 598 687 693 694 728 773 784 802 820 861 944 951 985 992 1020 1052 1073 1136 1175 1194 
48 56 162 191 348 393 394 407 460 542 595 600 624 648 656 715 723 742 803 809 827 890 946 969 996 1060 1079 1124 1135 1170 1177 1208 1223 1233 1234 1290 1302 1306 1328 
12 32 36 37 44 59 111 149 174 178 189 212 220 238 305 322 327 341 355 362 381 438 514 573 579 608 626 627 743 770 787 877 970 1024 1071 1147 1256 
19 101 118 122 140 164 166 167 179 324 345 391 400 423 427 439 470 499 520 572 652 658 726 800 835 856 906 907 931 957 1044 1045 
57 115 128 137 145 171 237 317 318 357 389 426 437 445 478 486 530 564 566 616 623 632 692 710 817 915 987 1034 1107 1142 1241 1310 
20 65 70 82 88 112 124 135 155 204 256 263 321 379 395 570 581 589 615 732 804 825 889 980 1094 1114 1146 1198 1305 1325 
0 68 104 146 275 293 338 356 358 367 383 440 498 548 549 557 582 583 604 609 640 893 971 978 1039 1145 1159 1168 
3 76 215 252 310 311 382 384 385 435 558 561 562 654 655 749 756 843 894 991 1036 1088 1089 1281 
14 107 187 203 336 337 396 525 565 603 611 709 733 759 913 1204 1236 1329 
25 91 213 214 272 299 328 536 537 610 684 685 729 1169 1215 1298 1319 
144 210 281 282 326 569 591 636 638 737 914 1023 1046 1050 1063 1104 
84 85 201 300 412 473 506 531 617 618 702 942 956 1294 1321 
45 120 378 446 496 622 746 752 763 815 1062 1160 1173 1210 
47 92 147 298 471 559 676 798 808 879 880 1065 1082 1083 
46 131 425 436 461 527 528 718 839 840 841 1096 1206 
61 62 646 874 876 896 990 1001 1011 1100 1259 1286 1330 
280 387 433 620 717 776 846 847 859 888 1097 1192 1317 
401 408 431 432 450 673 674 701 722 921 964 1043 1196 
9 165 279 442 630 631 814 816 863 878 940 1112 
106 175 176 233 330 512 517 518 819 920 1018 1270 
16 132 488 489 568 625 779 780 1035 1041 1118 
27 60 100 271 332 333 550 747 754 778 981 
139 295 370 639 699 764 937 1004 1026 1028 1116 
152 523 665 757 794 867 1181 1218 1219 1312 
160 323 402 409 456 505 923 925 1030 1049 
51 221 227 228 961 1006 1048 1087 1199 
54 207 249 644 811 812 848 857 1182 
73 266 351 404 574 651 1055 1076 1077 
80 230 286 476 807 858 967 1054 1085 
125 211 216 229 253 283 441 753 1103 
151 593 612 791 911 1109 1113 1197 1255 
181 185 524 683 755 849 1229 1243 1351 
183 184 373 659 660 1092 1130 1216 1354 
188 260 419 552 884 885 974 1068 1277 
241 261 413 495 724 842 1027 1070 1167 
313 469 511 521 690 789 941 1289 1300 
417 418 539 704 707 897 932 933 945 
482 641 642 734 830 924 928 1084 1144 
483 705 706 882 886 887 1031 1131 1166 
647 805 806 868 1134 1246 1263 1326 1336 
18 546 713 714 788 905 1098 1295 
58 200 329 667 983 1139 1237 1342 
69 190 287 584 682 786 908 1220 
127 443 629 869 898 1038 1075 1202 
141 268 434 545 653 672 785 801 
150 555 799 833 834 1150 1151 1257 
739 740 1078 1115 1157 1254 1299 1343 
2 21 451 901 1143 1183 1276 
105 116 398 466 775 1203 1333 
217 810 917 918 1019 1086 1304 
236 371 663 698 1122 1141 1349 
240 273 274 929 1155 1235 1288 
364 420 484 513 1149 1240 1335 
529 645 664 930 952 977 999 
860 862 873 881 976 1033 1153 
29 186 428 444 534 671 
31 64 634 899 953 1271 
75 81 284 464 477 1129 
77 78 661 662 989 1101 
103 197 540 541 1226 1285 
129 130 254 829 1105 1239 
142 738 750 1264 1344 1346 
154 225 386 1003 1056 1258 
177 424 519 585 686 959 
198 270 297 335 533 973 
267 968 1025 1090 1230 1303 
290 331 696 975 1000 1005 
415 650 824 1119 1120 1315 
459 494 590 744 866 1007 
621 695 716 831 832 1228 
769 939 1190 1274 1284 1316 
902 903 954 988 1047 1091 
1009 1010 1185 1191 1296 1297 
1 347 430 688 1029 
39 223 1072 1108 1347 
41 522 904 1021 1214 
96 218 669 995 1209 
113 114 458 760 1222 
292 575 767 1133 1345 
342 576 772 1111 1248 
491 560 783 852 934 
567 677 678 777 912 
571 596 597 1242 1275 
681 711 712 1158 1189 
943 948 1205 1213 1247 
24 657 1232 1350 
35 314 689 895 
74 123 727 1002 
97 410 485 1032 
102 319 766 1059 
136 193 972 1074 
159 262 926 1138 
192 411 700 782 
196 554 927 1042 
205 1201 1327 1338 
206 448 500 947 
231 232 633 679 
239 602 958 1069 
242 508 544 1211 
264 265 818 910 
276 836 1221 1287 
291 346 792 922 
343 344 481 751 
372 551 666 965 
452 480 605 1186 
463 691 697 1117 
543 1053 1123 1200 
586 587 1217 1293 
680 1164 1253 1331 
730 950 1015 1057 
771 854 994 1012 
796 797 850 851 
919 1017 1099 1280 
6 246 813 
8 289 1022 
17 243 1291 
28 465 532 
49 761 762 
50 71 1314 
55 325 1066 
72 497 748 
90 1110 1311 
95 703 745 
98 986 1080 
109 487 826 
134 735 1231 
138 670 1184 
153 307 601 
156 157 982 
168 202 1058 
169 226 1067 
182 1163 1225 
209 247 900 
304 821 1272 
315 643 790 
359 966 993 
365 1051 1161 
366 504 635 
376 377 607 
399 1064 1227 
405 822 1016 
416 721 823 
449 592 1061 
472 547 1179 
479 493 774 
490 578 870 
492 1013 1152 
509 510 828 
637 1121 1140 
731 916 1212 
837 838 1283 
855 1128 1165 
891 892 1224 
960 1132 1282 
962 963 1269 
1081 1262 1292 
1244 1245 1261 
