1 6 12 22 34 36 40 67 88 119 148 165 169 208 220 227 324 376 381 401 412 421 464 475 477 491 503 513 516 526 570 573 585 600 627 630 686 695 749 781 792 814 832 874 875 908 957 988 1011 1058 1078 1081 1106 1129 1162 1187 1240 1261 1271 1273 1294 1332 1335 1348 
4 10 44 47 100 131 149 265 275 291 292 295 359 394 395 425 432 461 462 466 471 490 523 541 543 608 618 626 665 673 674 683 722 784 790 794 802 818 841 889 916 933 938 948 952 954 976 1021 1043 1053 1064 1079 1091 1123 1141 1147 1200 1233 1333 
48 56 57 105 127 128 137 170 171 189 191 233 264 393 398 446 460 486 487 512 530 542 564 571 584 616 623 624 656 691 692 715 775 809 867 966 969 1107 1108 1124 1135 1177 1234 1241 1272 1290 1302 1306 1317 
8 54 72 93 144 202 211 229 248 263 318 319 322 378 420 435 440 441 476 492 558 560 563 566 602 689 753 754 766 783 821 855 866 915 980 987 1031 1082 1289 
5 75 83 111 132 136 256 285 304 305 307 347 354 362 375 396 397 458 473 474 556 569 578 581 582 595 625 652 676 688 710 795 1044 1050 1060 1159 
102 103 104 107 108 113 114 164 168 203 251 282 389 404 525 603 615 648 651 653 667 723 733 737 752 762 843 982 983 996 1013 1017 1103 
154 225 226 299 300 328 386 387 537 601 729 903 1003 1014 1016 1055 1056 1057 1169 1215 1258 1319 
13 20 69 112 195 200 249 250 303 308 340 342 419 504 511 643 644 728 1198 1248 1325 
14 15 109 115 267 326 565 596 743 826 913 968 1004 1025 1090 1134 1230 1236 1242 1259 1303 
52 125 126 174 268 290 293 294 400 434 442 495 640 697 941 971 1023 1048 1117 1210 
106 110 145 175 176 188 224 260 313 330 348 437 771 914 1068 1208 1270 1275 
217 231 232 482 507 641 642 679 680 734 830 924 928 1019 1084 1144 1155 1164 
32 38 370 405 522 613 713 919 1018 1052 1062 1099 1109 1115 1254 1278 1280 
129 130 591 606 611 638 780 891 1001 1012 1035 1102 1125 1173 1238 1239 
160 161 180 184 190 215 239 243 709 756 944 1069 1130 1204 1320 
141 238 496 497 501 534 552 748 785 801 892 960 1041 1277 
198 270 297 298 335 533 535 536 871 958 973 1148 1301 
214 228 392 451 531 589 594 800 967 1042 1276 
3 76 369 382 883 1088 1089 1183 1265 1327 
23 61 62 339 416 696 1100 1195 1300 1330 
91 92 343 559 654 682 906 907 1045 1246 
99 199 628 629 711 712 805 806 1158 1336 
117 183 253 372 373 445 755 931 1005 1034 
156 196 197 472 699 727 904 905 951 992 
317 334 631 703 746 844 868 961 1112 1263 
509 510 739 740 799 854 1059 1157 1299 1343 
7 58 73 74 329 545 865 900 1249 
11 547 607 694 741 767 1145 1179 1345 
18 123 146 152 158 221 358 406 407 
33 97 172 271 301 302 429 454 693 
101 314 480 621 770 772 813 1111 1281 
193 377 402 791 925 972 1030 1049 1156 
528 718 839 840 853 862 935 943 1247 
49 50 350 588 812 1086 1197 1260 
68 140 167 670 815 1022 1206 1214 
71 96 777 873 1033 1153 1209 1316 
81 205 284 488 886 995 1131 1201 
116 266 896 990 1071 1203 1266 1286 
258 498 549 684 963 1269 1279 1298 
357 371 551 636 698 984 1104 1342 
479 493 661 662 918 989 1101 1136 
2 9 21 207 279 901 1143 
42 64 218 219 234 309 457 
59 212 360 575 635 724 803 
66 280 433 847 888 1097 1192 
89 90 222 278 1110 1140 1311 
94 272 356 415 650 1070 1315 
124 155 320 365 502 550 981 
133 849 1166 1175 1229 1232 1350 
135 204 325 687 817 912 1305 
157 576 593 612 878 911 1128 
162 163 418 538 708 763 820 
178 788 1076 1098 1161 1237 1295 
186 240 273 274 385 860 929 
206 499 714 796 797 946 947 
262 374 519 702 926 1074 1096 
312 494 521 633 690 789 1163 
422 587 831 955 1217 1293 1338 
555 833 834 1150 1151 1184 1257 
620 677 678 716 717 776 846 
827 864 962 998 1154 1167 1321 
24 242 245 277 517 671 
31 46 634 899 953 970 
60 332 390 417 527 614 
87 327 349 352 798 1094 
120 816 1160 1171 1244 1245 
147 166 880 1065 1083 1093 
182 725 824 1119 1120 1225 
185 666 964 1165 1199 1288 
255 468 500 515 524 1351 
259 296 341 383 649 1038 
289 403 704 779 945 1213 
310 311 483 655 882 965 
336 337 411 759 887 1329 
384 478 579 632 1114 1256 
399 505 974 1172 1227 1228 
706 750 828 1264 1344 1346 
850 851 863 1073 1113 1133 
1009 1010 1185 1191 1296 1297 
17 39 469 470 1291 
26 459 848 859 1304 
79 235 443 574 580 
98 423 439 1028 1252 
118 645 884 885 977 
241 261 413 810 842 
244 366 388 410 599 
246 681 811 857 1182 
283 529 664 922 930 
315 586 837 838 1283 
453 768 910 917 1066 
617 736 861 1137 1138 
769 939 1190 1274 1284 
19 179 553 562 
25 121 306 467 
29 927 1092 1176 
30 978 1205 1310 
37 355 367 544 
41 757 1002 1087 
43 730 993 1222 
45 70 622 747 
63 872 1037 1189 
82 288 835 1077 
84 672 876 877 
85 86 744 942 
134 427 619 742 
138 700 719 720 
139 1026 1027 1116 
142 223 1067 1347 
151 949 950 1255 
153 201 869 1051 
177 333 985 991 
237 539 897 932 
254 554 1178 1312 
353 637 845 936 
379 424 506 956 
430 705 890 1072 
436 894 895 1006 
455 592 823 1132 
463 484 994 1149 
540 1170 1226 1285 
557 765 1007 1061 
590 669 778 856 
659 660 1216 1354 
731 774 879 1212 
893 1181 1218 1219 
0 1122 1349 
16 78 1235 
27 726 773 
28 465 735 
51 597 1146 
53 192 975 
55 181 1186 
65 732 1029 
80 173 1054 
95 122 745 
187 276 852 
194 657 1231 
210 1063 1105 
216 937 1282 
230 921 1168 
247 999 1036 
252 438 979 
257 338 548 
269 508 1075 
286 807 1020 
287 808 858 
316 572 639 
321 489 546 
331 518 920 
344 577 898 
346 825 1314 
361 604 909 
368 520 1024 
408 701 1196 
409 561 707 
428 444 870 
447 485 1039 
452 568 1152 
514 819 1139 
646 647 1326 
685 829 1121 
758 1220 1287 
761 793 822 
836 986 1221 
881 923 934 
1046 1085 1202 
1207 1223 1328 
