0 10 27 31 33 44 46 47 48 56 57 65 100 105 127 128 137 140 141 160 161 170 171 188 189 191 206 215 224 238 239 243 264 268 275 281 295 301 302 313 358 359 391 393 408 409 425 428 432 437 446 454 460 462 466 471 477 486 487 490 491 496 499 500 501 514 523 527 528 534 539 542 543 552 561 564 567 571 608 616 618 623 624 626 634 649 656 665 691 692 714 715 718 726 748 756 773 775 784 785 794 796 797 801 809 835 862 884 892 898 899 914 916 933 943 944 946 947 952 953 954 966 969 970 976 1021 1029 1041 1046 1053 1064 1068 1085 1091 1107 1108 1122 1123 1124 1135 1141 1147 1177 1200 1202 1208 1211 1234 1241 1272 1275 1277 1290 1302 1306 1313 1320 1333 1339 1349 
1 6 7 12 22 24 34 36 40 43 58 73 74 81 94 112 119 148 149 154 165 169 208 212 220 225 226 227 242 272 277 299 300 305 314 315 321 324 328 329 360 362 374 376 381 386 387 388 401 412 421 433 464 475 484 489 503 513 516 517 519 526 537 541 545 546 570 573 585 599 600 601 607 627 630 650 663 671 686 695 702 729 730 749 750 781 790 792 803 824 828 832 865 875 900 903 908 926 936 957 988 993 1003 1014 1056 1057 1058 1078 1095 1096 1106 1119 1120 1129 1157 1169 1180 1215 1240 1244 1245 1247 1258 1261 1264 1271 1273 1294 1319 1332 1346 1348 
41 80 102 103 104 107 108 113 114 167 168 173 182 185 196 197 198 202 214 251 257 258 266 270 282 284 297 298 322 335 338 341 389 392 404 444 451 472 494 525 531 533 535 536 548 550 551 589 594 602 603 615 633 636 648 651 666 667 668 684 712 723 725 733 737 752 757 762 800 802 841 843 870 871 902 904 905 919 951 958 959 962 963 964 967 973 982 983 992 996 1002 1013 1017 1042 1047 1054 1062 1087 1103 1139 1148 1163 1165 1188 1199 1269 1276 1279 1298 1301 1324 1342 1344 
4 18 30 45 54 70 123 135 146 147 152 158 166 172 174 204 221 230 250 271 287 291 292 394 395 400 406 407 429 447 448 449 450 461 557 687 693 747 765 858 867 880 889 910 912 921 978 998 1007 1015 1020 1043 1061 1065 1079 1083 1093 1154 1167 1168 1187 1205 1249 1305 1307 1308 1321 
75 82 83 88 120 131 132 155 181 186 200 240 256 273 285 286 288 304 307 320 347 354 375 385 396 397 398 473 474 488 556 569 578 581 582 625 652 688 710 711 795 860 929 980 1044 1060 1077 1097 1131 1159 1160 1171 1233 
11 145 184 310 311 336 337 411 452 479 483 509 510 547 555 568 579 611 655 694 700 706 709 719 720 727 739 740 741 759 767 799 882 885 887 965 1031 1059 1069 1130 1152 1179 1204 1299 1329 1343 1345 
5 72 93 124 144 187 213 248 263 276 312 318 378 420 431 476 502 530 540 560 563 566 595 605 673 722 764 821 852 855 866 886 915 938 987 1082 1170 1193 1194 1196 1206 1226 1285 1289 1317 
32 38 52 125 126 228 290 293 294 405 434 442 495 521 522 613 640 690 697 713 738 760 789 816 941 948 971 1016 1023 1048 1052 1115 1117 1210 1253 1254 1267 1268 1278 1300 
19 95 117 122 179 183 253 316 345 372 373 426 445 453 553 562 572 590 639 658 669 745 755 768 769 778 845 856 931 939 1005 1034 1066 1142 1190 1274 1284 
25 68 121 136 138 193 306 330 331 377 402 415 456 467 470 518 670 791 815 881 920 923 925 934 972 1018 1022 1030 1049 1072 1099 1145 1156 1184 1214 1280 
14 15 115 116 267 326 565 596 647 743 805 806 826 913 968 1004 1025 1050 1070 1071 1090 1134 1158 1203 1230 1242 1259 1266 1303 1309 1326 1334 1336 
9 20 21 69 134 180 190 195 207 249 279 308 340 342 419 427 511 584 619 643 644 653 728 732 742 786 787 857 901 1143 1198 1325 
23 61 62 84 85 86 368 520 620 646 672 677 678 701 716 717 776 846 874 876 877 896 942 990 1001 1011 1024 1100 1195 1286 1330 1335 
8 203 211 262 319 399 435 440 441 492 505 622 707 753 754 766 780 783 814 839 840 853 935 974 981 1035 1161 1172 1227 1228 
26 55 60 67 98 162 163 289 332 390 403 417 418 459 497 538 614 708 763 820 848 859 917 918 945 1080 1186 1213 1304 1318 
35 177 178 229 237 283 333 351 455 481 529 592 598 664 674 788 823 897 922 930 932 985 991 1076 1098 1132 1237 1295 
28 29 159 217 231 232 465 482 507 641 642 679 680 734 735 830 924 927 928 1000 1019 1084 1144 1155 1164 1176 1288 
49 50 71 218 241 261 350 413 588 777 810 812 842 873 1033 1040 1086 1088 1092 1153 1197 1224 1260 1292 1316 1340 1341 
66 101 151 246 280 363 364 480 621 770 772 811 813 847 888 949 950 1111 1149 1182 1192 1255 1281 
87 129 130 254 325 554 591 606 638 645 771 854 891 1012 1102 1105 1125 1162 1173 1238 1239 
16 59 78 244 274 366 410 504 575 609 610 635 724 744 804 836 986 997 1235 1310 
156 157 164 236 576 593 612 675 758 761 793 822 878 911 1128 1220 1221 1222 1248 1287 
2 106 109 110 175 176 233 260 323 348 414 463 512 549 583 819 940 994 1270 
3 76 153 201 210 357 365 369 382 384 478 632 869 1051 1063 1089 1114 1183 1265 
51 219 259 269 356 443 597 751 893 1038 1075 1146 1181 1207 1218 1219 1223 1312 1328 
37 133 216 303 355 367 371 544 698 849 937 984 1104 1166 1175 1229 1232 1350 
77 317 334 532 631 703 746 844 850 851 863 868 961 1073 1112 1113 1133 1263 
79 96 235 430 493 498 574 580 661 662 705 807 890 989 1101 1136 1209 
111 139 370 380 676 995 1009 1010 1026 1027 1109 1116 1185 1191 1296 1297 
327 349 352 353 379 424 506 637 798 817 956 1094 1315 1322 1323 1331 
150 346 704 779 825 833 834 864 883 1118 1150 1151 1257 1314 1327 
91 92 343 559 654 682 731 774 879 906 907 1045 1212 1246 
89 90 222 255 278 515 524 1110 1140 1236 1243 1311 1351 
422 586 587 831 837 838 955 1074 1217 1256 1283 1293 1338 
13 63 252 344 438 577 681 872 979 1037 1189 
42 64 234 245 309 361 457 604 909 1081 1262 
142 143 223 659 660 683 1067 1216 1337 1347 1354 
17 39 194 469 657 827 1055 1225 1231 1291 
99 199 468 617 628 629 736 861 1137 1138 
209 247 558 685 782 808 829 999 1036 1121 
118 339 416 458 696 721 960 977 1282 
205 436 485 689 894 895 1006 1039 1201 
97 423 439 699 1008 1028 1032 1252 
53 192 296 383 508 975 1178 
