5 7 10 11 26 33 38 48 56 57 106 108 110 115 126 128 131 133 137 138 145 152 158 162 170 171 172 173 176 180 188 191 206 207 219 222 237 248 259 260 264 288 294 301 302 317 318 348 352 363 368 389 390 393 395 397 407 416 417 418 419 426 429 437 443 445 447 448 460 461 462 474 478 485 486 497 500 510 512 523 530 532 539 542 556 564 566 577 579 580 595 598 600 616 623 624 647 648 656 665 668 670 673 680 687 692 693 694 707 710 715 721 723 728 739 742 748 757 773 784 794 796 797 802 803 805 806 809 820 824 827 841 851 868 889 890 915 932 933 945 946 947 951 969 974 987 992 996 1020 1034 1060 1068 1073 1079 1107 1108 1112 1115 1119 1120 1124 1134 1135 1136 1142 1164 1170 1175 1177 1181 1184 1186 1194 1206 1208 1218 1219 1223 1233 1234 1241 1243 1246 1254 1259 1263 1270 1275 1278 1279 1290 1299 1302 1306 1310 1312 1313 1315 1326 1328 1331 1335 1336 1339 1343 
1 12 13 15 22 23 31 32 34 36 37 40 42 43 44 53 55 59 63 64 66 79 82 83 86 87 89 93 94 111 148 149 153 174 178 189 195 208 212 218 220 224 234 235 238 245 250 255 257 258 269 277 278 285 296 303 304 305 306 307 308 309 320 322 325 327 339 340 341 347 349 350 353 354 355 360 361 362 374 375 381 388 392 394 403 406 414 421 422 430 438 467 468 475 501 502 503 515 516 526 535 573 588 594 599 608 619 626 627 631 649 669 688 701 736 743 758 765 770 781 787 793 817 821 845 867 871 872 875 877 899 909 936 943 948 953 955 970 995 997 998 1024 1029 1037 1066 1106 1125 1147 1148 1154 1162 1172 1193 1198 1205 1213 1247 1260 1265 1266 1271 1272 1273 1301 1307 1308 1309 1332 1334 1348 
9 14 75 76 81 107 113 114 125 142 143 144 159 165 168 187 196 202 203 211 217 262 265 267 276 279 284 319 332 334 336 337 342 345 357 366 396 435 441 442 458 464 477 550 554 563 565 569 576 606 611 630 632 709 733 734 738 753 754 759 760 766 768 769 772 814 816 818 833 834 836 863 878 910 913 917 918 926 927 939 940 960 966 968 981 993 1019 1025 1042 1050 1058 1090 1111 1129 1132 1138 1150 1151 1179 1190 1197 1204 1222 1230 1236 1248 1257 1264 1274 1282 1284 1303 1304 1329 1337 1344 
4 20 47 52 54 65 70 88 92 97 112 124 135 147 155 161 169 194 204 226 244 249 256 263 298 321 379 410 453 454 471 514 559 570 581 589 601 615 636 644 681 711 712 732 798 804 808 811 812 848 850 857 879 880 897 944 949 980 1028 1049 1065 1067 1082 1083 1093 1094 1099 1104 1114 1146 1158 1159 1160 1168 1182 1189 1195 1291 1305 1320 1325 
24 50 73 77 78 136 193 266 292 351 404 452 480 493 529 574 575 614 620 621 645 651 657 661 662 664 695 704 716 717 730 767 774 831 832 856 902 903 930 935 950 952 954 977 986 988 989 999 1015 1055 1057 1074 1076 1077 1080 1091 1101 1110 1133 1207 1228 1232 1293 1311 1345 1350 
3 41 98 134 154 215 225 242 252 299 310 311 369 382 384 385 386 459 494 508 522 544 552 558 561 562 572 590 650 654 655 658 735 744 749 750 756 843 894 904 931 991 1003 1007 1021 1036 1056 1085 1088 1089 1211 1214 1231 1258 1281 1346 
25 91 101 127 213 214 239 272 280 328 387 415 433 439 504 525 536 537 602 603 610 629 684 685 729 776 801 807 846 847 853 859 869 884 885 888 898 958 1038 1069 1097 1169 1192 1202 1215 1277 1292 1298 1317 1319 
28 45 61 62 71 72 96 120 231 232 261 286 378 413 446 465 495 496 605 622 633 646 679 724 746 752 763 815 842 876 891 892 896 979 990 1001 1011 1026 1027 1070 1100 1113 1167 1173 1209 1210 1217 1224 1286 1330 
0 68 69 104 146 190 287 293 338 356 367 376 377 383 440 463 498 548 549 557 582 583 604 607 609 640 682 691 697 786 893 908 971 972 978 1039 1117 1145 1178 1220 1221 1253 1267 1268 1287 
29 90 139 175 186 233 281 282 295 326 330 370 380 444 517 518 534 591 638 639 671 676 699 737 764 810 825 914 920 937 984 1004 1009 1010 1018 1023 1046 1086 1116 1185 1191 1296 1297 1314 
19 67 118 122 140 141 164 166 167 179 236 251 268 323 324 371 391 400 423 427 434 470 499 520 545 652 653 672 698 726 782 800 835 906 907 957 1044 1045 1122 1141 1342 1349 
74 123 129 130 150 254 479 482 483 507 509 555 578 613 641 642 708 725 727 799 829 830 870 924 928 994 1002 1084 1105 1144 1171 1238 1239 
27 60 100 163 182 271 312 313 316 333 405 469 472 511 521 547 586 587 666 690 747 778 789 822 938 941 985 1016 1163 1256 1289 1300 
121 181 185 290 331 524 543 637 683 696 731 755 849 916 975 1000 1005 1014 1053 1121 1123 1140 1176 1200 1212 1229 1318 1322 1323 1351 
16 39 119 132 192 223 411 457 488 489 568 625 635 700 779 780 861 1035 1041 1072 1102 1118 1225 1347 
102 240 241 273 274 492 567 677 678 740 777 785 828 912 929 956 1013 1059 1078 1152 1155 1157 1235 1288 
84 85 201 210 300 412 473 506 531 617 618 702 942 962 963 1047 1052 1063 1075 1269 1294 1321 
95 109 151 359 487 593 612 791 826 860 862 873 881 911 976 1033 1109 1153 1255 1316 1340 1341 
99 177 183 184 198 199 270 297 335 373 424 519 533 585 663 686 886 887 959 973 1130 1131 
21 49 103 197 451 540 541 705 706 761 762 882 901 1031 1143 1166 1183 1226 1276 1285 
18 401 449 450 546 592 674 713 714 719 788 921 964 1043 1061 1098 1156 1196 1295 
46 160 275 402 409 425 428 456 505 527 528 634 718 839 840 923 1030 1096 
51 221 227 228 247 315 643 790 837 838 961 1006 1048 1087 1095 1180 1199 1283 
8 289 364 399 420 513 628 720 874 919 1017 1022 1064 1149 1227 1240 1280 
6 35 205 209 246 314 689 813 866 895 900 1188 1201 1324 1327 1338 
17 243 365 491 560 571 596 597 659 783 852 934 1051 1161 1242 
105 116 398 455 466 490 741 775 844 1040 1081 1137 1203 1262 1333 
2 58 200 329 484 667 703 745 819 865 983 1139 1237 1249 
117 291 346 553 722 792 922 1032 1244 1245 1261 
343 344 481 538 675 751 823 925 
30 358 436 967 1062 1071 1187 
80 230 476 795 858 864 883 
216 229 253 283 584 1054 1103 
156 157 771 854 982 1012 
372 551 855 965 1128 1165 
660 1008 1092 1216 1252 1354 
408 431 432 905 
