4 5 7 10 11 26 30 33 38 48 56 57 97 106 108 110 115 118 126 128 131 133 137 138 144 145 158 161 162 171 172 173 176 180 188 191 206 207 210 222 230 233 237 244 248 260 282 288 294 301 302 317 318 334 348 352 368 389 390 393 395 397 407 410 417 418 419 426 429 436 437 445 447 448 449 453 454 458 460 461 474 478 485 486 500 510 512 530 539 542 553 556 564 566 569 577 580 592 598 600 607 616 623 624 648 656 670 687 692 693 694 704 707 708 710 715 722 723 728 739 742 748 771 773 778 784 802 803 809 820 841 850 889 897 914 915 919 932 933 944 945 947 951 969 974 985 987 996 1031 1034 1046 1050 1052 1060 1061 1063 1068 1073 1079 1105 1107 1108 1112 1115 1124 1135 1136 1142 1145 1168 1170 1175 1177 1194 1195 1206 1208 1223 1233 1234 1241 1254 1259 1270 1275 1278 1279 1289 1290 1291 1299 1300 1302 1306 1310 1313 1320 1328 1339 1343 
1 12 13 15 22 23 31 32 34 36 37 40 42 43 44 53 55 59 63 64 66 79 83 86 87 89 93 94 111 148 149 153 165 174 178 189 195 208 212 219 220 224 234 235 238 245 250 255 257 259 264 265 269 277 278 285 296 303 304 305 306 307 308 309 320 322 325 327 339 340 341 347 349 350 353 354 355 360 361 362 366 374 375 381 388 392 394 403 406 414 421 422 430 438 442 467 468 475 501 502 503 515 516 526 535 573 588 594 595 599 601 608 619 626 627 631 649 676 688 724 736 743 758 765 770 781 787 793 814 817 818 821 827 845 867 871 872 875 877 899 909 910 936 943 948 953 955 970 979 997 998 1011 1024 1029 1037 1066 1070 1071 1106 1147 1148 1154 1162 1172 1187 1198 1205 1213 1217 1247 1260 1265 1266 1271 1272 1273 1301 1307 1308 1309 1332 1334 1348 
3 17 41 80 98 101 134 152 154 156 157 215 225 243 252 286 310 311 345 358 359 369 382 384 385 386 425 435 439 459 462 476 494 522 523 552 558 561 562 572 590 654 655 658 665 735 744 749 750 756 757 794 795 843 858 864 883 894 904 946 967 982 991 1003 1007 1021 1028 1036 1056 1085 1088 1089 1181 1214 1218 1219 1231 1258 1277 1281 1312 1346 
20 54 65 70 82 88 112 124 135 155 160 175 194 204 211 217 249 254 256 263 321 330 379 380 402 409 441 482 483 491 505 517 518 527 560 570 581 589 615 628 641 642 644 681 711 712 720 721 732 753 783 804 811 812 829 830 848 852 857 920 923 924 928 934 984 1030 1051 1084 1093 1114 1144 1158 1182 1189 1305 1325 1342 
0 19 67 68 69 104 122 140 146 164 166 167 179 190 251 258 275 287 293 324 338 356 367 383 391 400 423 427 440 463 498 499 520 548 549 557 563 582 583 604 606 609 640 652 682 691 697 726 786 800 835 893 906 907 908 957 971 978 1039 1044 1045 1117 1159 1220 
16 39 51 81 119 132 192 205 218 221 223 227 315 405 411 415 457 488 489 568 586 625 635 643 650 669 779 780 790 837 838 861 886 887 890 895 961 995 1006 1033 1035 1041 1072 1087 1095 1102 1118 1125 1131 1146 1180 1199 1283 1315 1327 1338 1347 
27 60 100 121 127 181 182 185 271 290 312 313 331 333 469 470 472 511 521 524 543 547 587 605 666 683 690 696 731 747 755 789 822 849 916 938 941 972 975 1000 1005 1014 1016 1049 1053 1123 1163 1176 1200 1212 1229 1318 1351 
29 50 74 123 163 186 196 281 316 428 444 479 534 554 593 612 613 634 660 671 718 727 734 791 810 825 839 840 862 873 881 911 927 960 976 983 1002 1019 1042 1086 1092 1132 1153 1171 1178 1197 1216 1252 1304 1314 1340 1341 1354 
46 139 141 236 239 268 295 323 326 370 371 434 528 545 591 636 638 639 653 663 672 698 699 737 764 782 785 931 937 958 1004 1009 1010 1023 1026 1069 1096 1104 1116 1122 1141 1185 1191 1210 1282 1296 1297 1349 
18 28 45 62 71 72 95 120 151 231 232 378 446 465 496 497 532 546 622 633 679 713 714 746 752 763 788 815 891 892 992 1001 1018 1048 1062 1098 1109 1113 1160 1173 1193 1224 1225 1243 1255 1295 1330 
25 91 213 214 272 280 299 328 387 433 504 525 536 537 602 603 610 629 684 685 729 776 801 807 846 847 853 859 869 888 898 1038 1081 1097 1169 1192 1202 1215 1262 1292 1298 1317 1319 
292 351 443 529 574 575 620 621 645 664 695 716 717 730 767 831 832 884 885 902 903 930 935 950 952 954 977 988 999 1015 1057 1076 1091 1133 1228 1345 
6 35 99 170 177 183 184 193 198 199 209 246 270 297 314 335 363 373 424 519 533 585 668 686 689 813 866 900 959 973 1074 1130 1188 1324 
105 116 117 266 291 346 398 455 456 466 490 680 741 775 792 844 896 922 990 1032 1040 1137 1164 1203 1244 1245 1253 1261 1267 1268 1286 1331 1333 
14 107 187 203 228 247 267 284 332 336 337 396 550 565 611 709 733 754 759 860 913 968 981 1025 1090 1204 1230 1236 1303 1329 
102 240 241 273 274 492 567 677 678 740 777 796 797 824 828 851 854 912 929 956 1013 1059 1078 1119 1120 1152 1155 1157 1201 1235 
75 159 202 262 319 342 464 477 576 579 632 700 719 766 772 926 966 993 1111 1129 1138 1156 1222 1248 1256 
9 76 125 261 279 401 413 450 495 630 673 674 816 842 863 878 921 940 964 1027 1043 1167 1196 
8 150 242 289 364 399 420 508 513 544 874 994 1012 1017 1022 1064 1149 1211 1227 1240 1280 
2 21 49 103 197 451 540 541 705 761 762 882 901 1143 1166 1183 1226 1276 1285 
47 90 92 147 298 471 559 798 808 879 880 980 1065 1082 1083 1094 1099 1110 1311 
84 85 201 300 412 473 506 531 617 618 702 942 962 963 1047 1075 1269 1294 1321 
113 114 142 143 276 706 738 760 833 834 836 1150 1151 1221 1257 1264 1287 1337 1344 
24 73 136 404 452 480 614 651 657 856 1008 1055 1077 1186 1207 1232 1350 
61 96 216 229 253 283 376 377 416 584 823 925 1054 1100 1103 1209 
109 487 646 647 805 806 826 868 876 1134 1246 1263 1326 1335 1336 
58 200 329 484 514 667 703 745 819 865 1139 1237 1249 
129 130 507 509 555 578 725 799 870 1020 1184 1238 1239 
365 408 431 432 571 596 597 659 701 905 1161 1242 
77 78 493 661 662 774 986 989 1080 1101 1293 
768 769 917 918 939 1179 1190 1274 1284 1316 
357 372 551 855 965 1128 1165 1288 
168 637 1058 1121 1140 1322 1323 
343 344 481 538 675 751 
52 169 226 949 1067 
