0 1 6 7 11 12 22 34 36 40 58 65 73 74 76 84 88 119 148 153 154 165 169 180 184 190 201 208 210 220 225 226 227 239 291 292 299 315 324 328 329 330 331 360 368 369 376 381 382 384 386 387 401 412 421 424 433 464 475 478 484 491 503 506 513 516 518 520 526 537 545 547 555 570 573 579 585 586 593 600 601 607 627 630 632 663 672 686 694 695 709 729 740 741 749 750 767 781 790 792 814 816 832 837 838 846 854 865 869 875 876 877 878 900 903 908 920 956 957 988 994 1003 1011 1014 1016 1024 1029 1051 1055 1056 1057 1058 1059 1063 1069 1078 1081 1095 1106 1114 1129 1130 1145 1149 1157 1162 1169 1180 1184 1193 1202 1204 1240 1244 1245 1256 1258 1260 1261 1264 1265 1273 1277 1283 1294 1319 1332 1345 1346 1348 
8 10 18 31 44 46 96 98 100 123 131 140 141 149 152 160 161 172 215 221 231 236 237 238 243 265 268 271 275 295 301 358 359 394 395 406 407 423 425 428 429 432 439 447 461 462 466 471 485 490 496 507 523 528 534 539 541 543 552 608 618 626 634 638 665 674 675 683 693 699 718 737 757 784 794 802 818 839 840 851 862 889 897 899 916 932 933 935 943 946 948 952 953 954 970 976 983 1002 1004 1021 1028 1043 1053 1064 1073 1087 1091 1122 1123 1141 1147 1188 1196 1200 1209 1210 1224 1231 1233 1247 1271 1320 1324 1333 1349 
41 80 102 103 104 107 108 113 114 156 164 168 173 182 185 186 196 197 198 199 202 209 214 228 247 251 257 270 282 284 286 297 298 312 322 335 338 357 371 385 389 392 404 451 472 525 531 533 548 551 558 589 594 603 615 636 648 651 653 666 667 668 673 685 698 723 727 733 752 761 762 782 793 800 822 841 843 860 902 904 905 938 951 958 959 964 967 973 982 984 992 996 999 1013 1036 1042 1046 1048 1054 1085 1102 1103 1104 1121 1125 1199 1222 1243 1248 1276 1342 
3 4 27 33 45 68 70 110 118 120 129 130 133 159 175 254 302 323 325 348 378 414 446 454 458 463 482 483 521 554 583 591 606 622 641 642 645 670 726 747 763 773 780 789 815 829 830 849 863 884 885 891 892 924 928 940 944 977 1000 1001 1012 1022 1035 1084 1105 1113 1133 1144 1160 1163 1166 1171 1173 1175 1178 1183 1214 1229 1232 1238 1239 1312 1350 
48 56 57 105 106 127 128 137 145 167 170 171 176 188 189 191 206 224 233 260 264 281 313 339 341 391 393 398 408 416 437 460 477 486 487 499 512 530 542 564 571 616 623 624 649 656 691 692 696 714 715 771 775 797 809 835 867 947 966 969 974 1068 1079 1107 1108 1124 1135 1177 1208 1234 1241 1270 1272 1275 1290 1302 1306 1313 1317 1339 
54 72 93 135 144 146 147 166 187 207 230 248 250 263 276 279 287 310 311 318 353 420 431 448 449 450 476 509 510 563 566 602 637 655 677 678 687 689 725 739 764 776 796 799 808 817 821 824 828 852 855 858 866 880 882 912 915 921 965 987 1015 1031 1065 1082 1083 1093 1119 1120 1161 1168 1194 1201 1249 1252 1289 1299 1305 1322 1323 1343 
5 75 81 82 83 111 132 138 155 256 259 285 296 305 307 347 354 362 375 379 380 383 396 397 473 474 481 488 556 557 561 569 578 581 582 584 595 598 625 652 676 688 707 710 721 732 748 786 787 795 995 1038 1050 1060 1077 1131 1159 1206 1211 
24 43 117 121 122 136 242 245 253 277 316 321 345 372 426 445 452 453 489 517 546 572 590 639 658 669 671 684 704 745 768 769 778 779 825 845 856 910 917 918 931 936 939 1005 1034 1066 1142 1172 1179 1190 1215 1274 1284 1298 1314 
13 20 21 37 47 69 87 112 195 200 204 205 216 249 252 255 269 288 303 308 327 340 349 352 355 361 367 409 419 438 508 511 544 604 643 644 728 798 901 909 914 937 979 980 1075 1094 1143 1217 1282 1315 1325 1331 
32 38 49 50 53 71 232 261 350 405 413 479 501 522 567 588 612 613 620 679 690 713 716 717 738 777 785 810 812 842 853 873 911 919 1018 1033 1041 1052 1062 1086 1109 1115 1153 1197 1254 1262 1278 1280 1292 1316 1340 1341 
14 15 109 115 116 266 267 326 565 596 611 646 647 743 805 806 826 868 896 913 968 990 1025 1070 1071 1090 1112 1134 1158 1203 1230 1236 1242 1259 1263 1266 1286 1303 1309 1326 1334 1335 1336 
9 124 203 211 217 229 240 241 258 262 273 274 319 320 332 365 435 440 441 492 498 502 549 550 560 659 753 754 756 766 783 801 807 929 981 1020 1164 1165 1279 1288 
26 67 91 92 139 192 213 343 370 459 497 559 568 605 654 682 731 755 774 848 859 906 907 975 1009 1010 1026 1027 1045 1080 1099 1116 1185 1191 1212 1246 1296 1297 1304 1318 
30 125 126 174 219 234 290 293 294 400 434 436 442 443 495 609 610 640 697 894 895 941 971 978 1006 1023 1039 1117 1187 1205 1310 
16 78 79 235 422 493 494 535 536 574 580 587 614 633 661 662 831 836 871 955 986 989 1101 1136 1148 1235 1293 1301 1338 
23 66 85 86 101 280 314 366 388 480 504 599 744 770 813 847 888 898 942 1097 1192 1195 1300 
19 61 62 134 179 304 342 427 553 562 619 701 722 742 765 1007 1061 1100 1198 1307 1308 1330 
28 29 455 456 465 592 680 734 735 823 927 960 1019 1040 1092 1098 1132 1155 1176 1253 1267 1268 
17 39 193 194 377 402 469 470 621 657 791 881 923 925 934 972 1030 1049 1156 1225 
35 177 178 283 333 351 529 660 664 788 922 930 985 991 1076 1216 1237 1295 1354 
55 60 162 163 181 289 390 403 417 418 444 527 538 708 820 870 945 1186 1213 
89 90 222 278 300 468 500 515 524 962 963 1047 1110 1140 1152 1269 1311 1351 
150 346 827 833 834 864 998 1008 1032 1118 1150 1151 1154 1167 1257 1321 
42 51 64 142 143 218 223 309 457 597 1067 1146 1337 1347 
2 246 363 364 514 681 811 819 857 1139 1182 1281 
25 63 306 344 415 467 577 730 872 993 1037 1189 
59 212 430 575 635 705 724 803 804 890 997 1072 
94 97 158 244 272 356 410 650 850 1088 1089 1291 
183 373 374 519 700 702 719 720 926 1074 1096 
77 317 334 532 631 703 746 844 961 1044 
99 617 628 629 711 712 736 861 1137 1138 
336 337 411 759 879 883 887 1327 1329 
751 760 893 1181 1207 1218 1219 1223 1328 
157 576 758 772 1128 1220 1221 1287 
52 95 151 949 950 1111 1255 
399 505 874 886 1017 1228 
540 1170 1226 1227 1285 
