4 5 7 26 28 30 33 38 48 56 57 61 62 96 97 103 106 108 110 115 126 131 133 138 145 152 158 162 163 170 172 173 176 180 188 191 210 237 244 248 260 264 265 272 288 294 301 302 316 317 318 348 352 363 368 376 377 389 390 393 397 407 410 416 417 418 419 426 429 436 437 445 447 454 460 461 462 465 474 512 523 530 532 539 542 552 556 566 577 579 580 584 595 598 600 624 646 647 648 656 665 668 670 673 687 693 704 707 710 715 721 723 728 742 757 773 784 794 802 803 805 806 809 817 818 820 823 827 841 868 874 876 884 885 890 896 910 915 932 933 944 945 951 969 974 983 985 987 990 992 996 1001 1004 1011 1020 1032 1034 1052 1060 1063 1068 1073 1100 1112 1124 1134 1135 1136 1142 1170 1175 1177 1181 1184 1186 1194 1195 1206 1208 1209 1218 1219 1223 1233 1234 1241 1243 1246 1259 1263 1270 1275 1277 1278 1279 1286 1290 1302 1306 1310 1312 1313 1326 1328 1330 1335 1336 1339 
1 12 13 15 22 23 31 32 34 36 37 40 42 43 44 53 55 59 63 64 66 79 83 86 87 89 93 94 111 148 149 153 174 178 189 195 208 212 220 224 234 235 238 245 250 255 257 258 269 277 278 285 296 303 304 305 306 307 308 309 320 322 325 327 339 340 341 347 349 350 353 354 355 360 361 362 374 375 381 388 392 394 403 406 414 421 422 430 438 467 468 475 501 502 503 514 515 516 526 535 573 588 594 599 608 619 626 627 631 649 669 688 696 736 743 758 765 770 781 787 793 821 845 867 871 872 875 877 899 909 936 943 948 953 955 970 979 995 997 998 1024 1029 1037 1040 1066 1071 1102 1106 1125 1147 1148 1154 1162 1172 1178 1187 1193 1198 1205 1213 1247 1260 1265 1266 1271 1272 1273 1301 1307 1308 1309 1332 1334 1348 
14 20 47 54 65 70 88 92 107 112 124 135 139 147 155 169 175 187 194 204 226 233 249 256 263 267 281 282 295 298 321 326 330 336 337 370 379 380 396 471 517 518 559 565 569 570 581 589 591 601 611 615 636 638 639 644 676 681 699 709 711 732 733 737 759 764 798 804 808 811 812 819 825 848 857 879 880 913 914 919 920 937 968 980 984 1000 1009 1010 1014 1017 1018 1023 1025 1026 1028 1046 1050 1065 1067 1082 1083 1090 1093 1094 1099 1104 1114 1116 1158 1176 1182 1185 1189 1191 1204 1230 1236 1280 1296 1297 1303 1305 1325 1329 1342 
74 102 105 109 116 123 150 151 156 157 197 236 240 241 242 273 274 291 346 371 398 455 466 479 487 490 492 507 508 509 510 544 555 567 593 612 613 677 678 698 708 725 727 739 740 741 771 775 777 785 791 792 796 799 824 826 828 833 834 844 854 860 862 873 881 904 911 912 922 929 956 976 982 994 1002 1012 1013 1021 1059 1078 1081 1109 1113 1115 1119 1120 1122 1137 1141 1150 1151 1152 1153 1155 1157 1171 1197 1203 1211 1235 1238 1244 1245 1254 1255 1257 1261 1262 1288 1292 1299 1316 1333 1340 1341 1343 1349 
9 10 11 29 73 75 76 77 78 81 113 114 125 128 137 142 143 144 159 165 168 171 186 196 202 206 207 222 266 276 279 284 342 357 359 366 404 442 444 448 458 464 477 478 486 500 504 525 534 554 563 564 576 606 607 614 616 623 630 632 651 661 662 671 692 694 719 734 738 760 772 797 810 814 816 836 850 851 863 878 889 926 927 940 946 947 960 966 989 993 1019 1042 1055 1058 1077 1079 1086 1101 1107 1111 1129 1132 1138 1156 1207 1221 1222 1248 1282 1287 1304 1337 
0 19 67 68 69 101 104 118 122 140 146 164 166 167 179 190 251 275 287 293 324 338 356 358 367 383 391 395 400 423 427 439 440 463 470 485 498 499 520 548 549 557 572 582 583 604 609 640 652 680 682 691 697 726 786 800 835 893 906 907 908 957 971 978 1039 1044 1045 1117 1145 1159 1164 1168 1220 1253 1267 1268 1331 
27 60 100 181 182 183 184 185 271 290 312 313 331 333 372 373 405 469 472 511 521 524 543 547 551 586 587 605 637 660 666 683 690 731 747 755 778 789 822 849 855 916 917 918 938 941 965 975 1005 1008 1016 1053 1092 1121 1123 1128 1130 1140 1163 1165 1179 1200 1212 1216 1217 1225 1229 1252 1256 1289 1293 1300 1322 1323 1351 1354 
17 45 71 72 120 129 130 203 211 217 243 254 261 262 319 332 334 345 378 413 435 441 446 449 482 483 491 495 496 497 550 560 592 622 641 642 724 746 748 752 753 754 763 766 783 815 829 830 842 852 891 892 924 928 934 981 1027 1061 1062 1070 1084 1105 1144 1160 1167 1173 1210 1224 1239 1291 
50 84 85 90 201 219 280 292 300 351 412 433 443 473 506 529 531 574 575 617 618 620 621 645 664 695 702 716 717 730 767 776 831 832 846 847 853 859 888 902 903 930 935 942 950 952 954 962 963 977 988 999 1015 1047 1057 1075 1076 1091 1097 1110 1133 1192 1228 1269 1294 1311 1314 1317 1321 1345 
3 41 80 82 98 154 215 216 225 229 230 252 253 283 286 299 310 311 369 382 384 385 386 387 459 476 493 494 522 558 561 562 590 650 654 655 658 744 749 750 756 774 795 843 858 864 866 883 894 895 967 986 991 1003 1007 1036 1054 1056 1080 1085 1088 1089 1103 1169 1214 1258 1281 1346 
18 51 52 117 221 227 228 315 365 401 408 431 432 450 546 553 571 596 597 643 659 674 701 713 714 722 788 790 837 838 905 921 949 961 964 1006 1043 1048 1051 1087 1095 1098 1146 1161 1180 1196 1199 1242 1283 1295 
46 121 134 141 160 161 231 232 239 268 323 402 409 425 428 434 456 505 527 528 545 602 633 634 653 672 679 712 718 735 782 839 840 897 923 925 931 958 1030 1049 1069 1096 1231 1318 1320 
6 35 58 95 99 177 198 199 200 205 209 246 247 270 297 314 329 335 424 484 519 533 585 663 667 686 689 703 745 813 865 900 959 973 1139 1188 1201 1237 1249 1324 1327 1338 
16 39 119 132 136 192 193 218 223 259 411 415 457 488 489 568 625 635 700 779 780 861 972 1033 1035 1041 1072 1074 1108 1118 1315 1347 
24 25 91 127 213 214 328 452 480 536 537 610 629 657 684 685 729 801 807 856 869 898 1038 1202 1215 1232 1298 1319 1350 
2 21 49 451 540 541 578 603 705 706 761 762 870 882 886 887 901 1031 1131 1143 1166 1183 1226 1264 1276 1285 1344 
8 289 343 344 364 399 420 481 513 538 628 675 720 751 1022 1064 1149 1227 1240 
453 768 769 939 1190 1274 1284 
