1 6 7 11 12 22 24 25 34 36 40 53 58 66 68 73 74 88 119 129 130 140 148 154 165 169 208 212 220 225 226 227 236 242 245 262 272 277 280 299 300 306 314 315 321 324 325 328 329 360 374 376 381 386 387 388 401 412 415 421 433 464 467 475 484 489 491 503 513 516 517 519 526 537 545 546 547 570 573 585 591 599 600 601 606 607 627 630 650 663 671 675 686 694 695 702 726 729 740 741 749 750 765 780 781 790 792 800 803 814 832 847 854 865 875 888 891 900 903 908 926 957 962 963 988 1003 1014 1022 1035 1042 1056 1057 1058 1059 1078 1095 1096 1097 1106 1129 1145 1149 1152 1157 1169 1173 1179 1180 1192 1214 1215 1238 1239 1240 1244 1245 1258 1261 1264 1269 1271 1273 1294 1307 1308 1319 1332 1346 1348 
0 4 10 31 44 46 47 48 56 100 105 127 128 131 137 141 142 143 149 160 170 171 189 191 206 223 238 243 244 264 265 275 281 291 292 295 358 359 366 391 393 394 395 400 407 408 409 410 425 428 432 446 460 461 462 466 471 477 486 487 490 496 499 504 514 523 527 528 534 541 542 543 552 564 571 616 618 623 624 626 634 656 659 660 665 673 674 683 691 692 701 714 715 718 722 748 775 784 794 797 801 809 818 848 889 898 899 916 933 938 943 947 948 952 953 954 966 969 970 976 1021 1043 1053 1064 1067 1079 1091 1107 1108 1122 1123 1124 1135 1141 1147 1177 1196 1200 1216 1233 1234 1241 1247 1272 1290 1302 1306 1333 1337 1347 1349 1354 
80 102 103 104 107 108 113 114 156 164 167 168 173 196 197 198 202 214 228 240 251 257 266 270 273 286 297 298 322 323 335 338 341 385 389 392 404 451 472 494 498 525 531 533 535 536 548 583 589 594 603 615 633 651 653 668 687 699 723 733 737 744 752 761 762 807 841 843 860 871 902 904 905 929 951 958 959 967 973 982 996 1013 1017 1020 1046 1047 1062 1085 1103 1139 1148 1202 1276 1301 
14 15 32 38 109 115 116 267 312 326 405 501 521 522 565 567 596 608 611 613 646 647 690 713 738 743 760 785 789 826 913 919 960 968 1004 1016 1018 1025 1041 1050 1052 1070 1071 1090 1099 1109 1115 1134 1163 1203 1211 1230 1236 1242 1254 1259 1266 1278 1280 1282 1303 1309 1326 1334 1335 
13 20 21 69 82 99 112 120 124 134 155 195 199 200 205 255 308 320 340 342 398 419 427 468 500 502 511 515 524 617 619 628 629 643 644 711 712 728 736 742 805 806 816 861 901 1077 1100 1137 1138 1143 1158 1160 1171 1189 1198 1201 1231 1243 1325 1336 1351 
5 75 81 83 111 132 138 250 256 284 285 304 305 307 331 347 354 362 375 396 397 458 473 474 481 518 556 561 569 578 581 582 584 595 598 625 652 670 688 707 710 786 787 795 815 920 980 995 1044 1131 1159 1184 
30 42 49 50 59 64 71 218 234 241 261 309 350 413 457 488 575 588 635 724 769 771 777 804 810 812 842 873 939 978 997 1012 1033 1040 1086 1088 1089 1102 1125 1153 1162 1187 1190 1197 1205 1274 1284 1292 1310 1316 1340 1341 
9 18 33 45 70 97 123 146 152 158 172 174 180 190 207 221 254 271 279 287 301 302 406 429 447 448 454 483 693 747 796 824 858 867 892 910 912 944 946 961 1015 1028 1105 1119 1120 1219 1249 1312 
54 57 72 93 135 144 147 166 187 204 230 248 263 276 318 378 420 431 449 450 476 530 540 560 563 566 764 817 821 852 855 866 880 915 921 987 1065 1082 1083 1093 1168 1170 1206 1226 1285 1289 1305 1317 
3 23 76 85 86 87 161 184 215 239 327 349 352 353 369 379 382 424 506 602 637 645 649 709 756 767 798 909 942 956 1069 1094 1130 1183 1195 1204 1265 1277 1300 1315 1320 1322 1323 1331 1345 
52 55 60 125 126 162 163 181 268 289 290 293 294 332 390 403 417 418 434 442 444 495 538 614 640 697 708 763 820 870 941 945 971 992 1023 1048 1117 1186 1210 1213 1253 1267 1268 
8 178 203 211 217 229 319 399 435 440 441 455 492 505 592 622 753 754 766 783 788 823 839 840 853 862 935 974 1076 1098 1132 1161 1172 1227 1228 1237 1295 
2 106 110 175 176 188 224 233 260 313 330 348 370 380 414 437 463 512 676 819 940 984 994 1068 1193 1194 1208 1260 1270 1275 1313 1339 
27 95 117 122 183 253 316 345 372 373 426 445 453 572 590 639 658 669 745 755 768 773 778 845 856 931 936 1005 1034 1066 1142 
79 96 235 422 430 493 574 580 586 587 661 662 705 831 837 838 890 955 989 1060 1072 1074 1101 1136 1209 1217 1256 1283 1293 1338 
17 39 65 121 136 193 194 377 402 456 469 470 621 657 732 791 881 923 925 934 972 1029 1030 1049 1055 1156 1291 
28 61 62 84 368 465 520 620 672 677 678 716 717 735 776 846 874 876 877 886 896 990 1001 1011 1024 1286 1330 
182 185 186 282 371 550 551 636 648 666 698 725 782 793 822 914 964 981 1054 1104 1165 1199 1222 1225 1248 1342 
51 258 384 478 479 509 510 555 579 597 632 727 739 799 828 833 834 1114 1146 1150 1151 1257 1279 1299 1343 
29 231 232 482 507 638 641 642 679 680 734 830 924 927 928 1019 1084 1092 1144 1155 1164 1176 1224 1288 
37 139 216 249 288 303 355 367 544 937 1009 1010 1026 1027 1116 1185 1191 1296 1297 
26 67 98 192 296 383 459 497 508 554 859 917 918 975 1080 1178 1304 1318 
77 317 334 357 532 631 703 746 844 850 851 863 868 1073 1112 1113 1133 1263 
101 151 246 363 364 480 681 770 772 811 813 857 949 950 1111 1182 1255 1281 
145 310 311 336 337 411 655 706 759 882 883 887 965 1031 1327 1329 1344 
150 346 700 704 719 720 779 825 827 835 864 998 1118 1154 1167 1314 1321 
43 89 90 94 222 278 361 604 730 993 1081 1110 1140 1262 1311 
63 133 252 344 438 577 849 872 979 1037 1166 1175 1229 1232 1350 
91 92 237 343 539 559 654 682 897 906 907 932 1045 1246 
219 259 269 356 443 751 893 1038 1075 1181 1207 1218 1223 1328 
19 179 423 439 553 557 562 1007 1008 1032 1061 1252 
35 177 283 333 351 529 664 922 930 985 991 
157 576 593 612 758 878 911 1128 1220 1221 1287 
209 247 558 684 685 808 829 999 1036 1121 1298 
118 159 339 416 696 721 884 885 977 1000 
16 78 274 609 610 836 879 986 1235 
41 667 757 802 983 1002 1087 1188 1324 
153 201 210 365 549 869 1051 1063 
213 452 568 605 731 774 1212 
436 485 689 894 895 1006 1039 
