5 7 11 26 30 33 38 48 56 57 106 108 109 110 115 126 128 131 133 137 138 145 152 158 162 171 172 173 176 180 188 191 206 207 222 237 244 248 259 260 261 264 265 288 294 301 302 317 318 347 348 352 368 389 390 393 394 397 407 416 417 418 419 426 429 436 437 443 445 447 448 453 454 460 461 462 474 478 486 497 500 512 523 530 532 542 556 564 566 577 579 580 595 598 600 616 623 624 647 648 656 665 668 670 673 687 692 693 694 704 707 710 715 721 723 728 742 748 757 768 773 784 794 796 797 802 803 805 806 809 818 820 824 825 827 841 851 868 890 910 915 932 933 939 944 945 946 947 951 969 974 983 985 987 992 996 1020 1034 1060 1068 1073 1079 1107 1108 1112 1119 1120 1124 1134 1135 1136 1142 1170 1175 1177 1181 1184 1186 1194 1205 1206 1208 1218 1219 1223 1233 1234 1241 1243 1246 1256 1259 1263 1270 1275 1278 1279 1290 1291 1302 1306 1310 1312 1313 1315 1326 1328 1335 1336 1339 1342 
1 12 13 15 22 23 31 32 34 36 37 40 42 43 44 53 55 59 63 64 66 79 82 83 86 87 89 93 94 111 148 149 153 174 178 189 195 208 212 218 219 220 224 234 235 238 245 250 255 257 258 269 272 277 278 285 296 303 305 306 307 308 309 320 322 325 327 339 340 341 349 350 353 354 355 360 361 362 374 375 381 388 392 403 406 414 421 422 430 438 467 468 475 501 502 503 514 515 516 526 535 573 588 594 599 608 619 626 627 631 649 669 688 736 743 758 765 770 781 787 793 817 821 845 867 871 872 875 877 899 909 936 943 948 953 955 970 995 997 998 1024 1029 1037 1066 1071 1102 1106 1125 1147 1148 1154 1162 1172 1178 1187 1193 1198 1213 1247 1260 1265 1266 1271 1272 1273 1301 1307 1308 1309 1332 1334 1348 
0 19 67 68 69 101 104 118 122 140 146 164 166 167 170 179 190 251 287 293 324 338 356 358 363 367 383 391 395 400 423 427 439 440 463 470 485 498 499 520 548 549 557 582 583 604 609 640 652 680 682 691 697 726 786 800 835 889 893 906 907 908 957 971 978 1039 1044 1045 1117 1145 1159 1168 1220 1253 1267 1268 1331 
4 20 47 54 65 70 88 92 97 112 124 135 147 155 161 169 194 204 226 249 256 263 298 321 379 410 471 559 570 581 589 601 615 636 638 644 681 711 712 732 737 798 804 808 811 812 848 850 857 879 880 897 980 1049 1065 1067 1082 1083 1093 1094 1099 1104 1114 1158 1182 1189 1195 1305 1320 1325 
27 60 100 163 181 182 185 271 290 312 313 316 331 333 405 469 472 511 521 524 543 547 572 586 587 637 683 690 696 731 747 755 778 789 822 849 916 938 941 975 1000 1005 1014 1016 1053 1121 1123 1140 1163 1176 1179 1200 1212 1229 1289 1300 1322 1323 1351 
3 41 80 98 215 230 252 286 299 310 311 369 382 384 385 459 476 494 522 552 561 562 590 650 654 655 658 744 749 750 756 795 843 858 864 866 883 894 904 967 986 991 1007 1021 1036 1062 1080 1085 1088 1089 1214 1281 1346 
28 61 62 96 102 225 240 241 273 376 377 465 492 507 509 510 555 567 607 646 677 678 708 725 739 740 777 785 799 828 876 896 912 929 956 972 990 1001 1011 1013 1059 1078 1100 1115 1152 1157 1209 1238 1254 1286 1299 1330 1343 
6 35 58 74 99 123 177 183 184 198 199 200 205 209 246 247 270 297 314 329 335 373 424 484 519 533 558 585 663 667 686 689 703 727 745 813 865 895 900 959 973 1002 1130 1139 1188 1201 1237 1249 1324 1327 1338 
46 121 134 141 160 231 232 239 268 275 323 402 409 425 428 434 456 505 527 528 539 545 602 633 634 653 672 679 718 735 782 839 840 856 884 885 923 931 958 1030 1069 1096 1231 1277 1318 
2 29 90 139 175 186 233 281 282 295 326 330 370 380 444 517 518 534 591 639 671 676 699 764 810 819 914 920 937 984 1004 1009 1010 1018 1023 1026 1028 1046 1086 1116 1185 1191 1296 1297 
21 49 103 129 130 254 451 482 483 540 541 578 603 641 642 705 706 761 762 829 830 870 874 882 886 887 901 919 924 928 1017 1031 1084 1105 1131 1143 1144 1166 1183 1226 1239 1276 1280 1285 
14 77 78 107 142 143 187 267 336 337 396 493 565 611 661 662 709 733 738 759 774 833 834 913 918 968 989 1025 1090 1101 1150 1151 1204 1230 1236 1257 1264 1293 1303 1329 1337 1344 
10 25 91 127 213 214 280 328 366 387 415 433 504 536 537 610 629 684 685 729 776 801 807 846 847 853 859 869 888 898 1033 1038 1097 1169 1192 1202 1215 1292 1298 1317 1319 
45 71 72 120 378 413 446 495 496 605 622 724 746 752 763 815 842 891 892 979 1027 1070 1113 1160 1167 1173 1210 1217 1224 
9 17 125 203 211 217 243 262 319 332 334 345 435 441 449 491 550 560 592 753 754 766 783 852 934 981 1061 
75 76 81 165 279 284 357 442 464 477 569 630 632 719 734 814 816 863 878 917 940 1019 1050 1129 1156 1248 1304 
113 114 144 168 196 202 276 458 525 554 563 606 760 836 927 960 1042 1058 1132 1197 1221 1222 1282 1287 
16 39 119 132 192 223 411 457 488 489 568 625 635 700 779 780 861 1035 1041 1072 1118 1225 1347 
84 85 201 210 300 412 473 506 531 617 618 702 942 962 963 1047 1052 1063 1075 1269 1294 1321 
51 52 221 227 228 315 643 790 837 838 949 961 1006 1048 1087 1095 1146 1180 1199 1283 
154 351 386 529 645 664 902 903 930 935 952 954 977 988 999 1003 1056 1076 1091 1258 
18 401 408 431 432 450 546 674 713 714 788 905 921 964 1043 1098 1196 1295 
24 73 136 193 266 404 614 651 657 1055 1074 1077 1207 1232 1350 
95 151 487 791 826 860 862 873 881 976 1109 1153 1255 1340 1341 
105 116 398 455 466 490 741 775 844 1040 1081 1137 1203 1262 1333 
8 289 364 399 420 513 628 720 1022 1064 1149 1227 1240 
117 197 291 346 553 722 792 922 1032 1244 1245 1261 
274 372 551 666 855 965 1128 1155 1164 1165 1235 1288 
620 621 695 716 717 730 831 832 950 1015 1057 1228 
159 304 342 359 576 772 926 966 993 1111 1138 
50 292 574 575 767 1110 1133 1311 1314 1345 
150 242 508 544 771 854 994 1012 1211 
156 157 236 371 698 982 1122 1141 1349 
365 571 596 597 659 701 1051 1161 1242 
343 344 481 538 675 751 823 925 
452 479 480 593 612 613 911 1171 
216 229 253 283 584 1054 1103 
660 1008 1092 1216 1252 1354 
769 1190 1274 1284 1316 
