0 1 6 12 22 34 36 40 41 76 88 148 165 169 208 220 227 292 305 360 376 381 382 401 412 421 464 475 503 513 516 526 570 573 584 585 593 600 607 627 630 663 686 695 740 749 781 792 814 816 832 854 875 885 908 956 957 982 988 994 1011 1054 1058 1059 1078 1081 1102 1106 1125 1129 1149 1157 1162 1193 1240 1244 1245 1260 1261 1273 1294 1332 1348 
48 56 57 105 127 128 137 170 171 191 233 264 393 398 446 460 477 486 487 512 542 564 571 616 623 624 656 691 692 715 775 809 966 969 1107 1108 1124 1135 1177 1234 1241 1272 1290 1302 1306 
5 75 81 82 83 97 111 132 155 256 259 285 288 307 347 354 356 375 397 488 561 569 595 598 625 652 676 688 786 787 795 995 1038 1044 1050 1060 1077 1131 1211 
44 100 149 265 295 358 359 394 425 432 462 471 515 523 541 543 608 618 665 674 784 794 818 916 933 952 954 976 1021 1053 1091 1123 1141 1147 1200 
14 15 109 115 267 326 565 596 611 646 647 699 743 805 806 826 868 913 968 1004 1025 1090 1112 1134 1158 1230 1236 1242 1259 1263 1303 1326 1335 1336 
154 225 226 299 312 328 369 386 387 521 537 601 690 729 750 789 903 1003 1014 1016 1055 1056 1057 1163 1169 1215 1258 1265 1319 1346 
33 98 160 161 180 184 190 215 239 243 244 279 301 302 423 439 454 709 756 897 944 1028 1069 1130 1204 1277 1320 
124 203 211 229 262 319 320 332 345 365 435 440 441 502 550 560 622 659 753 754 766 783 801 981 1271 
182 186 198 199 209 270 282 297 298 335 371 533 636 698 782 958 959 973 984 1104 1342 
20 21 31 46 112 205 275 409 428 511 528 539 634 718 899 901 953 970 1143 1325 
72 93 202 248 318 378 420 476 530 566 602 855 915 987 1031 1082 1194 1289 1317 
117 121 253 372 426 445 590 658 669 755 778 845 931 936 1005 1034 1142 
126 174 234 268 290 293 294 434 442 495 640 697 941 971 1023 1117 1210 
29 217 232 679 680 734 927 960 1019 1092 1132 1155 1164 1176 1197 
103 104 156 196 197 472 727 904 905 951 992 1048 1224 1243 
32 405 501 713 919 1018 1062 1109 1115 1254 1278 1299 
138 362 396 474 556 578 581 582 707 710 748 1159 
91 92 343 559 654 682 906 907 1045 1099 1246 
172 271 395 400 429 461 693 737 851 961 1073 
4 45 70 254 483 747 829 892 1105 1312 
49 50 261 350 413 588 810 812 842 1086 
66 280 504 807 847 888 898 1097 1192 1202 
107 108 167 284 389 531 603 667 733 752 
7 58 73 74 329 484 545 865 900 
18 123 152 221 406 407 447 485 946 
162 163 181 418 538 708 763 820 1186 
176 188 224 260 313 437 771 1068 1208 
214 392 451 589 594 615 967 1103 1276 
384 478 555 579 632 1020 1114 1184 1256 
509 510 677 678 739 776 799 828 1343 
16 78 274 661 662 989 1101 1235 
17 39 193 469 470 1049 1156 1225 
24 242 277 452 517 704 779 856 
54 147 166 880 1065 1083 1093 1110 
59 212 575 635 724 780 803 1035 
87 135 200 204 687 912 1252 1305 
183 373 374 519 702 926 1074 1096 
482 641 642 830 924 928 1084 1144 
769 917 918 939 1179 1190 1274 1284 
3 325 591 638 1001 1173 1183 
8 839 840 862 935 943 1247 
11 547 694 741 767 1145 1345 
26 67 459 497 848 859 1304 
133 849 1166 1175 1229 1232 1350 
153 201 210 491 869 1051 1063 
206 207 499 714 797 947 1079 
336 337 411 759 879 887 1329 
346 833 834 864 1150 1151 1257 
23 85 86 942 1195 1300 
30 436 978 1187 1205 1310 
47 327 349 798 980 1094 
61 62 701 1100 1196 1330 
63 304 342 872 1037 1189 
68 670 815 1022 1206 1214 
79 219 235 443 574 580 
95 151 450 772 1111 1255 
113 114 158 322 525 653 
116 1070 1071 1203 1266 1286 
119 272 324 433 650 1041 
129 130 606 891 1238 1239 
140 141 238 496 534 552 
146 250 287 808 858 1249 
177 178 788 1076 1237 1295 
246 681 811 857 1182 1281 
315 586 790 837 838 1283 
317 334 631 703 746 844 
402 620 621 716 717 1030 
404 651 723 843 996 1013 
725 796 824 1119 1120 1201 
751 760 893 1181 1218 1219 
777 873 1088 1089 1153 1316 
1009 1010 1185 1191 1296 1297 
10 683 1064 1122 1349 
19 179 553 562 722 
35 351 660 1216 1354 
38 522 738 1052 1280 
55 289 403 945 1213 
69 195 308 340 419 
99 628 629 711 712 
101 314 480 770 813 
110 175 330 348 1275 
118 458 645 884 977 
185 666 964 1161 1199 
237 333 932 985 991 
240 241 273 492 929 
255 468 500 524 1351 
283 529 664 922 930 
300 962 963 1047 1269 
310 311 655 882 965 
366 388 410 599 744 
368 506 520 846 1024 
399 505 974 1172 1228 
422 587 831 955 1338 
455 456 592 1040 1253 
535 536 871 1148 1301 
568 731 774 1152 1212 
617 736 861 1137 1138 
684 1165 1279 1288 1298 
827 998 1154 1167 1321 
2 514 819 1139 
25 306 415 467 
28 71 465 735 
37 303 367 544 
42 64 218 457 
43 94 730 993 
52 949 950 1067 
53 192 370 975 
60 390 417 527 
84 672 876 877 
89 222 1140 1311 
96 231 507 1209 
106 145 914 1270 
120 286 1160 1171 
139 1026 1027 1116 
144 263 563 821 
157 576 878 1128 
164 761 762 793 
187 276 558 852 
216 355 937 1282 
228 247 999 1036 
245 361 604 909 
249 643 644 728 
266 414 896 990 
377 881 923 934 
430 705 890 1072 
453 768 910 1066 
479 612 613 911 
758 1220 1221 1287 
800 804 997 1042 
853 1033 1262 1292 
894 895 1006 1039 
13 252 438 
27 726 773 
51 597 1146 
65 732 1029 
77 532 1293 
136 473 557 
142 223 1347 
168 685 1121 
194 657 1231 
230 921 1168 
257 338 548 
258 498 549 
269 508 1075 
281 391 835 
316 572 639 
321 489 546 
331 518 920 
339 416 696 
341 408 649 
352 1315 1331 
357 551 648 
379 380 721 
427 619 742 
466 490 1333 
481 823 1098 
493 614 1136 
668 841 902 
671 825 1314 
700 719 720 
706 1264 1344 
757 1002 1087 
765 1007 1061 
791 925 972 
802 889 983 
822 1222 1248 
863 1113 1133 
874 886 1017 
1207 1223 1328 
