0 1 3 6 7 12 22 34 36 40 58 73 74 76 88 99 112 119 120 129 130 148 149 153 154 165 169 180 190 201 208 210 212 220 225 226 227 236 255 272 292 299 300 305 315 324 325 328 329 360 362 369 376 381 386 401 412 421 424 433 464 468 471 475 484 491 500 503 506 513 516 524 537 541 545 570 573 584 585 586 591 600 601 606 607 617 627 628 629 630 650 663 674 677 678 686 695 711 712 726 729 736 749 750 776 780 781 792 803 805 806 807 814 816 828 832 837 838 861 865 869 875 891 899 900 903 908 956 957 962 963 988 994 1001 1003 1016 1020 1035 1047 1051 1054 1056 1057 1058 1063 1081 1106 1129 1137 1138 1149 1158 1160 1162 1169 1171 1173 1183 1193 1202 1215 1238 1239 1240 1244 1245 1247 1258 1260 1261 1265 1269 1273 1283 1294 1319 1332 1336 1346 1348 1351 
4 10 18 21 33 44 45 47 65 70 97 98 100 123 124 131 152 155 160 161 184 215 221 237 239 243 254 265 279 291 295 301 302 320 323 358 359 365 407 423 425 432 439 447 453 454 461 462 466 482 483 485 490 502 515 523 526 543 552 554 583 608 618 622 626 641 642 659 665 683 709 732 737 747 756 763 767 784 790 794 801 802 818 829 830 862 892 897 901 910 916 924 928 932 933 944 946 948 952 954 976 983 1021 1028 1029 1043 1053 1064 1069 1084 1091 1095 1105 1122 1123 1130 1141 1143 1144 1147 1178 1180 1200 1204 1233 1252 1271 1277 1312 1320 1333 1345 1349 
20 31 46 48 56 57 77 96 105 127 128 137 140 141 170 171 189 191 231 233 238 264 275 281 317 334 391 393 398 408 409 428 446 460 477 486 487 496 501 507 511 512 528 532 534 539 542 564 567 571 616 623 624 631 634 649 656 691 692 703 715 718 746 775 785 809 835 839 840 844 867 935 943 953 960 966 969 970 1041 1107 1108 1124 1135 1177 1209 1234 1241 1272 1290 1293 1302 1306 1325 
41 80 102 103 104 133 156 168 173 182 185 186 196 197 198 199 209 251 270 297 298 335 357 370 371 404 472 533 551 636 638 648 651 666 673 685 698 723 727 757 782 822 843 849 904 905 938 951 958 959 964 973 982 984 992 996 999 1002 1013 1087 1102 1104 1121 1125 1161 1166 1175 1188 1199 1222 1229 1232 1248 1324 1342 1350 
8 54 72 93 135 144 147 166 187 200 202 204 211 213 230 248 263 276 318 319 378 420 431 435 476 509 510 558 560 563 566 602 605 687 689 725 739 754 764 766 783 796 799 821 824 852 855 866 880 912 915 921 987 1031 1065 1082 1083 1093 1119 1120 1168 1194 1201 1289 1299 1343 
5 27 75 81 82 83 111 132 136 205 256 259 284 285 286 288 296 307 347 354 375 379 380 383 396 397 458 473 474 488 530 556 557 561 569 578 581 582 595 598 625 652 676 688 707 710 721 748 773 786 787 795 980 995 1038 1044 1050 1060 1077 1159 1211 1317 
17 32 38 39 49 50 52 68 193 194 261 350 377 402 405 413 444 469 470 522 588 620 621 657 670 675 713 716 717 738 810 812 815 842 870 881 919 923 934 1018 1022 1023 1030 1048 1049 1052 1062 1086 1115 1156 1206 1214 1224 1225 1231 1243 1254 1278 1280 
24 43 117 121 122 242 253 277 316 345 372 426 445 452 517 568 572 590 639 658 669 671 704 731 745 755 768 769 774 778 779 825 845 856 917 918 931 936 939 1005 1034 1066 1142 1179 1190 1212 1274 1284 1314 
37 69 87 139 195 216 249 269 303 308 327 340 349 352 353 355 361 367 419 508 544 637 643 644 728 765 798 909 937 1007 1009 1010 1026 1027 1061 1075 1094 1116 1185 1191 1282 1296 1297 1307 1308 1322 1323 1331 
28 29 71 217 232 258 441 465 479 498 549 592 593 612 613 679 680 684 734 735 753 777 853 873 911 927 1019 1033 1088 1092 1132 1153 1155 1164 1165 1176 1197 1262 1279 1288 1292 1298 1305 1316 1340 1341 
107 108 113 114 164 167 203 214 228 240 247 257 273 282 322 338 385 389 392 451 525 531 548 589 594 603 615 653 667 668 733 752 761 762 793 800 841 860 902 929 967 1036 1042 1103 1276 
14 15 109 115 116 267 326 565 596 611 646 647 699 743 826 868 913 968 1004 1025 1071 1090 1109 1112 1134 1203 1230 1236 1242 1259 1263 1266 1286 1303 1309 1326 1334 1335 
11 84 330 331 368 382 384 387 478 518 520 547 555 579 632 672 694 740 741 846 854 876 877 920 1011 1024 1059 1078 1089 1114 1145 1152 1157 1184 1256 
16 78 138 244 274 312 366 388 406 410 494 521 599 633 661 662 690 789 836 850 851 863 986 989 1012 1014 1055 1073 1101 1113 1133 1163 1235 1291 
9 30 125 126 174 219 234 268 290 293 294 434 436 442 443 495 609 610 640 697 894 895 941 971 978 1006 1039 1117 1187 1205 1210 1310 
13 19 63 66 134 179 252 280 304 342 344 427 438 504 553 562 577 619 722 742 847 872 888 898 979 1037 1097 1189 1192 1198 1217 
26 55 60 67 162 163 181 289 332 390 403 417 418 459 497 527 538 708 820 848 859 945 1080 1186 1213 1304 1318 
2 106 110 145 175 176 188 224 260 313 321 348 437 489 514 546 771 819 914 1068 1139 1208 1270 1275 1313 1339 
35 177 178 229 283 333 351 529 660 664 788 922 930 985 991 1076 1216 1237 1295 1354 
91 92 266 343 414 463 559 654 682 896 906 907 940 990 1045 1099 1246 
146 245 250 287 310 311 448 655 706 808 858 882 965 1015 1249 1264 1344 
150 346 827 833 834 864 879 998 1008 1032 1118 1150 1151 1154 1167 1257 1321 
158 172 206 207 271 394 395 400 429 499 693 714 797 889 947 961 1079 
95 142 143 151 223 450 550 772 949 950 981 1067 1111 1255 1337 1347 
89 90 94 222 278 440 604 730 993 1046 1070 1085 1140 1311 
23 61 62 85 86 701 744 942 1100 1195 1196 1300 1330 
51 356 597 751 760 893 1146 1181 1207 1218 1219 1223 1328 
79 235 422 493 574 580 587 614 831 955 1110 1136 1338 
101 246 314 363 364 480 681 770 811 813 857 1182 1281 
42 64 218 309 341 457 535 536 817 871 1148 1301 
183 262 373 374 519 700 702 719 720 926 1074 1096 
455 456 481 791 823 925 972 1040 1098 1253 1267 1268 
241 399 492 505 874 886 974 1017 1131 1172 1228 
59 430 575 635 705 724 804 890 997 1072 
118 159 339 416 645 696 884 885 977 1000 
25 53 192 306 415 467 975 1315 
157 576 758 878 1128 1220 1221 1287 
336 337 411 759 883 887 1327 1329 
449 540 1170 1226 1227 1285 
