0 6 7 11 22 34 36 40 67 73 74 79 81 88 112 120 148 154 155 165 169 184 208 212 220 225 226 227 235 238 239 255 272 277 284 299 300 312 315 320 323 328 329 353 360 364 369 376 381 382 384 386 388 392 401 412 421 464 468 475 477 484 493 503 513 516 521 524 526 537 545 547 573 574 580 583 585 599 600 601 602 607 617 627 628 629 637 647 649 663 673 674 686 690 694 695 711 712 723 729 736 741 749 750 767 781 788 803 805 806 816 832 851 861 863 865 875 886 900 903 908 938 957 1003 1014 1016 1050 1056 1057 1058 1069 1073 1106 1113 1125 1129 1130 1131 1133 1134 1136 1137 1138 1149 1152 1158 1160 1162 1196 1215 1236 1240 1243 1258 1271 1273 1278 1294 1319 1322 1323 1326 1332 1336 1345 1346 1348 1351 
10 14 15 27 31 46 48 71 72 105 106 115 116 127 128 137 140 141 142 143 170 171 176 188 191 206 223 224 231 233 236 260 264 267 268 281 313 326 348 358 366 391 393 408 409 410 425 428 434 444 446 460 461 486 487 494 496 499 500 501 512 528 534 542 552 564 565 567 571 596 608 616 623 624 633 634 656 659 660 675 683 691 692 714 715 718 726 743 748 773 775 785 796 797 801 809 835 884 892 898 899 913 943 946 947 953 966 968 969 970 1004 1025 1041 1046 1064 1067 1068 1070 1071 1085 1090 1107 1108 1122 1124 1135 1177 1202 1203 1208 1211 1216 1230 1233 1234 1241 1242 1247 1259 1266 1270 1272 1275 1277 1286 1290 1302 1303 1306 1309 1313 1334 1337 1339 1347 1349 1354 
5 9 18 20 21 33 37 43 63 87 94 97 98 119 123 131 133 135 152 160 161 167 172 174 180 190 200 204 207 215 216 221 243 244 249 252 256 259 269 279 286 288 295 301 302 303 310 311 324 325 327 342 344 349 352 355 356 367 394 395 400 406 407 423 429 430 433 438 439 443 447 454 491 508 510 511 540 541 544 570 577 589 639 643 644 645 650 687 693 699 705 728 730 747 751 756 765 766 800 817 849 867 872 889 890 893 901 912 937 944 951 961 979 993 998 1008 1028 1032 1037 1038 1042 1060 1075 1079 1088 1089 1094 1139 1143 1154 1166 1167 1170 1181 1189 1198 1207 1218 1219 1223 1226 1252 1265 1285 1305 1307 1308 1312 1320 1321 1325 1328 1331 
2 3 80 103 104 107 108 113 114 129 130 139 164 173 182 186 196 197 198 214 228 253 257 266 270 282 283 297 298 335 338 341 371 385 389 399 404 424 458 472 525 529 531 533 535 536 548 551 591 594 603 606 615 636 638 648 651 664 666 668 698 707 725 733 737 752 760 780 793 814 822 824 841 843 854 860 871 891 896 902 904 905 919 930 958 959 960 964 967 973 974 982 990 1009 1010 1012 1013 1017 1035 1047 1054 1055 1062 1098 1102 1103 1104 1116 1119 1120 1132 1148 1163 1172 1173 1183 1185 1191 1199 1222 1225 1227 1238 1239 1248 1282 1295 1301 1342 
16 17 24 25 32 39 52 56 68 78 121 125 126 136 138 175 193 194 240 242 251 273 274 290 293 294 306 321 330 331 377 402 405 442 456 467 469 470 489 495 517 518 546 609 610 613 640 657 661 662 670 671 697 704 706 713 720 771 779 789 815 819 825 850 879 881 914 920 923 925 929 934 941 971 972 989 992 1018 1022 1023 1030 1048 1049 1072 1101 1115 1117 1145 1156 1175 1184 1210 1214 1232 1235 1253 1254 1264 1267 1268 1289 1291 1300 1314 1344 1350 
4 8 44 45 47 70 96 99 100 117 124 132 149 158 189 199 205 250 254 275 291 292 305 316 322 354 359 362 432 455 462 466 471 481 483 488 490 502 514 515 523 543 554 584 598 618 625 626 665 722 784 786 787 790 792 794 798 823 839 840 853 862 916 922 933 935 948 952 954 976 995 1021 1043 1053 1076 1091 1095 1123 1141 1147 1161 1180 1200 1201 1209 1244 1245 1261 1333 
30 35 42 49 50 53 59 64 66 101 151 218 219 234 246 261 280 309 314 350 351 363 413 415 436 457 480 485 504 575 588 621 635 677 678 681 689 724 770 772 777 791 804 810 811 812 813 828 842 847 857 873 888 894 895 949 950 978 997 1006 1026 1027 1033 1039 1040 1086 1092 1097 1111 1153 1182 1187 1192 1197 1205 1224 1260 1281 1292 1310 1315 1316 1340 1341 
12 54 57 62 93 118 144 147 166 168 183 202 213 237 247 248 263 318 373 378 420 431 437 476 478 482 519 530 561 563 566 595 605 641 642 646 685 700 702 719 764 783 821 827 829 830 855 874 880 915 924 926 928 977 987 996 999 1011 1036 1065 1082 1083 1084 1093 1096 1121 1144 1206 1317 1330 1335 
89 90 102 146 187 203 211 217 222 229 230 241 245 262 276 278 287 319 332 345 361 435 440 441 448 449 450 492 505 550 558 560 592 604 622 630 655 735 753 754 836 852 858 882 887 909 921 965 981 1015 1031 1081 1110 1140 1168 1171 1228 1249 1255 1262 1311 
26 55 60 109 162 163 181 192 271 289 296 339 370 380 383 390 403 416 417 418 459 497 527 538 593 612 614 676 696 708 721 731 755 763 774 820 826 848 859 876 911 945 975 984 986 1066 1080 1109 1178 1186 1212 1213 1221 1229 1287 1304 1318 
28 29 51 84 159 232 258 357 368 379 387 451 452 465 479 506 507 520 555 578 579 597 620 632 672 679 680 684 716 717 727 732 734 761 762 776 846 870 877 927 962 963 1000 1019 1024 1114 1146 1155 1164 1169 1176 1269 1276 1279 1288 1298 
38 145 209 210 336 337 411 463 498 509 522 549 568 569 582 611 709 738 739 740 759 782 799 807 808 833 834 883 885 940 956 988 994 1020 1052 1059 1063 1078 1099 1105 1151 1157 1159 1193 1194 1204 1257 1280 1299 1327 1329 1343 
1 13 65 69 75 76 82 83 110 111 153 195 201 285 304 307 308 340 347 365 374 375 396 397 398 414 419 473 474 556 581 652 688 710 795 869 980 1029 1044 1051 1077 
19 23 61 85 86 95 122 134 179 426 427 553 557 559 562 572 590 619 653 658 669 701 742 744 745 778 845 856 866 931 936 942 1001 1007 1061 1100 1142 1195 1231 
77 156 157 185 317 334 372 445 532 576 631 703 746 758 844 868 878 1005 1034 1112 1128 1165 1220 1263 
91 92 177 178 333 343 539 654 682 897 906 907 932 985 991 1045 1246 
265 453 768 769 818 910 917 918 939 1179 1190 1274 1284 
422 586 587 831 837 838 955 1074 1217 1256 1283 1293 1338 
41 58 667 757 802 983 1002 1087 1188 1237 1324 
150 346 864 1118 1150 
