1 6 12 22 34 36 40 58 67 88 119 148 165 169 208 212 220 227 314 315 324 376 381 388 401 412 421 433 464 475 477 491 503 513 516 526 570 573 585 599 600 627 630 686 695 749 765 781 790 792 803 814 832 875 888 908 957 988 1058 1078 1097 1106 1129 1149 1240 1261 1271 1273 1294 1307 1308 1332 1348 
0 10 44 47 100 131 149 160 243 265 275 291 292 295 358 359 432 461 462 466 471 490 514 523 541 543 608 618 626 665 673 674 683 701 722 784 794 841 916 933 938 948 952 954 976 1021 1043 1053 1064 1091 1122 1123 1141 1147 1196 1200 1216 1233 1333 1349 
48 105 127 128 137 170 171 191 264 393 407 408 446 460 486 487 542 564 571 584 616 623 624 656 691 692 715 775 809 966 969 1107 1108 1124 1135 1177 1234 1241 1272 1290 1302 1306 
14 15 109 115 267 326 565 596 611 646 647 743 826 868 913 968 1004 1025 1050 1090 1112 1134 1230 1236 1242 1259 1263 1303 1326 1335 
52 56 125 126 268 290 293 294 434 442 495 640 697 941 971 992 1023 1048 1117 1210 1253 
57 72 93 144 248 263 318 378 420 476 530 563 566 821 855 915 987 1170 1206 1289 1317 
154 225 226 299 300 328 386 387 537 601 903 1003 1014 1016 1055 1056 1057 1169 1258 1319 
479 509 510 555 727 739 740 799 833 834 854 1059 1150 1151 1152 1157 1257 1299 1343 
5 33 45 70 97 133 158 244 254 301 302 454 497 747 748 892 944 1312 
75 83 111 132 285 304 307 347 375 397 569 595 625 652 688 795 1044 
29 217 232 482 641 642 734 830 924 927 928 1019 1084 1092 1144 1176 
71 769 777 873 939 1033 1088 1089 1153 1190 1262 1274 1284 1292 1316 
49 50 241 261 350 413 588 810 812 842 1040 1086 1197 1260 
198 270 297 298 335 341 533 535 536 871 958 973 1148 1301 
2 106 110 175 176 233 260 348 512 771 819 1270 1275 
9 203 211 229 262 435 440 441 492 622 753 783 981 
38 145 210 312 521 522 690 738 789 1052 1063 1105 1163 
157 317 334 576 593 612 631 703 746 844 878 911 1128 
193 377 402 456 791 881 923 925 934 972 1030 1049 1156 
214 392 451 494 589 594 744 761 800 967 1042 1276 
345 353 426 590 637 658 669 778 845 856 936 1142 
13 20 112 195 200 204 205 255 511 1201 1325 
27 288 305 354 362 380 458 474 676 721 773 
107 108 156 164 196 228 389 531 733 905 982 
129 130 591 606 638 780 891 1035 1173 1238 1239 
31 46 189 425 528 634 718 899 953 970 
32 405 613 713 919 1018 1062 1115 1254 1278 
91 92 343 559 654 682 906 907 1045 1246 
99 199 628 629 711 712 805 806 1158 1336 
28 62 465 735 896 990 1001 1286 1330 
96 493 661 662 847 989 1101 1136 1209 
141 238 428 496 534 552 801 943 1247 
7 73 74 329 484 545 865 900 
18 123 152 174 221 447 867 946 
54 147 166 880 1065 1082 1083 1093 
113 114 322 525 653 752 1139 1222 
117 253 372 445 755 931 1005 1034 
124 155 319 320 365 502 766 980 
396 556 578 581 582 707 710 1159 
11 547 607 694 741 1145 1179 
23 352 817 1195 1300 1315 1331 
26 459 848 859 917 918 1304 
68 140 670 726 815 1022 1214 
89 90 222 278 1110 1140 1311 
162 163 418 538 708 763 820 
178 788 1076 1098 1161 1237 1295 
246 681 811 813 857 1182 1281 
266 404 651 723 843 996 1013 
357 384 478 579 632 1114 1256 
436 485 689 894 895 1006 1039 
827 864 962 998 1154 1167 1321 
850 851 863 1073 1109 1113 1133 
893 1181 1207 1218 1219 1223 1328 
3 76 369 382 1183 1265 
8 839 840 853 862 935 
42 64 218 234 309 457 
60 332 390 417 527 614 
63 342 872 1037 1189 1248 
81 284 488 886 995 1131 
84 672 874 876 877 1011 
94 272 356 360 415 650 
120 816 1160 1171 1244 1245 
151 772 949 950 1111 1255 
186 240 273 385 860 929 
188 224 313 437 1068 1208 
206 499 714 796 797 947 
239 602 649 767 1277 1345 
310 311 483 655 882 1031 
336 337 411 759 887 1329 
371 636 698 984 1104 1342 
374 519 702 926 1074 1096 
399 505 974 1172 1227 1228 
468 617 736 861 1137 1138 
677 678 750 776 828 1346 
849 1166 1175 1229 1232 1350 
1009 1010 1185 1191 1296 1297 
17 39 469 470 1291 
21 207 279 901 1143 
24 242 277 517 671 
30 978 1187 1205 1310 
61 427 619 742 1100 
103 104 197 472 904 
116 1070 1071 1203 1266 
153 201 549 869 1051 
167 615 699 951 1103 
168 202 409 558 561 
172 271 429 693 961 
184 709 1069 1130 1204 
185 666 964 1165 1199 
187 276 560 754 852 
219 269 443 508 1075 
258 963 1269 1279 1298 
283 529 664 922 930 
327 349 379 798 1094 
330 331 518 920 1184 
406 824 912 1119 1120 
422 587 831 955 1338 
453 768 818 910 1066 
500 515 524 1243 1351 
679 680 1155 1164 1288 
4 394 889 1079 
16 138 836 986 
19 179 553 562 
25 121 306 467 
37 303 367 544 
41 757 1002 1087 
59 575 635 724 
69 308 340 419 
78 274 879 1235 
79 235 574 580 
87 161 645 1320 
101 480 621 770 
139 1026 1027 1116 
142 223 1067 1347 
177 333 985 991 
180 190 215 756 
182 282 725 1225 
216 355 937 1282 
230 449 450 921 
237 539 897 932 
245 361 604 909 
249 643 644 728 
281 391 835 914 
289 403 945 1213 
296 383 554 1178 
366 410 504 898 
370 463 940 994 
430 705 890 1072 
501 633 960 1041 
557 866 1007 1061 
568 731 774 1212 
586 837 838 1283 
620 716 717 846 
758 1220 1221 1287 
1012 1102 1125 1162 
43 730 993 
51 597 1146 
53 192 975 
55 181 1186 
65 732 1029 
66 280 1192 
80 173 1054 
85 86 942 
95 122 745 
98 1080 1318 
135 325 1305 
136 414 473 
146 250 1168 
194 657 1231 
209 782 808 
213 452 605 
231 507 1224 
236 663 675 
247 999 1036 
252 438 979 
257 338 548 
286 498 807 
316 572 639 
321 489 546 
339 416 696 
346 825 1314 
368 520 1024 
423 439 1028 
424 506 956 
540 1226 1285 
550 551 648 
567 785 1211 
659 660 1354 
667 802 983 
684 729 1215 
685 829 1121 
700 719 720 
706 1264 1344 
1008 1032 1252 
1046 1085 1202 
