0 6 7 22 34 36 40 58 73 74 81 88 112 119 120 148 154 165 169 180 184 190 208 212 220 225 226 227 239 255 272 277 299 300 315 320 324 328 329 357 360 364 369 376 381 382 384 386 388 401 412 421 433 464 468 473 475 477 484 503 513 516 521 524 526 537 545 573 574 585 599 600 601 602 617 627 628 629 647 663 667 674 686 690 695 711 712 729 736 749 750 781 788 790 803 805 806 816 832 850 851 863 865 875 886 888 900 903 908 936 957 962 963 1003 1014 1016 1050 1056 1057 1058 1069 1073 1095 1097 1106 1113 1125 1129 1130 1131 1133 1134 1137 1138 1149 1158 1160 1162 1180 1196 1215 1236 1237 1240 1243 1247 1249 1258 1264 1269 1273 1294 1319 1324 1326 1332 1336 1346 1348 1351 
10 27 31 46 48 56 71 72 105 106 127 128 137 140 141 142 143 167 170 171 176 188 191 206 214 223 224 231 233 236 244 260 264 268 281 295 312 313 348 366 391 393 394 395 400 408 409 410 425 434 446 460 461 486 487 496 499 500 512 528 542 552 561 564 571 589 616 623 624 634 656 673 675 683 692 714 715 718 723 726 748 773 775 796 797 800 801 804 809 835 884 889 892 898 899 938 943 946 947 953 966 969 970 997 1021 1042 1060 1064 1067 1068 1079 1107 1108 1122 1124 1135 1170 1177 1208 1233 1234 1241 1271 1272 1275 1277 1290 1302 1306 1310 1313 1337 1339 1347 1349 
2 24 25 32 38 39 52 68 91 92 121 126 136 175 193 194 232 242 258 290 293 294 306 321 330 331 343 377 402 414 442 452 456 467 469 470 479 489 495 517 518 522 546 613 640 654 657 670 679 682 684 697 713 738 771 819 833 834 881 906 907 919 920 923 925 934 971 972 992 1018 1022 1023 1030 1045 1048 1049 1062 1072 1093 1099 1115 1117 1145 1151 1156 1184 1210 1214 1231 1232 1246 1253 1254 1257 1267 1268 1279 1280 1298 1350 
4 8 30 33 44 45 70 97 98 99 100 117 124 129 130 149 160 199 238 243 254 275 291 292 301 302 316 358 359 423 432 439 454 462 466 471 481 483 490 491 502 514 515 523 539 543 554 577 598 618 626 665 722 784 792 794 823 839 840 853 862 897 916 922 932 933 935 944 948 952 954 976 978 988 1008 1028 1032 1043 1053 1076 1091 1123 1141 1147 1161 1187 1200 1205 1238 1239 1244 1245 1252 1261 1333 
3 80 107 108 113 114 139 158 164 173 196 198 216 228 257 266 270 284 297 298 335 338 341 399 404 424 458 525 531 533 535 536 548 591 594 603 606 638 651 653 668 706 707 733 737 752 758 760 780 814 841 843 854 871 891 896 902 937 958 959 960 967 973 974 982 990 1009 1010 1012 1013 1017 1035 1047 1055 1098 1102 1116 1132 1148 1172 1173 1183 1185 1191 1222 1227 1248 1282 1295 1301 1344 
16 17 78 103 104 138 145 197 240 251 273 274 336 337 405 411 472 568 609 610 611 661 662 709 720 739 740 759 789 883 885 904 905 929 956 986 989 1059 1078 1101 1157 1204 1221 1235 1287 1291 1299 1327 1329 1343 
13 20 59 79 82 83 96 111 132 155 200 205 235 250 288 323 342 354 392 396 398 488 493 504 511 540 541 570 575 580 583 625 635 724 786 787 815 995 1077 1136 1139 1198 1201 1209 1226 1278 1285 1325 
18 123 135 146 150 152 172 174 204 221 230 256 287 325 346 363 406 407 429 430 447 680 687 693 705 765 824 858 864 867 890 912 961 998 1118 1119 1120 1150 1154 1167 1168 1175 1305 1307 1308 1321 
5 26 55 60 67 133 162 163 181 189 271 289 305 322 362 390 403 417 418 459 497 527 538 614 708 719 731 747 755 763 774 820 848 859 879 945 1066 1080 1186 1212 1213 1229 1304 1318 
9 102 125 187 203 211 217 229 241 262 276 310 311 319 332 345 435 440 441 449 450 492 505 550 558 560 592 622 630 655 735 753 754 766 836 852 882 887 921 965 981 1031 1171 1228 
12 54 57 93 118 144 147 166 202 213 237 248 263 318 378 389 420 431 437 476 478 530 563 566 595 605 764 783 821 827 855 880 915 941 977 987 996 1065 1082 1083 1206 1289 1300 1317 
19 23 61 85 86 95 122 134 179 426 427 553 557 559 562 572 590 619 658 669 701 742 744 745 778 845 856 866 931 942 1001 1007 1061 1100 1142 1195 1203 1286 
49 50 53 218 219 261 350 385 413 588 677 678 777 812 828 842 860 873 1026 1027 1033 1040 1086 1088 1092 1153 1197 1224 1225 1260 1262 1292 1316 1340 1341 
182 186 253 282 283 371 428 444 529 534 551 584 636 648 664 666 698 725 782 793 810 822 914 930 964 1046 1054 1085 1104 1163 1199 1202 1342 
14 15 109 115 116 267 326 565 567 596 608 743 785 826 876 913 968 1004 1025 1070 1071 1090 1152 1211 1230 1242 1259 1266 1303 1309 1334 
1 65 69 75 153 195 201 249 285 307 308 340 347 397 419 556 569 581 643 644 688 710 728 732 795 869 1029 
11 76 110 365 368 379 387 474 506 520 547 607 620 694 717 741 767 776 846 1024 1051 1089 1169 1345 
37 47 87 161 303 327 349 352 353 355 367 510 544 637 645 798 817 980 1094 1320 1322 1323 1331 
42 64 89 90 94 222 234 245 278 309 361 415 457 604 650 861 909 1081 1110 1140 1270 1311 1315 
62 84 451 507 509 555 578 579 632 646 672 727 761 762 799 870 874 877 1011 1114 1276 1330 1335 
131 209 210 247 286 463 498 549 582 691 807 808 940 994 999 1020 1036 1052 1063 1105 1159 1193 1194 
66 101 151 280 304 314 374 375 480 621 652 716 770 772 813 847 949 950 1044 1111 1192 1255 
28 29 159 192 339 370 380 416 465 676 696 721 734 927 975 984 1000 1019 1155 1176 1288 
51 259 269 356 443 597 649 751 893 1038 1075 1146 1181 1207 1218 1219 1223 1312 1328 
156 157 185 494 501 576 593 612 633 791 878 911 1041 1109 1128 1164 1165 
77 317 334 372 445 455 532 631 703 746 844 868 1005 1034 1112 1263 
43 63 252 344 438 730 849 872 979 993 1037 1166 1189 1265 
183 373 436 485 519 689 700 702 894 895 926 1006 1039 1096 
265 453 768 769 818 910 917 918 939 1179 1190 1274 1284 
422 586 587 831 837 838 955 1074 1217 1256 1283 1293 1338 
35 177 178 333 351 659 660 985 991 1216 1220 1354 
168 482 641 642 685 829 830 924 928 1084 1121 1144 
215 246 296 383 508 681 756 811 857 1178 1182 1281 
21 207 279 448 901 1015 1143 
41 757 802 983 1002 1087 1188 
615 639 699 951 1103 
671 704 779 825 1314 
