0 4 8 9 10 18 21 30 31 33 44 45 46 47 48 56 57 65 70 96 97 98 100 105 123 127 128 131 135 137 140 141 152 158 160 167 170 171 172 189 190 191 206 207 211 215 221 231 233 238 239 243 244 249 254 264 265 268 271 275 279 291 295 301 302 312 358 359 391 393 394 395 398 407 408 423 425 429 432 439 446 453 454 460 461 462 466 471 486 487 490 496 499 507 512 521 523 528 534 542 543 552 554 564 567 571 608 616 618 622 623 624 626 634 643 644 649 656 659 660 665 673 674 683 687 691 692 693 714 715 718 722 728 747 756 765 775 784 785 789 790 794 796 797 801 802 809 818 839 840 841 862 867 889 892 901 910 912 916 933 935 938 943 944 946 947 948 952 953 954 966 969 970 976 978 1021 1028 1029 1043 1053 1064 1079 1091 1095 1105 1107 1108 1122 1123 1124 1135 1141 1143 1147 1163 1177 1178 1180 1187 1196 1200 1205 1209 1216 1233 1234 1241 1247 1252 1272 1277 1290 1302 1306 1310 1312 1333 1349 1354 
1 6 7 12 22 27 34 36 40 58 62 73 74 88 119 129 130 139 148 149 153 154 165 169 184 201 208 210 220 225 226 227 245 292 299 300 315 321 324 325 328 329 376 381 386 401 412 421 433 464 475 477 489 491 503 513 516 526 537 541 545 546 570 573 585 586 591 600 601 606 607 611 627 630 686 695 709 726 729 749 773 780 781 792 814 832 837 838 854 865 869 875 891 899 900 903 908 957 962 963 988 1001 1003 1009 1010 1011 1014 1016 1026 1027 1035 1047 1051 1056 1057 1058 1063 1069 1078 1081 1106 1116 1125 1129 1130 1157 1162 1173 1185 1191 1204 1215 1238 1239 1240 1258 1261 1269 1271 1273 1283 1294 1296 1297 1307 1308 1319 1330 1332 1335 1348 
13 19 20 23 25 37 43 53 61 63 66 69 85 86 87 89 90 94 112 118 124 134 159 161 179 180 192 195 200 204 205 216 219 222 252 255 269 272 278 280 303 304 306 308 319 320 327 339 340 342 344 349 352 355 360 361 365 367 415 416 419 427 435 438 440 467 502 504 508 511 544 550 553 562 577 604 619 645 650 696 701 725 730 742 744 766 798 824 827 847 864 872 884 888 898 909 937 942 975 977 979 981 993 998 1000 1007 1037 1046 1061 1070 1075 1085 1094 1097 1100 1110 1119 1120 1140 1154 1167 1189 1192 1195 1198 1201 1202 1217 1222 1248 1282 1300 1311 1315 1320 1321 1325 1331 
41 80 102 103 104 107 108 113 114 168 173 182 185 186 198 199 203 209 214 228 240 247 251 257 270 273 282 297 298 322 335 336 337 338 357 371 385 389 392 399 404 409 411 451 472 492 505 525 531 533 548 551 558 561 589 594 603 615 636 638 648 651 653 666 667 668 685 698 707 723 733 737 752 757 759 761 762 782 793 800 822 829 843 860 874 879 883 887 902 904 929 958 959 964 967 973 974 982 983 984 996 999 1002 1013 1017 1036 1042 1054 1055 1059 1087 1103 1104 1121 1172 1188 1199 1211 1228 1276 1324 1327 1329 1342 
2 3 28 29 35 49 50 71 76 177 178 229 237 241 261 283 333 350 351 369 379 382 413 424 441 455 456 465 481 506 529 539 588 592 664 732 735 753 769 777 788 791 810 812 823 842 853 873 897 922 925 927 930 932 956 972 985 991 1033 1040 1076 1086 1088 1089 1092 1098 1132 1153 1176 1183 1190 1197 1237 1253 1260 1262 1265 1267 1268 1274 1284 1292 1295 1316 1340 1341 
11 51 84 95 101 142 143 151 223 246 286 314 330 331 363 364 368 384 387 463 480 484 514 518 520 547 555 579 597 620 632 672 677 678 681 694 706 716 717 741 750 767 770 772 776 807 808 811 813 819 828 846 857 877 920 939 940 949 950 994 1020 1024 1067 1111 1114 1139 1145 1146 1149 1179 1182 1184 1255 1256 1264 1281 1337 1344 1345 1346 1347 
17 32 38 39 68 164 193 194 217 232 236 370 377 402 405 469 470 482 501 522 593 612 613 621 641 642 657 663 670 675 679 680 713 734 738 815 830 833 834 881 911 919 923 924 928 934 960 1018 1019 1022 1030 1041 1049 1052 1062 1084 1099 1109 1115 1144 1150 1151 1155 1156 1164 1165 1206 1214 1225 1231 1254 1257 1278 1280 1288 1305 
54 72 93 144 147 166 187 202 230 248 263 276 318 353 378 420 431 436 447 449 450 476 478 485 509 510 530 540 560 563 566 602 637 689 739 754 764 783 799 821 852 855 866 880 886 894 895 915 921 980 987 1006 1031 1039 1065 1082 1083 1093 1168 1170 1226 1227 1285 1289 1299 1317 1322 1323 1343 
14 15 91 92 106 109 110 115 116 145 175 176 188 224 260 266 267 313 326 343 348 414 437 559 565 596 646 647 654 682 699 743 771 826 876 896 906 907 913 914 968 990 1004 1025 1045 1068 1071 1090 1134 1203 1208 1230 1236 1242 1246 1259 1266 1270 1275 1286 1303 1309 1313 1326 1334 1339 
5 75 81 82 83 111 132 136 155 218 256 259 284 285 288 296 305 307 347 354 362 375 380 383 396 397 458 473 474 488 556 557 569 578 581 582 584 595 598 625 652 676 688 710 721 748 786 787 795 995 1038 1044 1050 1060 1077 1131 1159 
52 77 125 126 156 157 174 196 197 290 293 294 317 334 356 400 434 442 443 495 532 576 631 640 697 703 727 746 751 758 760 844 868 878 893 905 941 951 961 971 992 1023 1048 1112 1117 1128 1181 1207 1210 1218 1219 1220 1223 1263 1287 1293 1328 
24 117 121 122 138 150 183 242 253 262 277 316 345 346 372 373 374 426 445 517 519 572 590 639 658 669 671 700 702 704 719 720 745 755 768 778 779 825 835 845 856 917 918 926 931 936 1005 1008 1032 1034 1066 1074 1096 1118 1142 1314 
26 55 60 67 146 162 163 181 213 250 281 287 289 310 311 332 390 403 417 418 428 444 448 452 459 483 497 527 538 568 605 655 708 731 740 763 774 820 848 858 859 870 882 885 945 965 1015 1080 1152 1161 1186 1212 1213 1249 1304 1318 
16 78 258 274 309 341 422 479 493 494 498 535 536 549 587 609 610 614 633 661 662 684 690 817 831 836 871 955 986 989 1012 1101 1102 1136 1148 1169 1221 1235 1279 1298 1301 1338 
99 120 133 468 500 515 524 617 628 629 711 712 736 805 806 816 849 851 861 863 1073 1113 1133 1137 1138 1158 1160 1166 1171 1175 1193 1194 1224 1229 1232 1243 1244 1245 1336 1350 1351 
42 59 64 79 212 234 235 323 366 388 406 410 430 457 574 575 580 583 599 635 705 724 803 804 850 890 997 1072 1291 
