1 12 13 15 22 23 31 32 34 36 37 40 42 43 44 53 55 59 63 64 66 79 83 86 87 89 93 94 111 148 149 153 174 178 189 195 208 212 220 224 234 235 238 245 250 255 257 258 269 277 278 285 296 303 304 305 306 307 308 309 320 322 325 327 339 340 341 347 349 350 353 354 355 360 361 362 374 375 381 388 392 394 403 406 414 421 422 430 438 467 468 475 501 502 503 514 515 516 526 535 573 588 594 599 608 619 626 627 631 649 669 688 696 736 743 758 765 770 781 787 793 821 845 867 871 872 875 877 899 909 936 943 948 953 955 970 979 995 997 998 1024 1029 1037 1040 1066 1071 1102 1106 1125 1147 1148 1154 1162 1172 1178 1187 1193 1198 1205 1213 1247 1260 1265 1266 1271 1272 1273 1301 1307 1308 1309 1332 1334 1348 
28 48 56 57 61 62 96 103 106 115 131 162 176 188 191 237 248 260 264 272 317 318 348 376 377 393 416 419 426 437 445 460 465 512 542 552 566 584 595 600 624 646 647 648 656 673 710 715 721 723 742 803 805 806 809 823 827 868 874 876 884 885 890 896 915 969 974 987 990 996 1001 1004 1011 1034 1060 1068 1100 1112 1124 1134 1135 1142 1170 1177 1194 1206 1208 1209 1223 1233 1234 1241 1246 1259 1263 1270 1275 1277 1286 1290 1302 1306 1310 1313 1326 1328 1330 1335 1336 1339 
0 19 67 68 69 101 104 118 122 140 146 164 166 167 179 190 251 275 287 293 324 338 356 358 367 383 391 395 400 423 427 439 440 463 470 485 498 499 520 548 549 557 572 582 583 604 609 640 652 680 682 691 697 726 786 800 835 893 906 907 908 957 971 978 1039 1044 1045 1117 1145 1159 1164 1168 1220 1253 1267 1268 1331 
3 41 80 82 98 154 215 216 225 229 230 252 253 283 286 299 310 311 369 382 384 385 386 387 459 476 493 494 522 558 561 562 590 650 654 655 658 744 749 750 756 774 795 843 858 864 866 883 894 895 967 986 991 1003 1007 1036 1054 1056 1080 1085 1088 1089 1103 1169 1214 1258 1281 1346 
27 60 100 181 182 185 271 290 312 313 331 333 372 405 469 472 511 521 524 543 547 551 586 587 605 637 666 683 690 731 747 755 778 789 822 849 855 916 917 918 938 941 965 975 1005 1016 1053 1121 1123 1128 1140 1163 1165 1179 1200 1212 1217 1225 1229 1256 1289 1293 1300 1322 1323 1351 
20 47 54 65 70 88 92 112 124 135 147 155 169 194 204 226 249 256 263 298 321 379 380 471 559 570 581 589 601 615 636 644 681 711 732 798 804 808 811 812 825 848 857 879 880 980 984 1000 1014 1065 1067 1082 1083 1093 1094 1099 1104 1114 1158 1176 1182 1189 1305 1325 1342 
14 107 139 175 187 233 267 281 282 295 326 330 336 337 370 396 517 518 565 569 591 611 638 639 676 699 709 733 737 759 764 819 913 914 919 920 937 968 1009 1010 1017 1018 1023 1025 1026 1028 1046 1050 1090 1116 1185 1191 1204 1230 1236 1280 1296 1297 1303 1329 
5 26 30 33 38 108 126 133 145 158 172 173 180 210 288 301 302 352 368 429 436 454 461 532 577 579 580 598 687 693 784 802 817 841 944 951 983 985 992 1020 1052 1063 1073 1175 1243 1278 1279 
45 71 72 120 129 130 254 261 378 413 446 482 483 495 496 497 622 641 642 724 746 748 752 763 815 829 830 842 891 892 924 928 1027 1062 1070 1084 1105 1144 1160 1167 1173 1210 1224 1239 
7 110 138 152 163 265 294 316 389 390 397 407 417 418 447 474 523 530 539 556 665 670 704 707 728 757 773 794 818 820 910 932 933 945 1136 1181 1184 1186 1218 1219 1312 
102 150 240 241 273 274 492 507 509 510 555 708 725 739 740 771 799 833 834 854 929 956 994 1012 1013 1059 1078 1115 1150 1151 1152 1155 1157 1235 1238 1254 1257 1288 1299 1343 
46 121 134 141 160 231 232 268 323 402 409 425 428 434 456 505 527 528 545 633 634 653 672 679 712 718 735 782 839 840 923 925 931 1030 1049 1096 1231 1318 
77 78 113 114 142 143 144 159 276 342 359 458 525 563 576 606 661 662 738 760 772 836 926 960 966 989 993 1101 1111 1132 1138 1221 1222 1282 1287 1337 
9 10 11 76 125 165 206 207 222 279 366 442 448 500 504 607 630 694 719 797 814 816 850 851 863 878 889 940 946 947 1079 1156 
50 84 85 90 201 219 292 300 412 443 473 506 531 574 575 617 618 702 767 942 962 963 1075 1110 1133 1269 1294 1311 1314 1321 1345 
6 35 99 177 198 199 205 209 246 247 270 297 314 335 424 519 533 585 663 686 689 813 900 959 973 1188 1201 1324 1327 1338 
18 117 365 401 408 431 432 450 546 553 571 596 597 659 674 701 713 714 722 788 905 921 964 1043 1051 1098 1161 1196 1242 1295 
351 529 620 621 645 664 695 716 717 730 831 832 902 903 930 950 952 954 977 988 999 1015 1047 1057 1076 1091 1228 
17 203 211 217 243 262 319 332 334 345 435 441 449 491 550 560 592 753 754 766 783 852 934 981 1061 1291 
29 73 186 196 266 404 444 534 554 614 651 671 734 810 927 1019 1042 1055 1077 1086 1207 1304 
75 81 128 137 168 171 202 284 357 464 477 478 486 564 616 623 632 692 1058 1107 1129 1248 
105 116 291 346 398 455 466 490 741 775 792 844 922 1081 1137 1203 1244 1245 1261 1262 1292 1333 
24 25 91 213 214 328 452 480 536 537 610 657 684 685 729 856 1215 1232 1298 1319 1350 
16 119 132 218 259 415 457 488 489 568 625 635 779 780 861 1033 1035 1041 1118 1315 
51 52 221 227 228 315 643 790 837 838 949 961 1006 1048 1087 1095 1146 1180 1199 1283 
156 157 197 236 371 593 612 698 791 904 911 982 1021 1122 1141 1197 1349 
74 123 479 613 727 860 862 873 881 976 1002 1153 1171 1316 1340 1341 
242 508 544 567 677 678 777 785 796 824 828 912 1119 1120 1211 
2 21 49 451 578 603 761 762 870 901 1143 1166 1183 1276 
8 289 364 399 420 513 628 720 1022 1064 1149 1227 1240 
540 541 705 706 882 886 887 1031 1131 1226 1264 1285 1344 
39 136 192 193 223 411 700 972 1072 1074 1108 1347 
58 95 200 329 484 667 703 745 865 1139 1237 1249 
280 433 776 846 847 853 859 888 935 1097 1192 1317 
183 184 373 660 1008 1092 1130 1216 1252 1354 
127 629 801 807 869 898 1038 1202 
109 151 487 826 1109 1113 1255 
161 239 602 897 958 1069 1320 
453 768 769 939 1190 1274 1284 
4 97 244 410 1032 1195 
343 344 481 538 675 751 
170 363 462 668 
