12 13 15 22 23 32 34 36 37 40 42 43 44 53 59 63 66 79 83 86 87 89 93 94 111 148 149 153 174 178 189 195 208 212 220 224 234 235 238 245 250 255 257 258 269 277 278 285 296 303 305 306 307 308 309 320 322 327 339 340 341 349 350 353 354 355 360 361 362 374 375 381 388 392 394 403 406 414 421 422 438 467 468 475 501 502 503 514 515 516 526 535 573 588 594 599 608 619 626 627 631 649 669 696 736 743 758 765 781 787 793 845 867 871 872 875 877 909 936 948 955 979 995 997 1037 1040 1071 1102 1106 1125 1147 1148 1162 1172 1178 1187 1193 1198 1247 1260 1265 1266 1273 1301 1307 1308 1332 1348 
48 56 103 162 191 348 393 460 542 595 600 624 648 656 673 715 723 742 803 809 827 890 969 996 1060 1124 1135 1170 1177 1208 1223 1233 1234 1290 1302 1306 1328 
20 65 70 88 112 124 135 155 204 256 263 321 379 380 570 581 589 601 615 636 711 732 804 825 980 984 1094 1104 1114 1158 1305 1325 1342 
19 101 118 122 140 164 166 167 179 324 391 395 400 423 427 439 470 485 499 520 572 652 726 800 835 906 907 957 1044 1045 
0 68 104 275 293 338 356 367 383 440 498 548 549 557 582 583 604 609 640 893 971 978 1039 1145 1159 
5 30 33 126 133 180 288 301 302 368 436 454 461 577 687 802 841 944 983 985 1175 
203 211 217 262 319 332 334 345 435 441 491 550 560 753 754 766 783 852 934 981 
57 237 248 272 317 318 426 437 445 566 710 915 987 1034 1142 1194 1241 1310 
28 61 62 96 465 646 874 876 896 990 1001 1011 1100 1209 1286 1330 
46 141 268 409 425 428 434 527 528 545 634 718 839 840 931 1096 
3 299 369 384 385 650 749 750 843 883 1003 1088 1089 1258 1346 
14 107 187 336 337 396 565 611 709 733 759 913 1204 1236 1329 
129 130 254 482 483 641 642 829 830 924 928 1084 1105 1144 1239 
16 119 132 488 489 568 625 635 779 780 1033 1035 1041 1118 
25 91 213 214 328 536 537 610 684 685 729 1215 1298 1319 
10 11 206 207 222 448 500 607 694 889 946 947 1079 
45 120 378 496 622 746 752 763 815 1062 1160 1173 1210 
106 176 188 260 419 512 552 974 1068 1270 1275 1277 
128 137 171 357 478 486 564 616 623 632 692 1107 
294 389 417 418 539 704 707 820 932 933 945 1186 
401 408 431 432 450 674 701 722 921 964 1043 1196 
620 621 695 716 717 730 831 832 950 1015 1057 1228 
29 186 444 534 671 734 810 927 1019 1086 1304 
47 147 298 471 798 808 879 880 1065 1082 1083 
84 85 201 300 412 473 506 531 702 942 1321 
31 64 770 899 943 953 970 1205 1213 1271 
51 221 227 228 961 1006 1048 1087 1146 1199 
69 146 190 287 358 682 786 908 1168 1220 
76 165 279 442 630 814 816 863 878 940 
152 407 523 665 757 794 1181 1218 1219 1312 
280 433 776 846 847 859 888 1097 1192 1317 
2 21 451 761 901 1143 1166 1183 1276 
102 510 739 740 956 1059 1078 1157 1299 
115 868 1004 1112 1134 1246 1259 1263 1336 
281 282 326 591 638 737 914 1023 1046 
18 546 713 714 788 905 1098 1295 
26 158 173 579 951 992 1020 1243 
77 78 142 661 662 738 989 1101 
139 295 370 676 764 937 1026 1116 
156 157 593 612 791 911 982 1197 
160 323 402 653 712 925 1030 1049 
181 185 524 683 755 849 1229 1351 
183 184 373 660 1092 1130 1216 1354 
261 413 495 724 842 1027 1070 1167 
351 902 903 954 988 1047 1076 1091 
509 555 799 833 834 1150 1151 1257 
7 110 397 474 728 773 1136 
24 452 480 657 856 1232 1350 
35 314 519 585 663 686 689 
50 574 617 618 1133 1294 1314 
58 200 329 484 667 1139 1237 
75 81 284 464 477 1129 1248 
105 116 466 490 775 1203 1333 
215 252 558 756 894 895 1036 
240 273 274 929 1155 1235 1288 
249 644 681 811 812 857 1189 
291 346 792 922 1244 1245 1261 
459 493 494 590 658 744 967 
469 511 521 789 941 1289 1300 
529 645 664 930 952 977 999 
860 862 873 881 976 1153 1316 
6 209 246 247 813 900 
27 60 100 271 747 778 
73 266 404 651 1055 1077 
113 114 458 525 760 1222 
154 225 386 387 1056 1169 
198 270 297 335 533 973 
218 259 415 457 861 1315 
236 371 698 1122 1141 1349 
267 968 1025 1090 1230 1303 
310 311 562 654 655 774 
567 677 678 777 785 828 
1009 1010 1185 1191 1296 1297 
1 347 430 688 1029 
38 145 210 1052 1063 
39 223 1072 1108 1347 
80 230 286 476 858 
108 352 532 784 817 
172 429 598 693 1073 
175 233 330 517 819 
216 229 253 283 1103 
290 331 605 975 1005 
472 547 917 918 1179 
586 587 1217 1256 1293 
647 805 806 1326 1335 
705 706 882 887 1031 
796 824 912 1119 1120 
71 72 497 748 
74 123 727 1002 
97 244 410 1032 
127 869 898 1038 
136 193 972 1074 
151 1109 1113 1255 
159 342 926 1138 
205 1201 1327 1338 
231 232 633 679 
239 602 958 1069 
241 492 1013 1152 
242 508 544 1211 
264 416 721 823 
292 575 767 1345 
312 313 690 938 
333 405 822 1016 
343 344 481 751 
365 659 1051 1161 
372 551 666 965 
382 561 991 1281 
390 447 530 556 
446 891 892 1224 
453 768 1274 1284 
463 691 697 1117 
540 541 1226 1285 
543 1053 1123 1200 
571 596 597 1242 
629 801 807 1202 
680 1164 1253 1331 
8 289 1022 
17 243 1291 
41 522 1214 
49 603 762 
54 848 1182 
55 325 1066 
82 866 1007 
90 1110 1311 
92 559 1099 
95 703 745 
98 986 1080 
109 487 826 
134 735 1231 
138 670 1184 
144 563 606 
161 897 1320 
168 202 1058 
169 226 1067 
177 424 959 
182 1163 1225 
192 411 700 
196 554 1042 
197 904 1021 
219 443 1075 
265 818 910 
304 821 1272 
315 643 790 
359 966 993 
364 420 513 
376 377 584 
398 844 1137 
399 1064 1227 
449 592 1061 
456 505 923 
479 613 1171 
518 920 1018 
576 772 1111 
580 1278 1279 
637 1121 1140 
639 699 1028 
731 916 1212 
769 939 1190 
771 854 1012 
797 850 851 
837 838 1283 
855 1128 1165 
919 1017 1280 
960 1132 1282 
962 963 1269 
998 1024 1154 
1000 1014 1176 
1081 1262 1292 
1115 1254 1343 
