31 46 48 56 57 105 118 127 128 137 140 141 167 170 171 189 191 206 207 233 238 264 275 281 391 393 407 409 446 460 486 487 496 499 512 528 534 542 564 571 616 623 624 634 645 656 691 692 714 715 718 726 775 785 796 797 801 809 839 840 862 867 884 899 935 943 946 947 953 966 969 970 977 1021 1042 1079 1107 1108 1124 1135 1177 1234 1241 1247 1272 1290 1302 1306 
1 18 44 47 65 100 123 131 147 152 160 190 215 221 237 239 243 265 291 295 343 358 359 394 425 432 439 462 466 471 490 523 539 543 552 608 618 626 654 665 756 784 790 794 818 841 880 897 906 907 916 932 933 948 952 954 976 1011 1029 1043 1045 1053 1065 1083 1091 1110 1123 1141 1147 1200 1233 1246 1252 1277 1333 
8 54 72 93 144 145 202 211 248 263 318 319 378 384 420 435 476 478 509 510 530 555 558 563 566 579 602 632 689 739 766 783 799 821 855 866 914 915 980 987 1031 1082 1114 1146 1184 1256 1289 1299 1317 1343 
5 27 82 83 88 97 155 259 285 288 296 304 320 347 354 356 383 396 397 441 458 473 474 556 557 578 581 582 595 625 652 688 710 748 753 773 795 1038 1077 1159 
14 15 109 115 267 326 565 596 611 646 647 743 826 913 968 1025 1090 1134 1230 1236 1242 1259 1303 1326 1335 
154 225 299 300 312 328 386 521 537 600 601 690 729 789 903 1003 1014 1016 1056 1057 1163 1215 1258 1319 
217 232 482 641 642 679 680 734 830 924 928 1019 1084 1144 1155 1164 1165 1288 1305 
12 22 36 40 208 212 220 360 381 412 421 573 627 724 803 1081 1262 1271 
6 148 149 376 401 475 503 526 585 607 686 749 781 875 1106 1273 1348 
9 21 33 98 279 301 302 310 311 423 453 454 901 910 944 1028 1143 
49 50 81 218 284 350 488 588 598 676 812 886 995 1086 1131 1260 
106 110 175 176 188 224 260 313 330 348 437 771 1068 1208 1270 1275 
125 126 268 290 293 294 400 434 495 640 697 941 971 1023 1117 1210 
32 38 405 522 613 713 919 1018 1052 1062 1115 1254 1278 1280 
182 185 186 209 371 636 666 698 782 964 1054 1104 1199 1342 
13 20 112 180 195 200 205 219 255 349 511 1325 
214 392 451 589 594 615 761 800 967 1103 1276 
317 334 631 703 746 844 868 961 1044 1112 1263 
568 731 740 774 854 885 1059 1078 1152 1157 1212 
107 108 164 203 389 525 531 603 733 762 
3 76 369 382 593 1088 1089 1183 1265 
117 121 253 372 445 755 931 1005 1034 
183 262 373 374 519 702 926 1074 1096 
198 199 270 297 298 335 533 958 973 
341 494 535 536 633 817 871 1148 1301 
4 45 70 158 622 747 889 892 
7 58 73 74 329 545 865 900 
35 229 283 351 529 664 922 930 
66 280 504 847 888 898 1097 1192 
78 274 661 662 879 989 1101 1235 
94 415 650 725 824 1119 1120 1201 
11 547 694 741 767 1145 1345 
23 85 86 744 942 1195 1300 
26 67 459 497 848 859 1304 
75 111 132 307 375 569 1050 
133 849 1166 1175 1229 1232 1350 
153 201 210 491 869 1051 1063 
156 196 197 727 905 951 992 
193 377 402 621 1030 1049 1156 
227 305 362 792 1244 1245 1261 
258 479 498 549 684 1279 1298 
404 651 723 843 996 1013 1055 
24 136 242 245 277 517 
29 379 732 927 1092 1176 
34 398 674 957 1240 1332 
41 103 104 472 904 982 
51 142 223 597 1264 1347 
52 174 234 442 443 1048 
60 163 332 390 417 527 
61 62 701 1100 1196 1330 
63 681 857 872 1037 1189 
68 670 815 1022 1206 1214 
89 90 222 278 1140 1311 
113 114 282 322 653 752 
116 1070 1071 1203 1266 1286 
129 130 606 891 1238 1239 
134 342 427 619 742 1198 
162 418 538 708 763 820 
178 788 1076 1098 1237 1295 
241 261 413 492 810 842 
244 366 388 406 410 599 
336 337 411 759 887 1329 
468 617 736 861 1137 1138 
677 678 750 776 828 1346 
707 780 814 1035 1125 1162 
711 712 805 806 1158 1336 
777 873 1033 1153 1284 1316 
827 864 998 1154 1167 1321 
1009 1010 1185 1191 1296 1297 
10 461 683 802 1064 
25 53 272 306 467 
30 978 1187 1205 1310 
91 92 559 682 1099 
95 151 772 1111 1255 
101 314 480 770 813 
146 250 287 858 1249 
165 516 695 832 908 
169 226 1058 1169 1294 
172 271 395 429 693 
184 709 1069 1130 1204 
187 276 560 754 852 
230 449 450 921 1168 
240 273 385 860 929 
254 554 1105 1178 1312 
292 464 477 1102 1129 
315 586 837 838 1283 
368 387 520 846 1024 
399 505 974 1172 1228 
422 587 831 955 1338 
436 894 895 1006 1039 
483 655 882 965 1161 
501 567 960 1041 1282 
550 949 950 981 1067 
769 939 1179 1190 1274 
833 834 1150 1151 1257 
851 863 1073 1113 1133 
2 514 819 1139 
17 39 469 470 
19 179 553 562 
28 71 465 735 
37 303 367 544 
69 308 340 419 
79 235 574 580 
84 672 876 877 
96 231 507 1209 
120 816 1160 1171 
124 365 502 722 
135 204 687 912 
138 700 719 720 
139 1026 1027 1116 
157 576 878 1128 
177 333 985 991 
246 811 1182 1281 
249 643 644 728 
266 414 896 990 
289 403 945 1213 
325 591 1001 1173 
353 637 845 936 
361 440 604 909 
430 705 890 1072 
455 456 1040 1253 
500 515 524 1351 
513 807 808 1020 
590 669 778 856 
638 667 737 983 
659 660 1216 1354 
758 1220 1221 1287 
768 917 918 1066 
893 1181 1218 1219 
962 963 1047 1269 
0 1122 1349 
16 836 986 
42 64 457 
43 730 993 
55 181 1186 
59 575 635 
77 532 1293 
87 161 1320 
99 628 629 
119 324 433 
194 657 1231 
213 452 605 
216 355 937 
228 247 1036 
256 286 1060 
257 338 548 
269 508 1075 
316 572 639 
321 489 546 
327 798 1094 
331 518 920 
339 416 696 
346 1008 1032 
352 1315 1331 
357 551 648 
380 721 984 
424 506 956 
428 444 870 
484 994 1149 
493 614 1136 
540 1226 1227 
584 786 787 
592 1132 1197 
620 716 717 
668 902 959 
671 825 1314 
685 829 999 
704 779 835 
757 1002 1087 
765 1007 1061 
791 925 972 
881 923 934 
1046 1085 1202 
1207 1223 1328 
1224 1225 1243 
