0 4 5 10 30 31 33 44 45 46 47 48 70 97 100 105 127 128 131 133 135 137 141 149 158 160 170 171 172 189 191 238 243 244 254 264 265 271 275 281 291 292 295 301 302 325 339 358 359 391 393 394 395 398 400 407 408 416 425 428 429 432 446 454 460 461 462 466 471 486 487 490 496 497 514 523 528 534 541 542 543 552 564 567 571 584 608 616 618 623 624 626 634 656 659 660 665 673 674 683 687 691 692 693 696 701 715 718 722 747 748 775 784 785 794 801 809 827 835 841 864 889 892 899 914 916 933 938 943 944 948 952 953 954 961 962 966 969 970 976 978 998 1008 1020 1021 1032 1043 1053 1064 1079 1081 1091 1107 1108 1122 1123 1124 1135 1141 1147 1154 1167 1177 1187 1196 1200 1205 1211 1216 1233 1234 1241 1247 1252 1272 1290 1302 1305 1306 1310 1312 1321 1333 1349 1354 
1 6 7 12 22 24 25 34 36 40 58 66 67 73 74 88 119 121 148 154 165 169 208 212 220 225 226 227 242 277 280 299 300 306 314 315 321 324 328 329 374 376 381 386 387 388 401 412 421 433 464 467 475 477 484 489 491 503 513 516 517 519 526 537 545 546 570 573 585 586 599 600 601 627 630 671 684 686 695 702 704 729 749 765 779 781 790 792 803 814 832 837 838 865 875 888 900 903 908 926 957 988 1003 1014 1016 1055 1056 1057 1058 1074 1078 1095 1096 1097 1106 1129 1149 1169 1180 1192 1215 1240 1258 1261 1271 1273 1283 1294 1307 1308 1319 1332 1348 
41 102 103 104 107 108 113 114 156 164 167 168 196 197 198 202 228 251 266 270 297 298 322 335 341 389 404 409 472 525 531 533 535 536 558 561 603 615 651 653 667 699 723 733 737 752 757 762 802 843 871 904 905 951 958 973 982 983 996 1002 1013 1017 1087 1103 1139 1148 1188 1222 1301 1324 
11 51 84 357 368 384 478 479 509 510 520 547 555 579 597 607 620 632 672 677 678 694 716 717 727 739 740 741 750 776 799 828 833 834 846 854 874 876 877 1011 1024 1059 1114 1145 1146 1150 1151 1152 1157 1179 1256 1257 1299 1343 1346 
54 57 72 93 144 147 166 187 248 263 276 318 378 420 431 436 476 485 530 540 560 563 566 689 754 764 821 852 855 880 894 895 915 987 1006 1039 1065 1082 1083 1093 1170 1206 1226 1285 1289 1317 
27 75 83 111 132 136 256 285 288 304 305 307 347 354 362 370 375 380 396 397 414 458 463 473 474 556 569 578 581 582 595 625 652 676 688 707 710 721 773 795 940 994 1044 1060 1159 
3 49 50 71 76 153 201 241 261 350 369 382 413 549 588 769 777 810 812 842 869 873 939 1033 1040 1051 1086 1088 1089 1153 1183 1190 1197 1260 1262 1265 1274 1284 1292 1316 1340 1341 
16 68 78 129 130 138 139 140 274 591 606 638 670 726 780 815 836 879 891 986 1009 1010 1012 1022 1026 1027 1035 1102 1116 1125 1162 1173 1185 1191 1214 1235 1238 1239 1296 1297 
14 15 109 115 116 267 326 565 596 611 646 647 743 826 868 913 968 1004 1025 1050 1070 1071 1090 1112 1134 1203 1230 1236 1242 1259 1263 1266 1303 1309 1326 1334 1335 
32 38 145 210 312 405 501 521 522 613 633 690 713 738 789 850 851 863 919 960 1018 1041 1052 1062 1063 1073 1099 1105 1109 1113 1115 1133 1163 1254 1278 1280 
95 117 122 183 253 316 345 353 372 373 426 445 453 572 590 637 639 658 669 745 755 768 778 818 845 856 910 931 936 1005 1034 1066 1142 1322 1323 
18 65 123 152 174 180 184 190 215 221 239 406 423 439 447 602 649 709 732 756 767 824 867 912 946 1028 1029 1069 1119 1120 1130 1204 1277 1345 
26 55 60 98 162 163 181 289 332 390 403 417 418 444 459 527 538 614 708 763 820 848 859 870 917 918 945 1080 1186 1213 1304 1318 
80 85 86 173 186 214 240 273 286 385 392 451 494 498 589 594 744 761 800 807 860 929 942 967 1042 1046 1054 1085 1202 1276 
23 87 124 155 161 319 320 327 349 352 365 379 424 502 506 645 766 798 817 956 980 1094 1195 1300 1315 1320 1331 
28 62 77 157 236 317 334 465 532 576 593 612 631 663 675 703 735 746 844 878 896 911 990 1001 1128 1286 1330 
2 106 110 175 176 188 224 233 260 313 330 331 348 437 512 518 771 819 920 1068 1184 1208 1270 1275 1313 1339 
13 20 21 69 112 134 195 200 204 205 207 249 255 279 308 340 419 511 643 644 728 901 1143 1198 1201 1325 
8 9 203 211 229 262 399 435 440 441 492 505 622 753 783 839 840 853 862 935 974 981 1172 1227 1228 
52 56 125 126 268 290 293 294 434 442 495 609 610 640 697 941 971 992 1023 1048 1117 1210 1253 1267 1268 
29 217 231 232 482 507 641 642 679 680 734 830 924 927 928 1019 1084 1092 1144 1155 1164 1176 1224 1288 
99 120 199 628 629 711 712 805 806 816 849 1158 1160 1166 1171 1175 1193 1194 1229 1232 1244 1245 1336 1350 
42 64 94 218 219 234 245 259 269 272 309 356 360 361 415 443 457 508 604 650 909 1038 1075 
146 185 209 230 250 287 448 449 450 666 782 793 808 822 858 921 964 965 1015 1165 1168 1199 1249 
17 39 193 194 377 402 456 469 470 657 791 881 923 925 934 972 1030 1049 1156 1231 1291 
101 151 246 363 364 480 621 681 770 772 811 813 857 949 950 1111 1182 1255 1281 
182 206 282 371 499 550 551 636 648 698 714 725 796 797 947 984 1104 1225 1342 
89 90 222 278 468 500 515 524 617 736 861 1110 1137 1138 1140 1243 1311 1351 
91 92 213 343 452 559 568 605 654 682 731 774 906 907 1045 1212 1246 
310 311 336 337 411 483 655 706 759 882 883 887 1031 1264 1327 1329 1344 
96 422 493 587 661 662 831 847 955 989 1101 1136 1209 1217 1293 1338 
19 61 82 179 427 553 557 562 619 742 866 1007 1061 1077 1100 
35 177 237 283 333 351 529 539 664 897 922 930 932 985 991 
43 63 252 342 344 438 577 730 872 979 993 1037 1189 1248 
59 79 235 323 430 574 575 580 583 635 705 724 890 1072 
37 216 303 355 367 544 758 937 1220 1221 1282 1287 
142 143 223 366 410 504 804 898 997 1067 1337 1347 
178 455 592 788 823 1076 1098 1132 1161 1237 1295 
81 284 481 488 598 786 787 886 995 1131 
751 760 893 1181 1207 1218 1219 1223 1328 
150 346 700 719 720 825 1118 1314 
257 258 338 548 963 1269 1279 1298 
53 192 296 383 554 975 1178 
118 159 884 885 977 1000 
247 685 829 999 1036 1121 
668 902 959 1047 
