329 330 446 464 465 480 481 483 488 493 494 503 509 524 526 531 533 542 554 569 570 574 577 578 582 585 586 588 599 602 603 606 612 613 614 616 618 621 622 624 625 626 629 630 637 638 644 651 652 653 661 674 679 680 682 687 689 690 692 693 698 700 703 706 707 711 716 719 722 723 731 739 743 744 745 747 749 754 759 762 764 773 785 808 816 822 828 832 836 845 846 852 860 861 867 868 869 887 903 905 906 909 916 917 919 922 924 927 932 933 937 950 965 968 972 974 976 977 1001 1002 1012 1015 1017 1022 1024 1028 1037 1039 1055 1056 1065 1066 1080 1106 1109 1138 1145 1164 1189 1192 1204 1210 1228 1241 1246 1272 1288 
55 56 83 100 101 128 138 141 144 145 146 154 155 156 167 177 182 193 204 244 245 246 247 262 280 281 326 327 375 376 398 402 403 452 475 476 482 506 530 559 563 565 566 609 699 702 708 752 760 771 786 792 801 804 873 911 914 985 994 1014 1023 1071 1124 1146 1151 1166 1185 1226 1271 1278 
263 264 362 363 371 396 410 417 433 440 450 462 471 478 497 514 529 535 539 592 595 623 632 649 650 691 694 726 772 787 799 839 865 881 893 907 908 923 946 1018 1031 1061 1067 1072 1073 1143 1186 
34 35 38 39 53 54 71 82 89 92 97 122 181 218 219 332 393 556 594 617 619 715 727 831 949 1007 1038 1040 1083 1104 1157 1158 1196 1198 1285 
0 1 2 3 4 5 6 7 10 12 13 15 21 22 26 43 47 58 59 74 147 269 328 469 487 981 983 1053 1147 1193 1209 1245 1266 
41 42 72 114 115 129 171 173 178 220 228 229 238 239 250 255 319 347 365 428 686 728 756 863 864 871 957 1103 1131 1177 1187 1269 1284 
48 49 102 103 112 113 125 126 130 163 164 165 172 198 249 265 273 352 353 460 505 511 560 575 670 671 721 1114 1149 1168 1242 
184 185 270 271 274 275 283 302 337 344 346 360 369 380 381 384 385 414 429 447 479 508 572 589 761 820 827 1035 1237 
67 68 93 94 109 136 161 170 188 200 201 221 304 310 325 372 374 382 383 404 512 523 549 587 1020 1188 1208 1273 
44 45 46 50 51 57 76 81 116 137 149 272 297 335 336 517 642 720 1036 1062 1107 1127 1172 1173 1263 
233 234 313 438 439 461 501 580 581 648 823 967 990 991 1046 1119 1122 1133 1136 1140 1152 1264 
60 61 69 70 73 150 151 157 158 159 174 248 349 350 551 712 1079 1093 1256 
8 9 11 14 18 19 23 25 30 33 37 52 162 900 1059 1141 1229 1239 
717 802 803 812 813 847 1090 1091 1092 1097 1130 1132 1142 1159 1162 1184 1202 1224 
77 78 88 104 117 118 119 131 148 160 295 499 500 507 541 1280 
28 29 40 98 224 225 257 258 331 527 1050 1077 1101 1176 1262 
139 140 420 435 502 528 576 659 805 825 829 849 953 1238 1286 
415 416 454 558 685 770 781 826 830 876 904 928 984 1110 1197 
107 108 127 253 254 276 277 282 455 456 573 646 1021 1148 
62 63 95 134 135 294 333 411 1094 1099 1179 1212 
320 321 345 713 714 872 918 1041 1042 1049 1218 1281 
377 378 436 448 521 550 660 862 1181 1203 1233 1236 
408 409 470 491 536 579 774 855 886 1010 1118 1277 
735 736 763 777 788 795 915 925 934 1180 1240 1268 
189 190 286 419 444 510 654 755 791 835 1254 
291 292 361 368 468 681 765 910 1009 1084 1235 
16 17 20 24 27 36 296 966 1013 1025 
120 121 123 259 260 312 322 323 386 1054 
202 203 205 206 232 256 278 287 288 590 
214 215 230 252 405 421 453 593 800 1251 
216 217 242 379 399 424 495 866 1100 1267 
175 176 348 407 658 710 913 1076 1274 
210 211 318 443 451 457 477 490 1089 
284 285 351 498 633 879 880 963 1161 
391 392 397 406 434 472 564 1075 1137 
543 544 596 620 779 838 959 1255 1279 
850 851 874 875 926 1030 1033 1113 1125 
79 80 96 99 183 339 598 912 
90 91 226 237 293 389 1108 1163 
186 187 243 266 356 370 824 1116 
306 307 373 492 683 701 859 1032 
314 315 334 357 496 732 1250 1287 
340 341 437 525 1183 1201 1213 1244 
354 355 390 515 729 939 1102 1283 
545 546 552 647 656 992 1171 1227 
809 810 890 901 958 1026 1098 1216 
31 32 806 807 870 982 1270 
64 65 66 75 338 1060 1120 
86 87 166 207 324 522 1191 
212 213 342 343 395 591 1223 
222 223 261 418 427 597 885 
289 290 432 513 519 695 1044 
358 359 718 766 964 1214 1257 
458 459 818 819 969 975 1167 
600 601 645 1019 1045 1123 1160 
604 605 640 641 655 688 938 
814 815 935 936 1115 1128 1144 
951 952 960 988 989 1182 1222 
105 106 124 305 1051 1052 
132 133 227 240 241 367 
142 143 168 169 518 1261 
179 180 199 364 520 1253 
412 413 568 834 1117 1178 
466 467 534 557 567 615 
635 636 675 676 1016 1027 
110 111 303 753 1205 
194 195 553 796 837 
208 209 449 634 1029 
627 628 811 858 1211 
737 738 742 955 1121 
750 751 767 778 1081 
782 783 1074 1082 1275 
789 790 844 1096 1105 
898 899 1069 1170 1217 
152 153 231 489 
191 192 366 445 
196 197 251 1230 
235 236 279 920 
267 268 540 555 
387 388 394 532 
400 401 463 547 
430 431 504 1195 
441 442 516 1068 
473 474 548 902 
484 485 684 1057 
486 657 662 821 
537 538 639 663 
561 562 997 1199 
643 817 1190 1260 
668 669 748 1008 
775 776 784 1011 
797 798 848 884 
856 857 921 1169 
882 883 978 1200 
894 895 973 993 
970 971 1034 1043 
995 996 1221 1249 
1005 1006 1087 1095 
84 85 311 
298 299 768 
300 301 1058 
308 309 571 
425 426 954 
583 584 631 
607 608 746 
610 611 709 
664 665 1194 
666 667 780 
672 673 1265 
677 678 769 
696 697 833 
724 725 730 
733 734 1215 
842 843 929 
877 878 1150 
888 889 956 
891 892 1243 
896 897 1234 
930 931 1000 
940 941 1126 
942 943 1129 
947 948 1070 
1047 1048 1225 
1134 1135 1139 
1165 1252 1282 
1258 1259 1276 
