0 1 2 3 4 5 6 7 8 9 10 11 12 13 14 15 16 17 18 19 20 21 22 23 24 25 26 27 28 29 30 31 32 33 34 35 36 37 38 39 40 41 42 43 44 45 46 47 48 49 50 51 52 53 54 55 56 57 58 59 60 61 62 63 64 65 66 67 68 69 70 71 72 73 74 75 76 77 78 79 80 81 82 83 84 85 86 87 88 89 90 91 92 93 94 95 96 97 98 99 100 101 102 103 104 105 106 107 108 109 110 111 112 113 114 115 116 117 118 119 120 121 122 123 124 125 126 127 128 129 130 131 132 133 134 135 136 137 138 139 140 141 142 143 144 145 146 147 148 149 150 151 152 153 154 155 156 157 158 159 160 161 162 163 164 165 166 167 168 169 170 171 172 173 174 175 176 177 178 179 180 181 182 183 184 185 186 187 188 189 190 191 192 193 194 195 196 197 198 199 200 201 202 203 204 205 206 207 208 209 210 211 212 213 214 215 216 217 218 219 220 221 222 223 224 225 226 227 228 229 230 231 232 233 234 235 236 237 238 239 240 241 242 243 244 245 246 247 248 249 250 251 252 253 254 255 256 257 258 259 260 261 262 263 264 265 266 267 268 269 270 271 272 273 274 275 276 277 278 279 280 281 282 283 284 285 286 287 288 289 290 291 292 293 294 295 296 297 298 299 300 301 302 303 304 305 306 307 308 309 310 311 312 313 314 315 316 317 318 319 320 321 322 323 324 325 326 327 328 329 330 331 332 333 334 335 336 337 338 339 340 341 342 343 344 345 346 347 348 349 350 351 352 353 354 355 356 357 358 359 360 361 362 363 364 365 366 367 368 369 370 371 372 373 374 375 376 377 378 379 380 381 382 383 384 385 386 387 388 389 390 391 392 393 394 395 396 397 398 399 400 401 402 403 404 405 406 407 408 409 410 411 412 413 414 415 416 417 418 419 420 421 422 423 424 425 426 427 428 429 430 431 432 433 434 435 436 437 438 439 440 441 442 443 444 445 446 447 448 449 450 451 452 453 454 455 456 457 458 459 460 461 462 463 464 465 466 467 468 469 470 471 472 473 474 475 476 477 478 479 480 481 482 483 484 485 486 487 488 489 490 491 492 493 494 495 496 497 498 499 500 501 502 503 504 505 506 507 508 509 510 511 512 513 514 515 516 517 518 519 520 521 522 523 524 525 526 527 528 529 530 531 532 533 534 535 536 537 538 539 540 541 542 543 544 545 546 547 548 549 550 551 552 553 554 555 556 557 558 559 560 561 562 563 564 565 566 567 568 569 570 571 572 573 574 575 576 577 578 579 580 581 582 583 584 585 586 587 588 589 590 591 592 593 594 595 596 597 598 599 600 601 602 603 604 605 606 607 608 609 610 611 612 613 614 615 616 617 618 619 620 621 622 623 624 625 626 627 628 629 630 631 632 633 634 635 636 637 638 639 640 641 642 643 644 645 646 647 648 649 650 651 652 653 654 655 656 657 658 659 660 661 662 663 664 665 666 667 668 669 670 671 672 673 674 675 676 677 678 679 680 681 682 683 684 685 686 687 688 689 690 691 692 693 694 695 696 697 698 699 700 701 702 703 704 705 706 707 708 709 710 711 712 713 714 715 716 717 718 719 720 721 722 723 724 725 726 727 728 729 730 731 732 733 734 735 736 737 738 739 740 741 742 743 744 745 746 747 748 749 750 751 752 753 754 755 756 757 758 759 760 761 762 763 764 765 766 767 768 769 770 771 772 773 774 775 776 777 778 779 780 781 782 783 784 785 786 787 788 789 790 791 792 793 794 795 796 797 798 799 800 801 802 803 804 805 806 807 808 809 810 811 812 813 814 815 816 817 818 819 820 821 822 823 824 825 826 827 828 829 830 831 832 833 834 835 836 837 838 839 840 841 842 843 844 845 846 847 848 849 850 851 852 853 854 855 856 857 858 859 860 861 862 863 864 865 866 867 868 869 870 871 872 873 874 875 876 877 878 879 880 881 882 883 884 885 886 887 888 889 890 891 892 893 894 895 896 897 898 899 900 901 902 903 904 905 906 907 908 909 910 911 912 913 914 915 916 917 918 919 920 921 922 923 924 925 926 927 928 929 930 931 932 933 934 935 936 937 938 939 940 941 942 943 944 945 946 947 948 949 950 951 952 953 954 955 956 957 958 959 960 962 963 964 965 966 967 968 969 970 971 972 973 974 975 976 977 978 979 980 981 982 983 984 985 986 987 988 989 990 991 992 993 994 995 997 998 999 1000 1001 1002 1003 1004 1005 1006 1007 1008 1009 1010 1011 1012 1013 1014 1015 1016 1017 1018 1019 1020 1021 1022 1023 1024 1025 1026 1027 1028 1029 1030 1031 1032 1033 1034 1035 1036 1037 1038 1039 1040 1041 1042 1043 1044 1045 1046 1047 1048 1049 1050 1051 1052 1053 1054 1055 1056 1057 1058 1059 1060 1061 1062 1063 1064 1065 1066 1067 1068 1069 1070 1071 1072 1073 1074 1075 1076 1077 1078 1079 1080 1081 1082 1083 1084 1085 1086 1087 1088 1089 1090 1091 1092 1093 1094 1095 1096 1097 1098 1099 1100 1101 1102 1103 1104 1105 1106 1107 1108 1109 1110 1111 1112 1113 1114 1115 1116 1117 1118 1119 1120 1121 1122 1123 1124 1125 1126 1127 1128 1129 1130 1131 1132 1133 1135 1136 1137 1138 1139 1140 1141 1142 1143 1144 1145 1146 1147 1148 1149 1150 1151 1152 1153 1154 1155 1156 1157 1158 1159 1160 1161 1162 1163 1164 1165 1166 1167 1168 1169 1170 1171 1172 1173 1174 1175 1176 1177 1178 1179 1180 1181 1182 1183 1184 1185 1186 1188 1189 1190 1191 1192 1193 1194 1195 1196 1197 1198 1199 1200 1201 1202 1203 1204 1205 1206 1207 1208 1209 1210 1211 1212 1213 1214 1215 1216 1217 1218 1219 1220 1221 1222 1223 1224 1225 1226 1227 1228 1229 1230 1231 1232 1233 1234 1235 1236 1237 1238 1239 1240 1241 1242 1243 1244 1245 1246 1247 1248 1249 1250 1251 1253 1254 1255 1256 1257 1258 1259 1260 1261 1262 1263 1264 1265 1266 1267 1268 1269 1270 1271 1272 1273 1274 1275 1277 1278 1279 1280 1281 1282 1283 1284 1285 1286 1287 1288 
200 253 471 652 1029 1129 1141 1249 1278 1279 
37 65 78 83 160 163 166 179 293 354 355 383 384 403 405 504 553 579 595 615 627 657 658 676 690 711 721 724 726 866 894 936 954 977 1006 1063 1085 1134 
259 273 550 771 1101 1154 1252 1273 
105 140 157 165 174 175 185 222 268 313 359 414 491 518 689 818 856 950 967 982 996 1001 1034 1088 1093 1157 1167 1193 1196 1208 1221 
1269 1270 1271 
437 438 439 440 441 442 443 444 445 446 447 448 449 450 451 452 453 454 455 456 457 458 536 543 702 703 
995 996 1007 1008 1009 1010 1011 1012 1056 1222 1223 
212 257 268 269 431 449 450 620 623 664 748 749 779 867 915 919 1030 1044 
39 40 43 62 95 113 115 116 118 135 148 175 186 187 196 265 279 294 321 349 350 368 398 399 414 503 507 517 527 530 534 540 591 599 615 650 708 718 720 724 753 766 785 807 830 835 836 844 858 877 912 927 932 962 963 967 976 989 1023 1070 1123 1136 1143 1159 1195 1202 1213 1215 1228 1257 1273 1278 1281 
8 29 30 79 90 107 124 208 216 219 305 306 310 316 317 329 330 333 352 359 363 364 365 372 382 385 390 391 392 448 451 452 493 494 495 496 510 528 579 580 581 588 598 618 619 626 646 688 689 725 780 782 783 802 803 842 844 845 846 847 860 866 882 885 886 910 944 954 964 965 974 979 980 990 993 994 1001 1004 1031 1067 1068 1084 1092 1127 1135 1137 1145 1148 1216 1242 1244 1264 1265 1268 1277 
165 412 413 458 570 612 659 686 863 875 1100 1101 1154 
9 86 87 127 235 334 344 345 425 562 568 688 689 702 703 763 822 823 844 866 982 1056 1079 1115 1210 
0 60 62 113 175 247 292 407 441 530 635 675 707 718 807 830 893 896 1136 1152 1159 1228 
1237 1238 1239 1240 1241 1242 1243 1244 1245 1246 1247 
909 911 912 913 914 
207 388 390 394 510 1017 1037 1202 1203 1204 1205 1206 1207 1208 
185 188 236 505 509 512 628 960 961 962 963 964 
64 457 459 462 466 467 468 695 1008 1195 1196 1197 1198 1199 1200 
806 807 808 809 810 811 812 813 814 815 816 817 818 819 866 867 868 870 1265 1283 1284 1285 1286 
17 18 180 181 183 184 185 186 187 188 189 190 191 192 194 195 196 197 199 200 201 202 203 204 205 505 512 513 802 805 1033 1036 1038 1039 1047 
37 38 42 54 89 482 483 484 485 486 487 488 573 574 575 577 584 590 592 593 594 596 598 599 701 872 922 924 926 1014 1015 
37 42 43 54 59 476 481 483 487 571 572 573 576 578 579 580 582 583 584 585 586 587 588 589 591 595 597 598 599 669 820 1060 1175 1180 1181 
332 949 1158 
0 2 4 5 8 10 11 65 110 111 149 174 185 205 222 248 354 355 360 366 430 466 527 554 577 606 655 656 659 732 821 891 892 915 990 1256 
0 68 258 293 318 338 350 356 367 383 498 548 549 557 582 583 604 609 869 893 940 978 1039 1178 
126 162 163 294 389 390 417 418 538 707 708 763 820 945 1093 1186 
280 846 847 888 898 1097 1192 
45 70 71 120 378 446 496 497 501 746 747 748 752 763 815 892 979 991 1173 
27 46 121 122 134 141 179 253 426 427 451 452 494 572 590 637 639 655 658 669 704 744 778 795 845 856 931 
20 54 65 95 96 112 155 195 200 204 205 255 256 379 563 578 579 728 866 1114 1146 
14 15 75 83 91 92 115 132 183 184 213 214 285 307 326 336 337 375 396 397 474 489 513 556 565 581 596 610 611 688 709 743 759 802 913 1004 1040 1069 1130 1204 1236 1242 
433 525 602 603 1081 
291 346 629 792 807 1032 1085 1202 1244 1261 
68 107 140 141 166 167 179 324 391 400 423 499 520 652 726 957 1044 1045 
254 482 483 641 642 734 829 830 924 928 1084 1144 
34 40 76 157 164 165 292 351 406 414 422 442 466 515 516 535 574 575 576 580 593 612 613 629 630 631 758 767 791 807 814 816 863 878 902 911 994 1012 1109 1113 1133 1162 1240 1260 
77 84 85 144 145 175 201 209 210 281 282 412 569 898 914 942 1046 1051 1052 1063 1075 1105 
138 139 377 402 455 456 670 881 923 934 967 1009 1010 1040 1171 1185 1191 1214 1253 1267 1268 
14 15 61 62 115 266 267 326 396 513 565 596 611 646 647 651 743 759 805 806 826 868 876 877 896 913 968 990 1001 1004 1011 1025 1050 1090 1100 1134 1158 1203 1230 1236 1242 1259 1276 1286 
2 3 21 48 105 106 109 110 176 223 224 233 260 261 347 348 393 419 420 437 512 571 597 634 715 771 809 819 915 974 1083 1142 1183 1208 1275 
18 19 20 21 22 23 24 25 26 377 394 419 478 511 512 617 618 619 620 621 622 748 786 787 788 789 790 791 792 
126 127 128 129 130 131 132 133 134 135 136 137 138 139 140 141 142 143 144 145 146 147 148 149 150 151 152 153 154 155 156 157 158 159 160 161 162 163 164 165 166 167 168 169 170 171 172 173 174 175 176 177 178 179 180 231 233 234 235 236 238 240 241 242 243 245 246 247 248 249 251 252 254 258 259 297 331 332 333 334 336 337 490 491 573 574 575 585 586 587 588 589 647 661 662 664 665 698 732 736 795 831 851 
186 187 243 266 356 370 824 1116 
125 126 172 202 203 205 206 232 256 265 278 287 288 590 
340 341 437 525 543 544 596 620 779 838 959 1183 1201 1213 
304 323 955 979 980 
139 140 420 435 502 528 576 659 805 825 829 849 953 
3 153 341 342 343 344 346 347 516 559 613 616 618 619 620 642 712 729 730 787 789 
315 371 389 390 473 474 475 598 599 600 601 609 611 612 802 803 822 
6 7 20 26 29 40 85 86 115 126 135 154 195 196 207 209 221 227 242 243 368 373 374 498 597 899 
441 442 534 771 883 988 
2 119 120 127 128 149 161 165 170 171 219 309 315 316 384 385 402 403 418 419 461 492 549 557 613 656 684 692 860 886 934 940 951 1005 
36 64 100 101 125 142 143 167 177 261 285 319 320 325 331 354 414 445 494 568 666 687 689 696 794 814 818 878 880 881 913 960 
345 425 476 693 743 744 895 1050 
83 203 245 279 321 322 411 452 462 497 508 551 593 631 654 701 786 827 831 879 
252 416 418 419 420 421 422 452 453 454 455 456 457 
60 75 269 270 315 329 391 412 441 661 
136 137 201 304 325 383 495 542 543 550 562 602 635 
53 54 78 103 104 320 321 387 829 
35 36 38 48 60 72 75 82 97 98 121 140 417 444 463 546 565 577 631 769 
19 20 21 22 151 368 441 479 661 
23 24 25 26 27 334 358 359 360 361 366 386 401 
139 371 372 373 374 455 457 458 512 513 554 
34 509 524 555 567 568 739 740 741 799 854 956 1013 1059 1078 1152 1157 
6 7 25 34 35 40 58 67 73 74 80 81 123 132 148 177 190 314 315 328 329 401 402 408 424 484 516 519 545 546 547 585 607 663 667 668 686 700 745 852 865 874 875 886 887 900 994 1094 1131 1193 1252 1260 
0 1 12 13 22 23 32 34 36 37 40 42 43 44 48 53 55 59 63 64 65 66 75 79 83 86 87 88 93 94 111 132 148 155 174 189 195 200 208 212 218 219 220 234 235 242 245 250 255 256 257 259 269 272 277 278 285 296 303 304 305 306 307 308 309 321 322 327 339 340 341 349 353 355 360 361 374 375 381 388 403 406 408 415 416 421 443 457 464 467 468 473 475 502 503 504 508 515 516 526 573 584 588 594 599 608 619 625 626 627 649 681 688 724 728 736 751 770 786 812 867 890 899 926 936 948 953 980 994 997 1029 1061 1070 1071 1147 1187 1193 1213 1247 1248 1260 
668 669 748 1008 1168 1253 1260 1265 
216 217 242 294 333 379 399 411 424 464 465 475 483 488 495 526 577 578 621 637 638 687 692 703 722 723 745 845 866 887 909 927 972 1039 1066 
34 35 38 39 53 54 71 82 89 92 97 122 165 181 218 219 332 393 556 594 619 727 756 831 1007 1038 
320 321 345 685 713 872 918 1049 
120 121 123 259 260 312 322 323 386 594 617 1054 
90 91 226 237 293 389 
